Period,Principal,Payment,Interest,Amount_Towards_Principal,Ending Balance,Loan_Name,Index,Inner_Loop_Iteration
0,4000.0,1070.0,16.0,1054.0,2946.0,testing,1,1
1,2946.0,1070.0,11.78,1058.22,1887.78,testing,1,1
2,1887.78,1070.0,7.55,1062.45,825.33,testing,1,1
3,825.33,1070.0,3.3,1066.7,-241.37,testing,1,1
0,5000.0,333.0,36.0,297.0,4703.0,Car,1,2
1,4703.0,333.0,33.86,299.14,4403.86,Car,1,2
2,4403.86,333.0,31.71,301.29,4102.57,Car,1,2
3,4102.57,574.37,29.54,544.83,3557.74,Car,1,2
4,3557.74,1403.0,25.62,1377.38,2180.36,Car,1,2
5,2180.36,1403.0,15.7,1387.3,793.06,Car,1,2
6,793.06,1403.0,5.71,1397.29,-604.23,Car,1,2
0,8250.57,84.62,53.63,30.99,8219.58,WellsFargo1,1,3
1,8219.58,84.62,53.43,31.19,8188.39,WellsFargo1,1,3
2,8188.39,84.62,53.22,31.4,8156.99,WellsFargo1,1,3
3,8156.99,84.62,53.02,31.6,8125.39,WellsFargo1,1,3
4,8125.39,84.62,52.82,31.8,8093.59,WellsFargo1,1,3
5,8093.59,84.62,52.61,32.01,8061.58,WellsFargo1,1,3
6,8061.58,688.85,52.4,636.45,7425.13,WellsFargo1,1,3
7,7425.13,1487.62,48.26,1439.36,5985.77,WellsFargo1,1,3
8,5985.77,1487.62,38.91,1448.71,4537.06,WellsFargo1,1,3
9,4537.06,1487.62,29.49,1458.13,3078.93,WellsFargo1,1,3
10,3078.93,1487.62,20.01,1467.61,1611.32,WellsFargo1,1,3
11,1611.32,1487.62,10.47,1477.15,134.17,WellsFargo1,1,3
12,134.17,1487.62,0.87,1486.75,-1352.58,WellsFargo1,1,3
0,20000.0,191.04,108.0,83.04,19916.96,WellsFargo2,1,4
1,19916.96,191.04,107.55,83.49,19833.47,WellsFargo2,1,4
2,19833.47,191.04,107.1,83.94,19749.53,WellsFargo2,1,4
3,19749.53,191.04,106.65,84.39,19665.14,WellsFargo2,1,4
4,19665.14,191.04,106.19,84.85,19580.29,WellsFargo2,1,4
5,19580.29,191.04,105.73,85.31,19494.98,WellsFargo2,1,4
6,19494.98,191.04,105.27,85.77,19409.21,WellsFargo2,1,4
7,19409.21,191.04,104.81,86.23,19322.98,WellsFargo2,1,4
8,19322.98,191.04,104.34,86.7,19236.28,WellsFargo2,1,4
9,19236.28,191.04,103.88,87.16,19149.12,WellsFargo2,1,4
10,19149.12,191.04,103.41,87.63,19061.49,WellsFargo2,1,4
11,19061.49,191.04,102.93,88.11,18973.38,WellsFargo2,1,4
12,18973.38,1543.62,102.46,1441.16,17532.22,WellsFargo2,1,4
13,17532.22,1678.66,94.67,1583.99,15948.23,WellsFargo2,1,4
14,15948.23,1678.66,86.12,1592.54,14355.69,WellsFargo2,1,4
15,14355.69,1678.66,77.52,1601.14,12754.55,WellsFargo2,1,4
16,12754.55,1678.66,68.87,1609.79,11144.76,WellsFargo2,1,4
17,11144.76,1678.66,60.18,1618.48,9526.28,WellsFargo2,1,4
18,9526.28,1678.66,51.44,1627.22,7899.06,WellsFargo2,1,4
19,7899.06,1678.66,42.65,1636.01,6263.05,WellsFargo2,1,4
20,6263.05,1678.66,33.82,1644.84,4618.21,WellsFargo2,1,4
21,4618.21,1678.66,24.94,1653.72,2964.49,WellsFargo2,1,4
22,2964.49,1678.66,16.01,1662.65,1301.84,WellsFargo2,1,4
23,1301.84,1678.66,7.03,1671.63,-369.79,WellsFargo2,1,4
0,180000.0,1331.44,594.0,737.44,179262.56,mortgage,1,5
1,179262.56,1331.44,591.57,739.87,178522.69,mortgage,1,5
2,178522.69,1331.44,589.12,742.32,177780.37,mortgage,1,5
3,177780.37,1331.44,586.68,744.76,177035.61,mortgage,1,5
4,177035.61,1331.44,584.22,747.22,176288.39,mortgage,1,5
5,176288.39,1331.44,581.75,749.69,175538.7,mortgage,1,5
6,175538.7,1331.44,579.28,752.16,174786.54,mortgage,1,5
7,174786.54,1331.44,576.8,754.64,174031.9,mortgage,1,5
8,174031.9,1331.44,574.31,757.13,173274.77,mortgage,1,5
9,173274.77,1331.44,571.81,759.63,172515.14,mortgage,1,5
10,172515.14,1331.44,569.3,762.14,171753.0,mortgage,1,5
11,171753.0,1331.44,566.78,764.66,170988.34,mortgage,1,5
12,170988.34,1331.44,564.26,767.18,170221.16,mortgage,1,5
13,170221.16,1331.44,561.73,769.71,169451.45,mortgage,1,5
14,169451.45,1331.44,559.19,772.25,168679.2,mortgage,1,5
15,168679.2,1331.44,556.64,774.8,167904.4,mortgage,1,5
16,167904.4,1331.44,554.08,777.36,167127.04,mortgage,1,5
17,167127.04,1331.44,551.52,779.92,166347.12,mortgage,1,5
18,166347.12,1331.44,548.95,782.49,165564.63,mortgage,1,5
19,165564.63,1331.44,546.36,785.08,164779.55,mortgage,1,5
20,164779.55,1331.44,543.77,787.67,163991.88,mortgage,1,5
21,163991.88,1331.44,541.17,790.27,163201.61,mortgage,1,5
22,163201.61,1331.44,538.57,792.87,162408.74,mortgage,1,5
23,162408.74,1701.23,535.95,1165.28,161243.46,mortgage,1,5
24,161243.46,3010.1,532.1,2478.0,158765.46,mortgage,1,5
25,158765.46,3010.1,523.93,2486.17,156279.29,mortgage,1,5
26,156279.29,3010.1,515.72,2494.38,153784.91,mortgage,1,5
27,153784.91,3010.1,507.49,2502.61,151282.3,mortgage,1,5
28,151282.3,3010.1,499.23,2510.87,148771.43,mortgage,1,5
29,148771.43,3010.1,490.95,2519.15,146252.28,mortgage,1,5
30,146252.28,3010.1,482.63,2527.47,143724.81,mortgage,1,5
31,143724.81,3010.1,474.29,2535.81,141189.0,mortgage,1,5
32,141189.0,3010.1,465.92,2544.18,138644.82,mortgage,1,5
33,138644.82,3010.1,457.53,2552.57,136092.25,mortgage,1,5
34,136092.25,3010.1,449.1,2561.0,133531.25,mortgage,1,5
35,133531.25,3010.1,440.65,2569.45,130961.8,mortgage,1,5
36,130961.8,3010.1,432.17,2577.93,128383.87,mortgage,1,5
37,128383.87,3010.1,423.67,2586.43,125797.44,mortgage,1,5
38,125797.44,3010.1,415.13,2594.97,123202.47,mortgage,1,5
39,123202.47,3010.1,406.57,2603.53,120598.94,mortgage,1,5
40,120598.94,3010.1,397.98,2612.12,117986.82,mortgage,1,5
41,117986.82,3010.1,389.36,2620.74,115366.08,mortgage,1,5
42,115366.08,3010.1,380.71,2629.39,112736.69,mortgage,1,5
43,112736.69,3010.1,372.03,2638.07,110098.62,mortgage,1,5
44,110098.62,3010.1,363.33,2646.77,107451.85,mortgage,1,5
45,107451.85,3010.1,354.59,2655.51,104796.34,mortgage,1,5
46,104796.34,3010.1,345.83,2664.27,102132.07,mortgage,1,5
47,102132.07,3010.1,337.04,2673.06,99459.01,mortgage,1,5
48,99459.01,3010.1,328.21,2681.89,96777.12,mortgage,1,5
49,96777.12,3010.1,319.36,2690.74,94086.38,mortgage,1,5
50,94086.38,3010.1,310.49,2699.61,91386.77,mortgage,1,5
51,91386.77,3010.1,301.58,2708.52,88678.25,mortgage,1,5
52,88678.25,3010.1,292.64,2717.46,85960.79,mortgage,1,5
53,85960.79,3010.1,283.67,2726.43,83234.36,mortgage,1,5
54,83234.36,3010.1,274.67,2735.43,80498.93,mortgage,1,5
55,80498.93,3010.1,265.65,2744.45,77754.48,mortgage,1,5
56,77754.48,3010.1,256.59,2753.51,75000.97,mortgage,1,5
57,75000.97,3010.1,247.5,2762.6,72238.37,mortgage,1,5
58,72238.37,3010.1,238.39,2771.71,69466.66,mortgage,1,5
59,69466.66,3010.1,229.24,2780.86,66685.8,mortgage,1,5
60,66685.8,3010.1,220.06,2790.04,63895.76,mortgage,1,5
61,63895.76,3010.1,210.86,2799.24,61096.52,mortgage,1,5
62,61096.52,3010.1,201.62,2808.48,58288.04,mortgage,1,5
63,58288.04,3010.1,192.35,2817.75,55470.29,mortgage,1,5
64,55470.29,3010.1,183.05,2827.05,52643.24,mortgage,1,5
65,52643.24,3010.1,173.72,2836.38,49806.86,mortgage,1,5
66,49806.86,3010.1,164.36,2845.74,46961.12,mortgage,1,5
67,46961.12,3010.1,154.97,2855.13,44105.99,mortgage,1,5
68,44105.99,3010.1,145.55,2864.55,41241.44,mortgage,1,5
69,41241.44,3010.1,136.1,2874.0,38367.44,mortgage,1,5
70,38367.44,3010.1,126.61,2883.49,35483.95,mortgage,1,5
71,35483.95,3010.1,117.1,2893.0,32590.95,mortgage,1,5
72,32590.95,3010.1,107.55,2902.55,29688.4,mortgage,1,5
73,29688.4,3010.1,97.97,2912.13,26776.27,mortgage,1,5
74,26776.27,3010.1,88.36,2921.74,23854.53,mortgage,1,5
75,23854.53,3010.1,78.72,2931.38,20923.15,mortgage,1,5
76,20923.15,3010.1,69.05,2941.05,17982.1,mortgage,1,5
77,17982.1,3010.1,59.34,2950.76,15031.34,mortgage,1,5
78,15031.34,3010.1,49.6,2960.5,12070.84,mortgage,1,5
79,12070.84,3010.1,39.83,2970.27,9100.57,mortgage,1,5
80,9100.57,3010.1,30.03,2980.07,6120.5,mortgage,1,5
81,6120.5,3010.1,20.2,2989.9,3130.6,mortgage,1,5
82,3130.6,3010.1,10.33,2999.77,130.83,mortgage,1,5
83,130.83,3010.1,0.43,3009.67,-2878.84,mortgage,1,5
0,4000.0,1070.0,16.0,1054.0,2946.0,testing,2,1
1,2946.0,1070.0,11.78,1058.22,1887.78,testing,2,1
2,1887.78,1070.0,7.55,1062.45,825.33,testing,2,1
3,825.33,1070.0,3.3,1066.7,-241.37,testing,2,1
0,5000.0,333.0,36.0,297.0,4703.0,Car,2,2
1,4703.0,333.0,33.86,299.14,4403.86,Car,2,2
2,4403.86,333.0,31.71,301.29,4102.57,Car,2,2
3,4102.57,574.37,29.54,544.83,3557.74,Car,2,2
4,3557.74,1403.0,25.62,1377.38,2180.36,Car,2,2
5,2180.36,1403.0,15.7,1387.3,793.06,Car,2,2
6,793.06,1403.0,5.71,1397.29,-604.23,Car,2,2
0,8250.57,84.62,53.63,30.99,8219.58,WellsFargo1,2,3
1,8219.58,84.62,53.43,31.19,8188.39,WellsFargo1,2,3
2,8188.39,84.62,53.22,31.4,8156.99,WellsFargo1,2,3
3,8156.99,84.62,53.02,31.6,8125.39,WellsFargo1,2,3
4,8125.39,84.62,52.82,31.8,8093.59,WellsFargo1,2,3
5,8093.59,84.62,52.61,32.01,8061.58,WellsFargo1,2,3
6,8061.58,688.85,52.4,636.45,7425.13,WellsFargo1,2,3
7,7425.13,1487.62,48.26,1439.36,5985.77,WellsFargo1,2,3
8,5985.77,1487.62,38.91,1448.71,4537.06,WellsFargo1,2,3
9,4537.06,1487.62,29.49,1458.13,3078.93,WellsFargo1,2,3
10,3078.93,1487.62,20.01,1467.61,1611.32,WellsFargo1,2,3
11,1611.32,1487.62,10.47,1477.15,134.17,WellsFargo1,2,3
12,134.17,1487.62,0.87,1486.75,-1352.58,WellsFargo1,2,3
0,180000.0,1331.44,594.0,737.44,179262.56,mortgage,2,4
1,179262.56,1331.44,591.57,739.87,178522.69,mortgage,2,4
2,178522.69,1331.44,589.12,742.32,177780.37,mortgage,2,4
3,177780.37,1331.44,586.68,744.76,177035.61,mortgage,2,4
4,177035.61,1331.44,584.22,747.22,176288.39,mortgage,2,4
5,176288.39,1331.44,581.75,749.69,175538.7,mortgage,2,4
6,175538.7,1331.44,579.28,752.16,174786.54,mortgage,2,4
7,174786.54,1331.44,576.8,754.64,174031.9,mortgage,2,4
8,174031.9,1331.44,574.31,757.13,173274.77,mortgage,2,4
9,173274.77,1331.44,571.81,759.63,172515.14,mortgage,2,4
10,172515.14,1331.44,569.3,762.14,171753.0,mortgage,2,4
11,171753.0,1331.44,566.78,764.66,170988.34,mortgage,2,4
12,170988.34,2684.02,564.26,2119.76,168868.58,mortgage,2,4
13,168868.58,2819.06,557.27,2261.79,166606.79,mortgage,2,4
14,166606.79,2819.06,549.8,2269.26,164337.53,mortgage,2,4
15,164337.53,2819.06,542.31,2276.75,162060.78,mortgage,2,4
16,162060.78,2819.06,534.8,2284.26,159776.52,mortgage,2,4
17,159776.52,2819.06,527.26,2291.8,157484.72,mortgage,2,4
18,157484.72,2819.06,519.7,2299.36,155185.36,mortgage,2,4
19,155185.36,2819.06,512.11,2306.95,152878.41,mortgage,2,4
20,152878.41,2819.06,504.5,2314.56,150563.85,mortgage,2,4
21,150563.85,2819.06,496.86,2322.2,148241.65,mortgage,2,4
22,148241.65,2819.06,489.2,2329.86,145911.79,mortgage,2,4
23,145911.79,2819.06,481.51,2337.55,143574.24,mortgage,2,4
24,143574.24,2819.06,473.79,2345.27,141228.97,mortgage,2,4
25,141228.97,2819.06,466.06,2353.0,138875.97,mortgage,2,4
26,138875.97,2819.06,458.29,2360.77,136515.2,mortgage,2,4
27,136515.2,2819.06,450.5,2368.56,134146.64,mortgage,2,4
28,134146.64,2819.06,442.68,2376.38,131770.26,mortgage,2,4
29,131770.26,2819.06,434.84,2384.22,129386.04,mortgage,2,4
30,129386.04,2819.06,426.97,2392.09,126993.95,mortgage,2,4
31,126993.95,2819.06,419.08,2399.98,124593.97,mortgage,2,4
32,124593.97,2819.06,411.16,2407.9,122186.07,mortgage,2,4
33,122186.07,2819.06,403.21,2415.85,119770.22,mortgage,2,4
34,119770.22,2819.06,395.24,2423.82,117346.4,mortgage,2,4
35,117346.4,2819.06,387.24,2431.82,114914.58,mortgage,2,4
36,114914.58,2819.06,379.22,2439.84,112474.74,mortgage,2,4
37,112474.74,2819.06,371.17,2447.89,110026.85,mortgage,2,4
38,110026.85,2819.06,363.09,2455.97,107570.88,mortgage,2,4
39,107570.88,2819.06,354.98,2464.08,105106.8,mortgage,2,4
40,105106.8,2819.06,346.85,2472.21,102634.59,mortgage,2,4
41,102634.59,2819.06,338.69,2480.37,100154.22,mortgage,2,4
42,100154.22,2819.06,330.51,2488.55,97665.67,mortgage,2,4
43,97665.67,2819.06,322.3,2496.76,95168.91,mortgage,2,4
44,95168.91,2819.06,314.06,2505.0,92663.91,mortgage,2,4
45,92663.91,2819.06,305.79,2513.27,90150.64,mortgage,2,4
46,90150.64,2819.06,297.5,2521.56,87629.08,mortgage,2,4
47,87629.08,2819.06,289.18,2529.88,85099.2,mortgage,2,4
48,85099.2,2819.06,280.83,2538.23,82560.97,mortgage,2,4
49,82560.97,2819.06,272.45,2546.61,80014.36,mortgage,2,4
50,80014.36,2819.06,264.05,2555.01,77459.35,mortgage,2,4
51,77459.35,2819.06,255.62,2563.44,74895.91,mortgage,2,4
52,74895.91,2819.06,247.16,2571.9,72324.01,mortgage,2,4
53,72324.01,2819.06,238.67,2580.39,69743.62,mortgage,2,4
54,69743.62,2819.06,230.15,2588.91,67154.71,mortgage,2,4
55,67154.71,2819.06,221.61,2597.45,64557.26,mortgage,2,4
56,64557.26,2819.06,213.04,2606.02,61951.24,mortgage,2,4
57,61951.24,2819.06,204.44,2614.62,59336.62,mortgage,2,4
58,59336.62,2819.06,195.81,2623.25,56713.37,mortgage,2,4
59,56713.37,2819.06,187.15,2631.91,54081.46,mortgage,2,4
60,54081.46,2819.06,178.47,2640.59,51440.87,mortgage,2,4
61,51440.87,2819.06,169.75,2649.31,48791.56,mortgage,2,4
62,48791.56,2819.06,161.01,2658.05,46133.51,mortgage,2,4
63,46133.51,2819.06,152.24,2666.82,43466.69,mortgage,2,4
64,43466.69,2819.06,143.44,2675.62,40791.07,mortgage,2,4
65,40791.07,2819.06,134.61,2684.45,38106.62,mortgage,2,4
66,38106.62,2819.06,125.75,2693.31,35413.31,mortgage,2,4
67,35413.31,2819.06,116.86,2702.2,32711.11,mortgage,2,4
68,32711.11,2819.06,107.95,2711.11,30000.0,mortgage,2,4
69,30000.0,2819.06,99.0,2720.06,27279.94,mortgage,2,4
70,27279.94,2819.06,90.02,2729.04,24550.9,mortgage,2,4
71,24550.9,2819.06,81.02,2738.04,21812.86,mortgage,2,4
72,21812.86,2819.06,71.98,2747.08,19065.78,mortgage,2,4
73,19065.78,2819.06,62.92,2756.14,16309.64,mortgage,2,4
74,16309.64,2819.06,53.82,2765.24,13544.4,mortgage,2,4
75,13544.4,2819.06,44.7,2774.36,10770.04,mortgage,2,4
76,10770.04,2819.06,35.54,2783.52,7986.52,mortgage,2,4
77,7986.52,2819.06,26.36,2792.7,5193.82,mortgage,2,4
78,5193.82,2819.06,17.14,2801.92,2391.9,mortgage,2,4
79,2391.9,2819.06,7.89,2811.17,-419.27,mortgage,2,4
0,20000.0,191.04,108.0,83.04,19916.96,WellsFargo2,2,5
1,19916.96,191.04,107.55,83.49,19833.47,WellsFargo2,2,5
2,19833.47,191.04,107.1,83.94,19749.53,WellsFargo2,2,5
3,19749.53,191.04,106.65,84.39,19665.14,WellsFargo2,2,5
4,19665.14,191.04,106.19,84.85,19580.29,WellsFargo2,2,5
5,19580.29,191.04,105.73,85.31,19494.98,WellsFargo2,2,5
6,19494.98,191.04,105.27,85.77,19409.21,WellsFargo2,2,5
7,19409.21,191.04,104.81,86.23,19322.98,WellsFargo2,2,5
8,19322.98,191.04,104.34,86.7,19236.28,WellsFargo2,2,5
9,19236.28,191.04,103.88,87.16,19149.12,WellsFargo2,2,5
10,19149.12,191.04,103.41,87.63,19061.49,WellsFargo2,2,5
11,19061.49,191.04,102.93,88.11,18973.38,WellsFargo2,2,5
12,18973.38,191.04,102.46,88.58,18884.8,WellsFargo2,2,5
13,18884.8,191.04,101.98,89.06,18795.74,WellsFargo2,2,5
14,18795.74,191.04,101.5,89.54,18706.2,WellsFargo2,2,5
15,18706.2,191.04,101.01,90.03,18616.17,WellsFargo2,2,5
16,18616.17,191.04,100.53,90.51,18525.66,WellsFargo2,2,5
17,18525.66,191.04,100.04,91.0,18434.66,WellsFargo2,2,5
18,18434.66,191.04,99.55,91.49,18343.17,WellsFargo2,2,5
19,18343.17,191.04,99.05,91.99,18251.18,WellsFargo2,2,5
20,18251.18,191.04,98.56,92.48,18158.7,WellsFargo2,2,5
21,18158.7,191.04,98.06,92.98,18065.72,WellsFargo2,2,5
22,18065.72,191.04,97.55,93.49,17972.23,WellsFargo2,2,5
23,17972.23,191.04,97.05,93.99,17878.24,WellsFargo2,2,5
24,17878.24,191.04,96.54,94.5,17783.74,WellsFargo2,2,5
25,17783.74,191.04,96.03,95.01,17688.73,WellsFargo2,2,5
26,17688.73,191.04,95.52,95.52,17593.21,WellsFargo2,2,5
27,17593.21,191.04,95.0,96.04,17497.17,WellsFargo2,2,5
28,17497.17,191.04,94.48,96.56,17400.61,WellsFargo2,2,5
29,17400.61,191.04,93.96,97.08,17303.53,WellsFargo2,2,5
30,17303.53,191.04,93.44,97.6,17205.93,WellsFargo2,2,5
31,17205.93,191.04,92.91,98.13,17107.8,WellsFargo2,2,5
32,17107.8,191.04,92.38,98.66,17009.14,WellsFargo2,2,5
33,17009.14,191.04,91.85,99.19,16909.95,WellsFargo2,2,5
34,16909.95,191.04,91.31,99.73,16810.22,WellsFargo2,2,5
35,16810.22,191.04,90.78,100.26,16709.96,WellsFargo2,2,5
36,16709.96,191.04,90.23,100.81,16609.15,WellsFargo2,2,5
37,16609.15,191.04,89.69,101.35,16507.8,WellsFargo2,2,5
38,16507.8,191.04,89.14,101.9,16405.9,WellsFargo2,2,5
39,16405.9,191.04,88.59,102.45,16303.45,WellsFargo2,2,5
40,16303.45,191.04,88.04,103.0,16200.45,WellsFargo2,2,5
41,16200.45,191.04,87.48,103.56,16096.89,WellsFargo2,2,5
42,16096.89,191.04,86.92,104.12,15992.77,WellsFargo2,2,5
43,15992.77,191.04,86.36,104.68,15888.09,WellsFargo2,2,5
44,15888.09,191.04,85.8,105.24,15782.85,WellsFargo2,2,5
45,15782.85,191.04,85.23,105.81,15677.04,WellsFargo2,2,5
46,15677.04,191.04,84.66,106.38,15570.66,WellsFargo2,2,5
47,15570.66,191.04,84.08,106.96,15463.7,WellsFargo2,2,5
48,15463.7,191.04,83.5,107.54,15356.16,WellsFargo2,2,5
49,15356.16,191.04,82.92,108.12,15248.04,WellsFargo2,2,5
50,15248.04,191.04,82.34,108.7,15139.34,WellsFargo2,2,5
51,15139.34,191.04,81.75,109.29,15030.05,WellsFargo2,2,5
52,15030.05,191.04,81.16,109.88,14920.17,WellsFargo2,2,5
53,14920.17,191.04,80.57,110.47,14809.7,WellsFargo2,2,5
54,14809.7,191.04,79.97,111.07,14698.63,WellsFargo2,2,5
55,14698.63,191.04,79.37,111.67,14586.96,WellsFargo2,2,5
56,14586.96,191.04,78.77,112.27,14474.69,WellsFargo2,2,5
57,14474.69,191.04,78.16,112.88,14361.81,WellsFargo2,2,5
58,14361.81,191.04,77.55,113.49,14248.32,WellsFargo2,2,5
59,14248.32,191.04,76.94,114.1,14134.22,WellsFargo2,2,5
60,14134.22,191.04,76.32,114.72,14019.5,WellsFargo2,2,5
61,14019.5,191.04,75.71,115.33,13904.17,WellsFargo2,2,5
62,13904.17,191.04,75.08,115.96,13788.21,WellsFargo2,2,5
63,13788.21,191.04,74.46,116.58,13671.63,WellsFargo2,2,5
64,13671.63,191.04,73.83,117.21,13554.42,WellsFargo2,2,5
65,13554.42,191.04,73.19,117.85,13436.57,WellsFargo2,2,5
66,13436.57,191.04,72.56,118.48,13318.09,WellsFargo2,2,5
67,13318.09,191.04,71.92,119.12,13198.97,WellsFargo2,2,5
68,13198.97,191.04,71.27,119.77,13079.2,WellsFargo2,2,5
69,13079.2,191.04,70.63,120.41,12958.79,WellsFargo2,2,5
70,12958.79,191.04,69.98,121.06,12837.73,WellsFargo2,2,5
71,12837.73,191.04,69.32,121.72,12716.01,WellsFargo2,2,5
72,12716.01,191.04,68.67,122.37,12593.64,WellsFargo2,2,5
73,12593.64,191.04,68.01,123.03,12470.61,WellsFargo2,2,5
74,12470.61,191.04,67.34,123.7,12346.91,WellsFargo2,2,5
75,12346.91,191.04,66.67,124.37,12222.54,WellsFargo2,2,5
76,12222.54,191.04,66.0,125.04,12097.5,WellsFargo2,2,5
77,12097.5,191.04,65.33,125.71,11971.79,WellsFargo2,2,5
78,11971.79,191.04,64.65,126.39,11845.4,WellsFargo2,2,5
79,11845.4,610.31,63.97,546.34,11299.06,WellsFargo2,2,5
80,11299.06,3010.1,61.01,2949.09,8349.97,WellsFargo2,2,5
81,8349.97,3010.1,45.09,2965.01,5384.96,WellsFargo2,2,5
82,5384.96,3010.1,29.08,2981.02,2403.94,WellsFargo2,2,5
83,2403.94,3010.1,12.98,2997.12,-593.18,WellsFargo2,2,5
0,4000.0,1070.0,16.0,1054.0,2946.0,testing,3,1
1,2946.0,1070.0,11.78,1058.22,1887.78,testing,3,1
2,1887.78,1070.0,7.55,1062.45,825.33,testing,3,1
3,825.33,1070.0,3.3,1066.7,-241.37,testing,3,1
0,5000.0,333.0,36.0,297.0,4703.0,Car,3,2
1,4703.0,333.0,33.86,299.14,4403.86,Car,3,2
2,4403.86,333.0,31.71,301.29,4102.57,Car,3,2
3,4102.57,574.37,29.54,544.83,3557.74,Car,3,2
4,3557.74,1403.0,25.62,1377.38,2180.36,Car,3,2
5,2180.36,1403.0,15.7,1387.3,793.06,Car,3,2
6,793.06,1403.0,5.71,1397.29,-604.23,Car,3,2
0,20000.0,191.04,108.0,83.04,19916.96,WellsFargo2,3,3
1,19916.96,191.04,107.55,83.49,19833.47,WellsFargo2,3,3
2,19833.47,191.04,107.1,83.94,19749.53,WellsFargo2,3,3
3,19749.53,191.04,106.65,84.39,19665.14,WellsFargo2,3,3
4,19665.14,191.04,106.19,84.85,19580.29,WellsFargo2,3,3
5,19580.29,191.04,105.73,85.31,19494.98,WellsFargo2,3,3
6,19494.98,795.27,105.27,690.0,18804.98,WellsFargo2,3,3
7,18804.98,1594.04,101.55,1492.49,17312.49,WellsFargo2,3,3
8,17312.49,1594.04,93.49,1500.55,15811.94,WellsFargo2,3,3
9,15811.94,1594.04,85.38,1508.66,14303.28,WellsFargo2,3,3
10,14303.28,1594.04,77.24,1516.8,12786.48,WellsFargo2,3,3
11,12786.48,1594.04,69.05,1524.99,11261.49,WellsFargo2,3,3
12,11261.49,1594.04,60.81,1533.23,9728.26,WellsFargo2,3,3
13,9728.26,1594.04,52.53,1541.51,8186.75,WellsFargo2,3,3
14,8186.75,1594.04,44.21,1549.83,6636.92,WellsFargo2,3,3
15,6636.92,1594.04,35.84,1558.2,5078.72,WellsFargo2,3,3
16,5078.72,1594.04,27.43,1566.61,3512.11,WellsFargo2,3,3
17,3512.11,1594.04,18.97,1575.07,1937.04,WellsFargo2,3,3
18,1937.04,1594.04,10.46,1583.58,353.46,WellsFargo2,3,3
19,353.46,1594.04,1.91,1592.13,-1238.67,WellsFargo2,3,3
0,8250.57,84.62,53.63,30.99,8219.58,WellsFargo1,3,4
1,8219.58,84.62,53.43,31.19,8188.39,WellsFargo1,3,4
2,8188.39,84.62,53.22,31.4,8156.99,WellsFargo1,3,4
3,8156.99,84.62,53.02,31.6,8125.39,WellsFargo1,3,4
4,8125.39,84.62,52.82,31.8,8093.59,WellsFargo1,3,4
5,8093.59,84.62,52.61,32.01,8061.58,WellsFargo1,3,4
6,8061.58,84.62,52.4,32.22,8029.36,WellsFargo1,3,4
7,8029.36,84.62,52.19,32.43,7996.93,WellsFargo1,3,4
8,7996.93,84.62,51.98,32.64,7964.29,WellsFargo1,3,4
9,7964.29,84.62,51.77,32.85,7931.44,WellsFargo1,3,4
10,7931.44,84.62,51.55,33.07,7898.37,WellsFargo1,3,4
11,7898.37,84.62,51.34,33.28,7865.09,WellsFargo1,3,4
12,7865.09,84.62,51.12,33.5,7831.59,WellsFargo1,3,4
13,7831.59,84.62,50.91,33.71,7797.88,WellsFargo1,3,4
14,7797.88,84.62,50.69,33.93,7763.95,WellsFargo1,3,4
15,7763.95,84.62,50.47,34.15,7729.8,WellsFargo1,3,4
16,7729.8,84.62,50.24,34.38,7695.42,WellsFargo1,3,4
17,7695.42,84.62,50.02,34.6,7660.82,WellsFargo1,3,4
18,7660.82,84.62,49.8,34.82,7626.0,WellsFargo1,3,4
19,7626.0,1323.29,49.57,1273.72,6352.28,WellsFargo1,3,4
20,6352.28,1678.66,41.29,1637.37,4714.91,WellsFargo1,3,4
21,4714.91,1678.66,30.65,1648.01,3066.9,WellsFargo1,3,4
22,3066.9,1678.66,19.93,1658.73,1408.17,WellsFargo1,3,4
23,1408.17,1678.66,9.15,1669.51,-261.34,WellsFargo1,3,4
0,180000.0,1331.44,594.0,737.44,179262.56,mortgage,3,5
1,179262.56,1331.44,591.57,739.87,178522.69,mortgage,3,5
2,178522.69,1331.44,589.12,742.32,177780.37,mortgage,3,5
3,177780.37,1331.44,586.68,744.76,177035.61,mortgage,3,5
4,177035.61,1331.44,584.22,747.22,176288.39,mortgage,3,5
5,176288.39,1331.44,581.75,749.69,175538.7,mortgage,3,5
6,175538.7,1331.44,579.28,752.16,174786.54,mortgage,3,5
7,174786.54,1331.44,576.8,754.64,174031.9,mortgage,3,5
8,174031.9,1331.44,574.31,757.13,173274.77,mortgage,3,5
9,173274.77,1331.44,571.81,759.63,172515.14,mortgage,3,5
10,172515.14,1331.44,569.3,762.14,171753.0,mortgage,3,5
11,171753.0,1331.44,566.78,764.66,170988.34,mortgage,3,5
12,170988.34,1331.44,564.26,767.18,170221.16,mortgage,3,5
13,170221.16,1331.44,561.73,769.71,169451.45,mortgage,3,5
14,169451.45,1331.44,559.19,772.25,168679.2,mortgage,3,5
15,168679.2,1331.44,556.64,774.8,167904.4,mortgage,3,5
16,167904.4,1331.44,554.08,777.36,167127.04,mortgage,3,5
17,167127.04,1331.44,551.52,779.92,166347.12,mortgage,3,5
18,166347.12,1331.44,548.95,782.49,165564.63,mortgage,3,5
19,165564.63,1331.44,546.36,785.08,164779.55,mortgage,3,5
20,164779.55,1331.44,543.77,787.67,163991.88,mortgage,3,5
21,163991.88,1331.44,541.17,790.27,163201.61,mortgage,3,5
22,163201.61,1331.44,538.57,792.87,162408.74,mortgage,3,5
23,162408.74,1592.78,535.95,1056.83,161351.91,mortgage,3,5
24,161351.91,3010.1,532.46,2477.64,158874.27,mortgage,3,5
25,158874.27,3010.1,524.29,2485.81,156388.46,mortgage,3,5
26,156388.46,3010.1,516.08,2494.02,153894.44,mortgage,3,5
27,153894.44,3010.1,507.85,2502.25,151392.19,mortgage,3,5
28,151392.19,3010.1,499.59,2510.51,148881.68,mortgage,3,5
29,148881.68,3010.1,491.31,2518.79,146362.89,mortgage,3,5
30,146362.89,3010.1,483.0,2527.1,143835.79,mortgage,3,5
31,143835.79,3010.1,474.66,2535.44,141300.35,mortgage,3,5
32,141300.35,3010.1,466.29,2543.81,138756.54,mortgage,3,5
33,138756.54,3010.1,457.9,2552.2,136204.34,mortgage,3,5
34,136204.34,3010.1,449.47,2560.63,133643.71,mortgage,3,5
35,133643.71,3010.1,441.02,2569.08,131074.63,mortgage,3,5
36,131074.63,3010.1,432.55,2577.55,128497.08,mortgage,3,5
37,128497.08,3010.1,424.04,2586.06,125911.02,mortgage,3,5
38,125911.02,3010.1,415.51,2594.59,123316.43,mortgage,3,5
39,123316.43,3010.1,406.94,2603.16,120713.27,mortgage,3,5
40,120713.27,3010.1,398.35,2611.75,118101.52,mortgage,3,5
41,118101.52,3010.1,389.74,2620.36,115481.16,mortgage,3,5
42,115481.16,3010.1,381.09,2629.01,112852.15,mortgage,3,5
43,112852.15,3010.1,372.41,2637.69,110214.46,mortgage,3,5
44,110214.46,3010.1,363.71,2646.39,107568.07,mortgage,3,5
45,107568.07,3010.1,354.97,2655.13,104912.94,mortgage,3,5
46,104912.94,3010.1,346.21,2663.89,102249.05,mortgage,3,5
47,102249.05,3010.1,337.42,2672.68,99576.37,mortgage,3,5
48,99576.37,3010.1,328.6,2681.5,96894.87,mortgage,3,5
49,96894.87,3010.1,319.75,2690.35,94204.52,mortgage,3,5
50,94204.52,3010.1,310.87,2699.23,91505.29,mortgage,3,5
51,91505.29,3010.1,301.97,2708.13,88797.16,mortgage,3,5
52,88797.16,3010.1,293.03,2717.07,86080.09,mortgage,3,5
53,86080.09,3010.1,284.06,2726.04,83354.05,mortgage,3,5
54,83354.05,3010.1,275.07,2735.03,80619.02,mortgage,3,5
55,80619.02,3010.1,266.04,2744.06,77874.96,mortgage,3,5
56,77874.96,3010.1,256.99,2753.11,75121.85,mortgage,3,5
57,75121.85,3010.1,247.9,2762.2,72359.65,mortgage,3,5
58,72359.65,3010.1,238.79,2771.31,69588.34,mortgage,3,5
59,69588.34,3010.1,229.64,2780.46,66807.88,mortgage,3,5
60,66807.88,3010.1,220.47,2789.63,64018.25,mortgage,3,5
61,64018.25,3010.1,211.26,2798.84,61219.41,mortgage,3,5
62,61219.41,3010.1,202.02,2808.08,58411.33,mortgage,3,5
63,58411.33,3010.1,192.76,2817.34,55593.99,mortgage,3,5
64,55593.99,3010.1,183.46,2826.64,52767.35,mortgage,3,5
65,52767.35,3010.1,174.13,2835.97,49931.38,mortgage,3,5
66,49931.38,3010.1,164.77,2845.33,47086.05,mortgage,3,5
67,47086.05,3010.1,155.38,2854.72,44231.33,mortgage,3,5
68,44231.33,3010.1,145.96,2864.14,41367.19,mortgage,3,5
69,41367.19,3010.1,136.51,2873.59,38493.6,mortgage,3,5
70,38493.6,3010.1,127.03,2883.07,35610.53,mortgage,3,5
71,35610.53,3010.1,117.51,2892.59,32717.94,mortgage,3,5
72,32717.94,3010.1,107.97,2902.13,29815.81,mortgage,3,5
73,29815.81,3010.1,98.39,2911.71,26904.1,mortgage,3,5
74,26904.1,3010.1,88.78,2921.32,23982.78,mortgage,3,5
75,23982.78,3010.1,79.14,2930.96,21051.82,mortgage,3,5
76,21051.82,3010.1,69.47,2940.63,18111.19,mortgage,3,5
77,18111.19,3010.1,59.77,2950.33,15160.86,mortgage,3,5
78,15160.86,3010.1,50.03,2960.07,12200.79,mortgage,3,5
79,12200.79,3010.1,40.26,2969.84,9230.95,mortgage,3,5
80,9230.95,3010.1,30.46,2979.64,6251.31,mortgage,3,5
81,6251.31,3010.1,20.63,2989.47,3261.84,mortgage,3,5
82,3261.84,3010.1,10.76,2999.34,262.5,mortgage,3,5
83,262.5,3010.1,0.87,3009.23,-2746.73,mortgage,3,5
0,4000.0,1070.0,16.0,1054.0,2946.0,testing,4,1
1,2946.0,1070.0,11.78,1058.22,1887.78,testing,4,1
2,1887.78,1070.0,7.55,1062.45,825.33,testing,4,1
3,825.33,1070.0,3.3,1066.7,-241.37,testing,4,1
0,5000.0,333.0,36.0,297.0,4703.0,Car,4,2
1,4703.0,333.0,33.86,299.14,4403.86,Car,4,2
2,4403.86,333.0,31.71,301.29,4102.57,Car,4,2
3,4102.57,574.37,29.54,544.83,3557.74,Car,4,2
4,3557.74,1403.0,25.62,1377.38,2180.36,Car,4,2
5,2180.36,1403.0,15.7,1387.3,793.06,Car,4,2
6,793.06,1403.0,5.71,1397.29,-604.23,Car,4,2
0,20000.0,191.04,108.0,83.04,19916.96,WellsFargo2,4,3
1,19916.96,191.04,107.55,83.49,19833.47,WellsFargo2,4,3
2,19833.47,191.04,107.1,83.94,19749.53,WellsFargo2,4,3
3,19749.53,191.04,106.65,84.39,19665.14,WellsFargo2,4,3
4,19665.14,191.04,106.19,84.85,19580.29,WellsFargo2,4,3
5,19580.29,191.04,105.73,85.31,19494.98,WellsFargo2,4,3
6,19494.98,795.27,105.27,690.0,18804.98,WellsFargo2,4,3
7,18804.98,1594.04,101.55,1492.49,17312.49,WellsFargo2,4,3
8,17312.49,1594.04,93.49,1500.55,15811.94,WellsFargo2,4,3
9,15811.94,1594.04,85.38,1508.66,14303.28,WellsFargo2,4,3
10,14303.28,1594.04,77.24,1516.8,12786.48,WellsFargo2,4,3
11,12786.48,1594.04,69.05,1524.99,11261.49,WellsFargo2,4,3
12,11261.49,1594.04,60.81,1533.23,9728.26,WellsFargo2,4,3
13,9728.26,1594.04,52.53,1541.51,8186.75,WellsFargo2,4,3
14,8186.75,1594.04,44.21,1549.83,6636.92,WellsFargo2,4,3
15,6636.92,1594.04,35.84,1558.2,5078.72,WellsFargo2,4,3
16,5078.72,1594.04,27.43,1566.61,3512.11,WellsFargo2,4,3
17,3512.11,1594.04,18.97,1575.07,1937.04,WellsFargo2,4,3
18,1937.04,1594.04,10.46,1583.58,353.46,WellsFargo2,4,3
19,353.46,1594.04,1.91,1592.13,-1238.67,WellsFargo2,4,3
0,180000.0,1331.44,594.0,737.44,179262.56,mortgage,4,4
1,179262.56,1331.44,591.57,739.87,178522.69,mortgage,4,4
2,178522.69,1331.44,589.12,742.32,177780.37,mortgage,4,4
3,177780.37,1331.44,586.68,744.76,177035.61,mortgage,4,4
4,177035.61,1331.44,584.22,747.22,176288.39,mortgage,4,4
5,176288.39,1331.44,581.75,749.69,175538.7,mortgage,4,4
6,175538.7,1331.44,579.28,752.16,174786.54,mortgage,4,4
7,174786.54,1331.44,576.8,754.64,174031.9,mortgage,4,4
8,174031.9,1331.44,574.31,757.13,173274.77,mortgage,4,4
9,173274.77,1331.44,571.81,759.63,172515.14,mortgage,4,4
10,172515.14,1331.44,569.3,762.14,171753.0,mortgage,4,4
11,171753.0,1331.44,566.78,764.66,170988.34,mortgage,4,4
12,170988.34,1331.44,564.26,767.18,170221.16,mortgage,4,4
13,170221.16,1331.44,561.73,769.71,169451.45,mortgage,4,4
14,169451.45,1331.44,559.19,772.25,168679.2,mortgage,4,4
15,168679.2,1331.44,556.64,774.8,167904.4,mortgage,4,4
16,167904.4,1331.44,554.08,777.36,167127.04,mortgage,4,4
17,167127.04,1331.44,551.52,779.92,166347.12,mortgage,4,4
18,166347.12,1331.44,548.95,782.49,165564.63,mortgage,4,4
19,165564.63,2570.11,546.36,2023.75,163540.88,mortgage,4,4
20,163540.88,2925.48,539.68,2385.8,161155.08,mortgage,4,4
21,161155.08,2925.48,531.81,2393.67,158761.41,mortgage,4,4
22,158761.41,2925.48,523.91,2401.57,156359.84,mortgage,4,4
23,156359.84,2925.48,515.99,2409.49,153950.35,mortgage,4,4
24,153950.35,2925.48,508.04,2417.44,151532.91,mortgage,4,4
25,151532.91,2925.48,500.06,2425.42,149107.49,mortgage,4,4
26,149107.49,2925.48,492.05,2433.43,146674.06,mortgage,4,4
27,146674.06,2925.48,484.02,2441.46,144232.6,mortgage,4,4
28,144232.6,2925.48,475.97,2449.51,141783.09,mortgage,4,4
29,141783.09,2925.48,467.88,2457.6,139325.49,mortgage,4,4
30,139325.49,2925.48,459.77,2465.71,136859.78,mortgage,4,4
31,136859.78,2925.48,451.64,2473.84,134385.94,mortgage,4,4
32,134385.94,2925.48,443.47,2482.01,131903.93,mortgage,4,4
33,131903.93,2925.48,435.28,2490.2,129413.73,mortgage,4,4
34,129413.73,2925.48,427.07,2498.41,126915.32,mortgage,4,4
35,126915.32,2925.48,418.82,2506.66,124408.66,mortgage,4,4
36,124408.66,2925.48,410.55,2514.93,121893.73,mortgage,4,4
37,121893.73,2925.48,402.25,2523.23,119370.5,mortgage,4,4
38,119370.5,2925.48,393.92,2531.56,116838.94,mortgage,4,4
39,116838.94,2925.48,385.57,2539.91,114299.03,mortgage,4,4
40,114299.03,2925.48,377.19,2548.29,111750.74,mortgage,4,4
41,111750.74,2925.48,368.78,2556.7,109194.04,mortgage,4,4
42,109194.04,2925.48,360.34,2565.14,106628.9,mortgage,4,4
43,106628.9,2925.48,351.88,2573.6,104055.3,mortgage,4,4
44,104055.3,2925.48,343.38,2582.1,101473.2,mortgage,4,4
45,101473.2,2925.48,334.86,2590.62,98882.58,mortgage,4,4
46,98882.58,2925.48,326.31,2599.17,96283.41,mortgage,4,4
47,96283.41,2925.48,317.74,2607.74,93675.67,mortgage,4,4
48,93675.67,2925.48,309.13,2616.35,91059.32,mortgage,4,4
49,91059.32,2925.48,300.5,2624.98,88434.34,mortgage,4,4
50,88434.34,2925.48,291.83,2633.65,85800.69,mortgage,4,4
51,85800.69,2925.48,283.14,2642.34,83158.35,mortgage,4,4
52,83158.35,2925.48,274.42,2651.06,80507.29,mortgage,4,4
53,80507.29,2925.48,265.67,2659.81,77847.48,mortgage,4,4
54,77847.48,2925.48,256.9,2668.58,75178.9,mortgage,4,4
55,75178.9,2925.48,248.09,2677.39,72501.51,mortgage,4,4
56,72501.51,2925.48,239.25,2686.23,69815.28,mortgage,4,4
57,69815.28,2925.48,230.39,2695.09,67120.19,mortgage,4,4
58,67120.19,2925.48,221.5,2703.98,64416.21,mortgage,4,4
59,64416.21,2925.48,212.57,2712.91,61703.3,mortgage,4,4
60,61703.3,2925.48,203.62,2721.86,58981.44,mortgage,4,4
61,58981.44,2925.48,194.64,2730.84,56250.6,mortgage,4,4
62,56250.6,2925.48,185.63,2739.85,53510.75,mortgage,4,4
63,53510.75,2925.48,176.59,2748.89,50761.86,mortgage,4,4
64,50761.86,2925.48,167.51,2757.97,48003.89,mortgage,4,4
65,48003.89,2925.48,158.41,2767.07,45236.82,mortgage,4,4
66,45236.82,2925.48,149.28,2776.2,42460.62,mortgage,4,4
67,42460.62,2925.48,140.12,2785.36,39675.26,mortgage,4,4
68,39675.26,2925.48,130.93,2794.55,36880.71,mortgage,4,4
69,36880.71,2925.48,121.71,2803.77,34076.94,mortgage,4,4
70,34076.94,2925.48,112.45,2813.03,31263.91,mortgage,4,4
71,31263.91,2925.48,103.17,2822.31,28441.6,mortgage,4,4
72,28441.6,2925.48,93.86,2831.62,25609.98,mortgage,4,4
73,25609.98,2925.48,84.51,2840.97,22769.01,mortgage,4,4
74,22769.01,2925.48,75.14,2850.34,19918.67,mortgage,4,4
75,19918.67,2925.48,65.73,2859.75,17058.92,mortgage,4,4
76,17058.92,2925.48,56.29,2869.19,14189.73,mortgage,4,4
77,14189.73,2925.48,46.83,2878.65,11311.08,mortgage,4,4
78,11311.08,2925.48,37.33,2888.15,8422.93,mortgage,4,4
79,8422.93,2925.48,27.8,2897.68,5525.25,mortgage,4,4
80,5525.25,2925.48,18.23,2907.25,2618.0,mortgage,4,4
81,2618.0,2925.48,8.64,2916.84,-298.84,mortgage,4,4
0,8250.57,84.62,53.63,30.99,8219.58,WellsFargo1,4,5
1,8219.58,84.62,53.43,31.19,8188.39,WellsFargo1,4,5
2,8188.39,84.62,53.22,31.4,8156.99,WellsFargo1,4,5
3,8156.99,84.62,53.02,31.6,8125.39,WellsFargo1,4,5
4,8125.39,84.62,52.82,31.8,8093.59,WellsFargo1,4,5
5,8093.59,84.62,52.61,32.01,8061.58,WellsFargo1,4,5
6,8061.58,84.62,52.4,32.22,8029.36,WellsFargo1,4,5
7,8029.36,84.62,52.19,32.43,7996.93,WellsFargo1,4,5
8,7996.93,84.62,51.98,32.64,7964.29,WellsFargo1,4,5
9,7964.29,84.62,51.77,32.85,7931.44,WellsFargo1,4,5
10,7931.44,84.62,51.55,33.07,7898.37,WellsFargo1,4,5
11,7898.37,84.62,51.34,33.28,7865.09,WellsFargo1,4,5
12,7865.09,84.62,51.12,33.5,7831.59,WellsFargo1,4,5
13,7831.59,84.62,50.91,33.71,7797.88,WellsFargo1,4,5
14,7797.88,84.62,50.69,33.93,7763.95,WellsFargo1,4,5
15,7763.95,84.62,50.47,34.15,7729.8,WellsFargo1,4,5
16,7729.8,84.62,50.24,34.38,7695.42,WellsFargo1,4,5
17,7695.42,84.62,50.02,34.6,7660.82,WellsFargo1,4,5
18,7660.82,84.62,49.8,34.82,7626.0,WellsFargo1,4,5
19,7626.0,84.62,49.57,35.05,7590.95,WellsFargo1,4,5
20,7590.95,84.62,49.34,35.28,7555.67,WellsFargo1,4,5
21,7555.67,84.62,49.11,35.51,7520.16,WellsFargo1,4,5
22,7520.16,84.62,48.88,35.74,7484.42,WellsFargo1,4,5
23,7484.42,84.62,48.65,35.97,7448.45,WellsFargo1,4,5
24,7448.45,84.62,48.41,36.21,7412.24,WellsFargo1,4,5
25,7412.24,84.62,48.18,36.44,7375.8,WellsFargo1,4,5
26,7375.8,84.62,47.94,36.68,7339.12,WellsFargo1,4,5
27,7339.12,84.62,47.7,36.92,7302.2,WellsFargo1,4,5
28,7302.2,84.62,47.46,37.16,7265.04,WellsFargo1,4,5
29,7265.04,84.62,47.22,37.4,7227.64,WellsFargo1,4,5
30,7227.64,84.62,46.98,37.64,7190.0,WellsFargo1,4,5
31,7190.0,84.62,46.73,37.89,7152.11,WellsFargo1,4,5
32,7152.11,84.62,46.49,38.13,7113.98,WellsFargo1,4,5
33,7113.98,84.62,46.24,38.38,7075.6,WellsFargo1,4,5
34,7075.6,84.62,45.99,38.63,7036.97,WellsFargo1,4,5
35,7036.97,84.62,45.74,38.88,6998.09,WellsFargo1,4,5
36,6998.09,84.62,45.49,39.13,6958.96,WellsFargo1,4,5
37,6958.96,84.62,45.23,39.39,6919.57,WellsFargo1,4,5
38,6919.57,84.62,44.98,39.64,6879.93,WellsFargo1,4,5
39,6879.93,84.62,44.72,39.9,6840.03,WellsFargo1,4,5
40,6840.03,84.62,44.46,40.16,6799.87,WellsFargo1,4,5
41,6799.87,84.62,44.2,40.42,6759.45,WellsFargo1,4,5
42,6759.45,84.62,43.94,40.68,6718.77,WellsFargo1,4,5
43,6718.77,84.62,43.67,40.95,6677.82,WellsFargo1,4,5
44,6677.82,84.62,43.41,41.21,6636.61,WellsFargo1,4,5
45,6636.61,84.62,43.14,41.48,6595.13,WellsFargo1,4,5
46,6595.13,84.62,42.87,41.75,6553.38,WellsFargo1,4,5
47,6553.38,84.62,42.6,42.02,6511.36,WellsFargo1,4,5
48,6511.36,84.62,42.32,42.3,6469.06,WellsFargo1,4,5
49,6469.06,84.62,42.05,42.57,6426.49,WellsFargo1,4,5
50,6426.49,84.62,41.77,42.85,6383.64,WellsFargo1,4,5
51,6383.64,84.62,41.49,43.13,6340.51,WellsFargo1,4,5
52,6340.51,84.62,41.21,43.41,6297.1,WellsFargo1,4,5
53,6297.1,84.62,40.93,43.69,6253.41,WellsFargo1,4,5
54,6253.41,84.62,40.65,43.97,6209.44,WellsFargo1,4,5
55,6209.44,84.62,40.36,44.26,6165.18,WellsFargo1,4,5
56,6165.18,84.62,40.07,44.55,6120.63,WellsFargo1,4,5
57,6120.63,84.62,39.78,44.84,6075.79,WellsFargo1,4,5
58,6075.79,84.62,39.49,45.13,6030.66,WellsFargo1,4,5
59,6030.66,84.62,39.2,45.42,5985.24,WellsFargo1,4,5
60,5985.24,84.62,38.9,45.72,5939.52,WellsFargo1,4,5
61,5939.52,84.62,38.61,46.01,5893.51,WellsFargo1,4,5
62,5893.51,84.62,38.31,46.31,5847.2,WellsFargo1,4,5
63,5847.2,84.62,38.01,46.61,5800.59,WellsFargo1,4,5
64,5800.59,84.62,37.7,46.92,5753.67,WellsFargo1,4,5
65,5753.67,84.62,37.4,47.22,5706.45,WellsFargo1,4,5
66,5706.45,84.62,37.09,47.53,5658.92,WellsFargo1,4,5
67,5658.92,84.62,36.78,47.84,5611.08,WellsFargo1,4,5
68,5611.08,84.62,36.47,48.15,5562.93,WellsFargo1,4,5
69,5562.93,84.62,36.16,48.46,5514.47,WellsFargo1,4,5
70,5514.47,84.62,35.84,48.78,5465.69,WellsFargo1,4,5
71,5465.69,84.62,35.53,49.09,5416.6,WellsFargo1,4,5
72,5416.6,84.62,35.21,49.41,5367.19,WellsFargo1,4,5
73,5367.19,84.62,34.89,49.73,5317.46,WellsFargo1,4,5
74,5317.46,84.62,34.56,50.06,5267.4,WellsFargo1,4,5
75,5267.4,84.62,34.24,50.38,5217.02,WellsFargo1,4,5
76,5217.02,84.62,33.91,50.71,5166.31,WellsFargo1,4,5
77,5166.31,84.62,33.58,51.04,5115.27,WellsFargo1,4,5
78,5115.27,84.62,33.25,51.37,5063.9,WellsFargo1,4,5
79,5063.9,84.62,32.92,51.7,5012.2,WellsFargo1,4,5
80,5012.2,84.62,32.58,52.04,4960.16,WellsFargo1,4,5
81,4960.16,383.46,32.24,351.22,4608.94,WellsFargo1,4,5
82,4608.94,3010.1,29.96,2980.14,1628.8,WellsFargo1,4,5
83,1628.8,3010.1,10.59,2999.51,-1370.71,WellsFargo1,4,5
0,4000.0,1070.0,16.0,1054.0,2946.0,testing,5,1
1,2946.0,1070.0,11.78,1058.22,1887.78,testing,5,1
2,1887.78,1070.0,7.55,1062.45,825.33,testing,5,1
3,825.33,1070.0,3.3,1066.7,-241.37,testing,5,1
0,5000.0,333.0,36.0,297.0,4703.0,Car,5,2
1,4703.0,333.0,33.86,299.14,4403.86,Car,5,2
2,4403.86,333.0,31.71,301.29,4102.57,Car,5,2
3,4102.57,574.37,29.54,544.83,3557.74,Car,5,2
4,3557.74,1403.0,25.62,1377.38,2180.36,Car,5,2
5,2180.36,1403.0,15.7,1387.3,793.06,Car,5,2
6,793.06,1403.0,5.71,1397.29,-604.23,Car,5,2
0,180000.0,1331.44,594.0,737.44,179262.56,mortgage,5,3
1,179262.56,1331.44,591.57,739.87,178522.69,mortgage,5,3
2,178522.69,1331.44,589.12,742.32,177780.37,mortgage,5,3
3,177780.37,1331.44,586.68,744.76,177035.61,mortgage,5,3
4,177035.61,1331.44,584.22,747.22,176288.39,mortgage,5,3
5,176288.39,1331.44,581.75,749.69,175538.7,mortgage,5,3
6,175538.7,1935.67,579.28,1356.39,174182.31,mortgage,5,3
7,174182.31,2734.44,574.8,2159.64,172022.67,mortgage,5,3
8,172022.67,2734.44,567.67,2166.77,169855.9,mortgage,5,3
9,169855.9,2734.44,560.52,2173.92,167681.98,mortgage,5,3
10,167681.98,2734.44,553.35,2181.09,165500.89,mortgage,5,3
11,165500.89,2734.44,546.15,2188.29,163312.6,mortgage,5,3
12,163312.6,2734.44,538.93,2195.51,161117.09,mortgage,5,3
13,161117.09,2734.44,531.69,2202.75,158914.34,mortgage,5,3
14,158914.34,2734.44,524.42,2210.02,156704.32,mortgage,5,3
15,156704.32,2734.44,517.12,2217.32,154487.0,mortgage,5,3
16,154487.0,2734.44,509.81,2224.63,152262.37,mortgage,5,3
17,152262.37,2734.44,502.47,2231.97,150030.4,mortgage,5,3
18,150030.4,2734.44,495.1,2239.34,147791.06,mortgage,5,3
19,147791.06,2734.44,487.71,2246.73,145544.33,mortgage,5,3
20,145544.33,2734.44,480.3,2254.14,143290.19,mortgage,5,3
21,143290.19,2734.44,472.86,2261.58,141028.61,mortgage,5,3
22,141028.61,2734.44,465.39,2269.05,138759.56,mortgage,5,3
23,138759.56,2734.44,457.91,2276.53,136483.03,mortgage,5,3
24,136483.03,2734.44,450.39,2284.05,134198.98,mortgage,5,3
25,134198.98,2734.44,442.86,2291.58,131907.4,mortgage,5,3
26,131907.4,2734.44,435.29,2299.15,129608.25,mortgage,5,3
27,129608.25,2734.44,427.71,2306.73,127301.52,mortgage,5,3
28,127301.52,2734.44,420.1,2314.34,124987.18,mortgage,5,3
29,124987.18,2734.44,412.46,2321.98,122665.2,mortgage,5,3
30,122665.2,2734.44,404.8,2329.64,120335.56,mortgage,5,3
31,120335.56,2734.44,397.11,2337.33,117998.23,mortgage,5,3
32,117998.23,2734.44,389.39,2345.05,115653.18,mortgage,5,3
33,115653.18,2734.44,381.66,2352.78,113300.4,mortgage,5,3
34,113300.4,2734.44,373.89,2360.55,110939.85,mortgage,5,3
35,110939.85,2734.44,366.1,2368.34,108571.51,mortgage,5,3
36,108571.51,2734.44,358.29,2376.15,106195.36,mortgage,5,3
37,106195.36,2734.44,350.44,2384.0,103811.36,mortgage,5,3
38,103811.36,2734.44,342.58,2391.86,101419.5,mortgage,5,3
39,101419.5,2734.44,334.68,2399.76,99019.74,mortgage,5,3
40,99019.74,2734.44,326.77,2407.67,96612.07,mortgage,5,3
41,96612.07,2734.44,318.82,2415.62,94196.45,mortgage,5,3
42,94196.45,2734.44,310.85,2423.59,91772.86,mortgage,5,3
43,91772.86,2734.44,302.85,2431.59,89341.27,mortgage,5,3
44,89341.27,2734.44,294.83,2439.61,86901.66,mortgage,5,3
45,86901.66,2734.44,286.78,2447.66,84454.0,mortgage,5,3
46,84454.0,2734.44,278.7,2455.74,81998.26,mortgage,5,3
47,81998.26,2734.44,270.59,2463.85,79534.41,mortgage,5,3
48,79534.41,2734.44,262.46,2471.98,77062.43,mortgage,5,3
49,77062.43,2734.44,254.31,2480.13,74582.3,mortgage,5,3
50,74582.3,2734.44,246.12,2488.32,72093.98,mortgage,5,3
51,72093.98,2734.44,237.91,2496.53,69597.45,mortgage,5,3
52,69597.45,2734.44,229.67,2504.77,67092.68,mortgage,5,3
53,67092.68,2734.44,221.41,2513.03,64579.65,mortgage,5,3
54,64579.65,2734.44,213.11,2521.33,62058.32,mortgage,5,3
55,62058.32,2734.44,204.79,2529.65,59528.67,mortgage,5,3
56,59528.67,2734.44,196.44,2538.0,56990.67,mortgage,5,3
57,56990.67,2734.44,188.07,2546.37,54444.3,mortgage,5,3
58,54444.3,2734.44,179.67,2554.77,51889.53,mortgage,5,3
59,51889.53,2734.44,171.24,2563.2,49326.33,mortgage,5,3
60,49326.33,2734.44,162.78,2571.66,46754.67,mortgage,5,3
61,46754.67,2734.44,154.29,2580.15,44174.52,mortgage,5,3
62,44174.52,2734.44,145.78,2588.66,41585.86,mortgage,5,3
63,41585.86,2734.44,137.23,2597.21,38988.65,mortgage,5,3
64,38988.65,2734.44,128.66,2605.78,36382.87,mortgage,5,3
65,36382.87,2734.44,120.06,2614.38,33768.49,mortgage,5,3
66,33768.49,2734.44,111.44,2623.0,31145.49,mortgage,5,3
67,31145.49,2734.44,102.78,2631.66,28513.83,mortgage,5,3
68,28513.83,2734.44,94.1,2640.34,25873.49,mortgage,5,3
69,25873.49,2734.44,85.38,2649.06,23224.43,mortgage,5,3
70,23224.43,2734.44,76.64,2657.8,20566.63,mortgage,5,3
71,20566.63,2734.44,67.87,2666.57,17900.06,mortgage,5,3
72,17900.06,2734.44,59.07,2675.37,15224.69,mortgage,5,3
73,15224.69,2734.44,50.24,2684.2,12540.49,mortgage,5,3
74,12540.49,2734.44,41.38,2693.06,9847.43,mortgage,5,3
75,9847.43,2734.44,32.5,2701.94,7145.49,mortgage,5,3
76,7145.49,2734.44,23.58,2710.86,4434.63,mortgage,5,3
77,4434.63,2734.44,14.63,2719.81,1714.82,mortgage,5,3
78,1714.82,2734.44,5.66,2728.78,-1013.96,mortgage,5,3
0,8250.57,84.62,53.63,30.99,8219.58,WellsFargo1,5,4
1,8219.58,84.62,53.43,31.19,8188.39,WellsFargo1,5,4
2,8188.39,84.62,53.22,31.4,8156.99,WellsFargo1,5,4
3,8156.99,84.62,53.02,31.6,8125.39,WellsFargo1,5,4
4,8125.39,84.62,52.82,31.8,8093.59,WellsFargo1,5,4
5,8093.59,84.62,52.61,32.01,8061.58,WellsFargo1,5,4
6,8061.58,84.62,52.4,32.22,8029.36,WellsFargo1,5,4
7,8029.36,84.62,52.19,32.43,7996.93,WellsFargo1,5,4
8,7996.93,84.62,51.98,32.64,7964.29,WellsFargo1,5,4
9,7964.29,84.62,51.77,32.85,7931.44,WellsFargo1,5,4
10,7931.44,84.62,51.55,33.07,7898.37,WellsFargo1,5,4
11,7898.37,84.62,51.34,33.28,7865.09,WellsFargo1,5,4
12,7865.09,84.62,51.12,33.5,7831.59,WellsFargo1,5,4
13,7831.59,84.62,50.91,33.71,7797.88,WellsFargo1,5,4
14,7797.88,84.62,50.69,33.93,7763.95,WellsFargo1,5,4
15,7763.95,84.62,50.47,34.15,7729.8,WellsFargo1,5,4
16,7729.8,84.62,50.24,34.38,7695.42,WellsFargo1,5,4
17,7695.42,84.62,50.02,34.6,7660.82,WellsFargo1,5,4
18,7660.82,84.62,49.8,34.82,7626.0,WellsFargo1,5,4
19,7626.0,84.62,49.57,35.05,7590.95,WellsFargo1,5,4
20,7590.95,84.62,49.34,35.28,7555.67,WellsFargo1,5,4
21,7555.67,84.62,49.11,35.51,7520.16,WellsFargo1,5,4
22,7520.16,84.62,48.88,35.74,7484.42,WellsFargo1,5,4
23,7484.42,84.62,48.65,35.97,7448.45,WellsFargo1,5,4
24,7448.45,84.62,48.41,36.21,7412.24,WellsFargo1,5,4
25,7412.24,84.62,48.18,36.44,7375.8,WellsFargo1,5,4
26,7375.8,84.62,47.94,36.68,7339.12,WellsFargo1,5,4
27,7339.12,84.62,47.7,36.92,7302.2,WellsFargo1,5,4
28,7302.2,84.62,47.46,37.16,7265.04,WellsFargo1,5,4
29,7265.04,84.62,47.22,37.4,7227.64,WellsFargo1,5,4
30,7227.64,84.62,46.98,37.64,7190.0,WellsFargo1,5,4
31,7190.0,84.62,46.73,37.89,7152.11,WellsFargo1,5,4
32,7152.11,84.62,46.49,38.13,7113.98,WellsFargo1,5,4
33,7113.98,84.62,46.24,38.38,7075.6,WellsFargo1,5,4
34,7075.6,84.62,45.99,38.63,7036.97,WellsFargo1,5,4
35,7036.97,84.62,45.74,38.88,6998.09,WellsFargo1,5,4
36,6998.09,84.62,45.49,39.13,6958.96,WellsFargo1,5,4
37,6958.96,84.62,45.23,39.39,6919.57,WellsFargo1,5,4
38,6919.57,84.62,44.98,39.64,6879.93,WellsFargo1,5,4
39,6879.93,84.62,44.72,39.9,6840.03,WellsFargo1,5,4
40,6840.03,84.62,44.46,40.16,6799.87,WellsFargo1,5,4
41,6799.87,84.62,44.2,40.42,6759.45,WellsFargo1,5,4
42,6759.45,84.62,43.94,40.68,6718.77,WellsFargo1,5,4
43,6718.77,84.62,43.67,40.95,6677.82,WellsFargo1,5,4
44,6677.82,84.62,43.41,41.21,6636.61,WellsFargo1,5,4
45,6636.61,84.62,43.14,41.48,6595.13,WellsFargo1,5,4
46,6595.13,84.62,42.87,41.75,6553.38,WellsFargo1,5,4
47,6553.38,84.62,42.6,42.02,6511.36,WellsFargo1,5,4
48,6511.36,84.62,42.32,42.3,6469.06,WellsFargo1,5,4
49,6469.06,84.62,42.05,42.57,6426.49,WellsFargo1,5,4
50,6426.49,84.62,41.77,42.85,6383.64,WellsFargo1,5,4
51,6383.64,84.62,41.49,43.13,6340.51,WellsFargo1,5,4
52,6340.51,84.62,41.21,43.41,6297.1,WellsFargo1,5,4
53,6297.1,84.62,40.93,43.69,6253.41,WellsFargo1,5,4
54,6253.41,84.62,40.65,43.97,6209.44,WellsFargo1,5,4
55,6209.44,84.62,40.36,44.26,6165.18,WellsFargo1,5,4
56,6165.18,84.62,40.07,44.55,6120.63,WellsFargo1,5,4
57,6120.63,84.62,39.78,44.84,6075.79,WellsFargo1,5,4
58,6075.79,84.62,39.49,45.13,6030.66,WellsFargo1,5,4
59,6030.66,84.62,39.2,45.42,5985.24,WellsFargo1,5,4
60,5985.24,84.62,38.9,45.72,5939.52,WellsFargo1,5,4
61,5939.52,84.62,38.61,46.01,5893.51,WellsFargo1,5,4
62,5893.51,84.62,38.31,46.31,5847.2,WellsFargo1,5,4
63,5847.2,84.62,38.01,46.61,5800.59,WellsFargo1,5,4
64,5800.59,84.62,37.7,46.92,5753.67,WellsFargo1,5,4
65,5753.67,84.62,37.4,47.22,5706.45,WellsFargo1,5,4
66,5706.45,84.62,37.09,47.53,5658.92,WellsFargo1,5,4
67,5658.92,84.62,36.78,47.84,5611.08,WellsFargo1,5,4
68,5611.08,84.62,36.47,48.15,5562.93,WellsFargo1,5,4
69,5562.93,84.62,36.16,48.46,5514.47,WellsFargo1,5,4
70,5514.47,84.62,35.84,48.78,5465.69,WellsFargo1,5,4
71,5465.69,84.62,35.53,49.09,5416.6,WellsFargo1,5,4
72,5416.6,84.62,35.21,49.41,5367.19,WellsFargo1,5,4
73,5367.19,84.62,34.89,49.73,5317.46,WellsFargo1,5,4
74,5317.46,84.62,34.56,50.06,5267.4,WellsFargo1,5,4
75,5267.4,84.62,34.24,50.38,5217.02,WellsFargo1,5,4
76,5217.02,84.62,33.91,50.71,5166.31,WellsFargo1,5,4
77,5166.31,84.62,33.58,51.04,5115.27,WellsFargo1,5,4
78,5115.27,1098.58,33.25,1065.33,4049.94,WellsFargo1,5,4
79,4049.94,2819.06,26.32,2792.74,1257.2,WellsFargo1,5,4
80,1257.2,2819.06,8.17,2810.89,-1553.69,WellsFargo1,5,4
0,20000.0,191.04,108.0,83.04,19916.96,WellsFargo2,5,5
1,19916.96,191.04,107.55,83.49,19833.47,WellsFargo2,5,5
2,19833.47,191.04,107.1,83.94,19749.53,WellsFargo2,5,5
3,19749.53,191.04,106.65,84.39,19665.14,WellsFargo2,5,5
4,19665.14,191.04,106.19,84.85,19580.29,WellsFargo2,5,5
5,19580.29,191.04,105.73,85.31,19494.98,WellsFargo2,5,5
6,19494.98,191.04,105.27,85.77,19409.21,WellsFargo2,5,5
7,19409.21,191.04,104.81,86.23,19322.98,WellsFargo2,5,5
8,19322.98,191.04,104.34,86.7,19236.28,WellsFargo2,5,5
9,19236.28,191.04,103.88,87.16,19149.12,WellsFargo2,5,5
10,19149.12,191.04,103.41,87.63,19061.49,WellsFargo2,5,5
11,19061.49,191.04,102.93,88.11,18973.38,WellsFargo2,5,5
12,18973.38,191.04,102.46,88.58,18884.8,WellsFargo2,5,5
13,18884.8,191.04,101.98,89.06,18795.74,WellsFargo2,5,5
14,18795.74,191.04,101.5,89.54,18706.2,WellsFargo2,5,5
15,18706.2,191.04,101.01,90.03,18616.17,WellsFargo2,5,5
16,18616.17,191.04,100.53,90.51,18525.66,WellsFargo2,5,5
17,18525.66,191.04,100.04,91.0,18434.66,WellsFargo2,5,5
18,18434.66,191.04,99.55,91.49,18343.17,WellsFargo2,5,5
19,18343.17,191.04,99.05,91.99,18251.18,WellsFargo2,5,5
20,18251.18,191.04,98.56,92.48,18158.7,WellsFargo2,5,5
21,18158.7,191.04,98.06,92.98,18065.72,WellsFargo2,5,5
22,18065.72,191.04,97.55,93.49,17972.23,WellsFargo2,5,5
23,17972.23,191.04,97.05,93.99,17878.24,WellsFargo2,5,5
24,17878.24,191.04,96.54,94.5,17783.74,WellsFargo2,5,5
25,17783.74,191.04,96.03,95.01,17688.73,WellsFargo2,5,5
26,17688.73,191.04,95.52,95.52,17593.21,WellsFargo2,5,5
27,17593.21,191.04,95.0,96.04,17497.17,WellsFargo2,5,5
28,17497.17,191.04,94.48,96.56,17400.61,WellsFargo2,5,5
29,17400.61,191.04,93.96,97.08,17303.53,WellsFargo2,5,5
30,17303.53,191.04,93.44,97.6,17205.93,WellsFargo2,5,5
31,17205.93,191.04,92.91,98.13,17107.8,WellsFargo2,5,5
32,17107.8,191.04,92.38,98.66,17009.14,WellsFargo2,5,5
33,17009.14,191.04,91.85,99.19,16909.95,WellsFargo2,5,5
34,16909.95,191.04,91.31,99.73,16810.22,WellsFargo2,5,5
35,16810.22,191.04,90.78,100.26,16709.96,WellsFargo2,5,5
36,16709.96,191.04,90.23,100.81,16609.15,WellsFargo2,5,5
37,16609.15,191.04,89.69,101.35,16507.8,WellsFargo2,5,5
38,16507.8,191.04,89.14,101.9,16405.9,WellsFargo2,5,5
39,16405.9,191.04,88.59,102.45,16303.45,WellsFargo2,5,5
40,16303.45,191.04,88.04,103.0,16200.45,WellsFargo2,5,5
41,16200.45,191.04,87.48,103.56,16096.89,WellsFargo2,5,5
42,16096.89,191.04,86.92,104.12,15992.77,WellsFargo2,5,5
43,15992.77,191.04,86.36,104.68,15888.09,WellsFargo2,5,5
44,15888.09,191.04,85.8,105.24,15782.85,WellsFargo2,5,5
45,15782.85,191.04,85.23,105.81,15677.04,WellsFargo2,5,5
46,15677.04,191.04,84.66,106.38,15570.66,WellsFargo2,5,5
47,15570.66,191.04,84.08,106.96,15463.7,WellsFargo2,5,5
48,15463.7,191.04,83.5,107.54,15356.16,WellsFargo2,5,5
49,15356.16,191.04,82.92,108.12,15248.04,WellsFargo2,5,5
50,15248.04,191.04,82.34,108.7,15139.34,WellsFargo2,5,5
51,15139.34,191.04,81.75,109.29,15030.05,WellsFargo2,5,5
52,15030.05,191.04,81.16,109.88,14920.17,WellsFargo2,5,5
53,14920.17,191.04,80.57,110.47,14809.7,WellsFargo2,5,5
54,14809.7,191.04,79.97,111.07,14698.63,WellsFargo2,5,5
55,14698.63,191.04,79.37,111.67,14586.96,WellsFargo2,5,5
56,14586.96,191.04,78.77,112.27,14474.69,WellsFargo2,5,5
57,14474.69,191.04,78.16,112.88,14361.81,WellsFargo2,5,5
58,14361.81,191.04,77.55,113.49,14248.32,WellsFargo2,5,5
59,14248.32,191.04,76.94,114.1,14134.22,WellsFargo2,5,5
60,14134.22,191.04,76.32,114.72,14019.5,WellsFargo2,5,5
61,14019.5,191.04,75.71,115.33,13904.17,WellsFargo2,5,5
62,13904.17,191.04,75.08,115.96,13788.21,WellsFargo2,5,5
63,13788.21,191.04,74.46,116.58,13671.63,WellsFargo2,5,5
64,13671.63,191.04,73.83,117.21,13554.42,WellsFargo2,5,5
65,13554.42,191.04,73.19,117.85,13436.57,WellsFargo2,5,5
66,13436.57,191.04,72.56,118.48,13318.09,WellsFargo2,5,5
67,13318.09,191.04,71.92,119.12,13198.97,WellsFargo2,5,5
68,13198.97,191.04,71.27,119.77,13079.2,WellsFargo2,5,5
69,13079.2,191.04,70.63,120.41,12958.79,WellsFargo2,5,5
70,12958.79,191.04,69.98,121.06,12837.73,WellsFargo2,5,5
71,12837.73,191.04,69.32,121.72,12716.01,WellsFargo2,5,5
72,12716.01,191.04,68.67,122.37,12593.64,WellsFargo2,5,5
73,12593.64,191.04,68.01,123.03,12470.61,WellsFargo2,5,5
74,12470.61,191.04,67.34,123.7,12346.91,WellsFargo2,5,5
75,12346.91,191.04,66.67,124.37,12222.54,WellsFargo2,5,5
76,12222.54,191.04,66.0,125.04,12097.5,WellsFargo2,5,5
77,12097.5,191.04,65.33,125.71,11971.79,WellsFargo2,5,5
78,11971.79,191.04,64.65,126.39,11845.4,WellsFargo2,5,5
79,11845.4,191.04,63.97,127.07,11718.33,WellsFargo2,5,5
80,11718.33,1744.73,63.28,1681.45,10036.88,WellsFargo2,5,5
81,10036.88,3010.1,54.2,2955.9,7080.98,WellsFargo2,5,5
82,7080.98,3010.1,38.24,2971.86,4109.12,WellsFargo2,5,5
83,4109.12,3010.1,22.19,2987.91,1121.21,WellsFargo2,5,5
84,1121.21,3010.1,6.05,3004.05,-1882.84,WellsFargo2,5,5
0,4000.0,1070.0,16.0,1054.0,2946.0,testing,6,1
1,2946.0,1070.0,11.78,1058.22,1887.78,testing,6,1
2,1887.78,1070.0,7.55,1062.45,825.33,testing,6,1
3,825.33,1070.0,3.3,1066.7,-241.37,testing,6,1
0,5000.0,333.0,36.0,297.0,4703.0,Car,6,2
1,4703.0,333.0,33.86,299.14,4403.86,Car,6,2
2,4403.86,333.0,31.71,301.29,4102.57,Car,6,2
3,4102.57,574.37,29.54,544.83,3557.74,Car,6,2
4,3557.74,1403.0,25.62,1377.38,2180.36,Car,6,2
5,2180.36,1403.0,15.7,1387.3,793.06,Car,6,2
6,793.06,1403.0,5.71,1397.29,-604.23,Car,6,2
0,180000.0,1331.44,594.0,737.44,179262.56,mortgage,6,3
1,179262.56,1331.44,591.57,739.87,178522.69,mortgage,6,3
2,178522.69,1331.44,589.12,742.32,177780.37,mortgage,6,3
3,177780.37,1331.44,586.68,744.76,177035.61,mortgage,6,3
4,177035.61,1331.44,584.22,747.22,176288.39,mortgage,6,3
5,176288.39,1331.44,581.75,749.69,175538.7,mortgage,6,3
6,175538.7,1935.67,579.28,1356.39,174182.31,mortgage,6,3
7,174182.31,2734.44,574.8,2159.64,172022.67,mortgage,6,3
8,172022.67,2734.44,567.67,2166.77,169855.9,mortgage,6,3
9,169855.9,2734.44,560.52,2173.92,167681.98,mortgage,6,3
10,167681.98,2734.44,553.35,2181.09,165500.89,mortgage,6,3
11,165500.89,2734.44,546.15,2188.29,163312.6,mortgage,6,3
12,163312.6,2734.44,538.93,2195.51,161117.09,mortgage,6,3
13,161117.09,2734.44,531.69,2202.75,158914.34,mortgage,6,3
14,158914.34,2734.44,524.42,2210.02,156704.32,mortgage,6,3
15,156704.32,2734.44,517.12,2217.32,154487.0,mortgage,6,3
16,154487.0,2734.44,509.81,2224.63,152262.37,mortgage,6,3
17,152262.37,2734.44,502.47,2231.97,150030.4,mortgage,6,3
18,150030.4,2734.44,495.1,2239.34,147791.06,mortgage,6,3
19,147791.06,2734.44,487.71,2246.73,145544.33,mortgage,6,3
20,145544.33,2734.44,480.3,2254.14,143290.19,mortgage,6,3
21,143290.19,2734.44,472.86,2261.58,141028.61,mortgage,6,3
22,141028.61,2734.44,465.39,2269.05,138759.56,mortgage,6,3
23,138759.56,2734.44,457.91,2276.53,136483.03,mortgage,6,3
24,136483.03,2734.44,450.39,2284.05,134198.98,mortgage,6,3
25,134198.98,2734.44,442.86,2291.58,131907.4,mortgage,6,3
26,131907.4,2734.44,435.29,2299.15,129608.25,mortgage,6,3
27,129608.25,2734.44,427.71,2306.73,127301.52,mortgage,6,3
28,127301.52,2734.44,420.1,2314.34,124987.18,mortgage,6,3
29,124987.18,2734.44,412.46,2321.98,122665.2,mortgage,6,3
30,122665.2,2734.44,404.8,2329.64,120335.56,mortgage,6,3
31,120335.56,2734.44,397.11,2337.33,117998.23,mortgage,6,3
32,117998.23,2734.44,389.39,2345.05,115653.18,mortgage,6,3
33,115653.18,2734.44,381.66,2352.78,113300.4,mortgage,6,3
34,113300.4,2734.44,373.89,2360.55,110939.85,mortgage,6,3
35,110939.85,2734.44,366.1,2368.34,108571.51,mortgage,6,3
36,108571.51,2734.44,358.29,2376.15,106195.36,mortgage,6,3
37,106195.36,2734.44,350.44,2384.0,103811.36,mortgage,6,3
38,103811.36,2734.44,342.58,2391.86,101419.5,mortgage,6,3
39,101419.5,2734.44,334.68,2399.76,99019.74,mortgage,6,3
40,99019.74,2734.44,326.77,2407.67,96612.07,mortgage,6,3
41,96612.07,2734.44,318.82,2415.62,94196.45,mortgage,6,3
42,94196.45,2734.44,310.85,2423.59,91772.86,mortgage,6,3
43,91772.86,2734.44,302.85,2431.59,89341.27,mortgage,6,3
44,89341.27,2734.44,294.83,2439.61,86901.66,mortgage,6,3
45,86901.66,2734.44,286.78,2447.66,84454.0,mortgage,6,3
46,84454.0,2734.44,278.7,2455.74,81998.26,mortgage,6,3
47,81998.26,2734.44,270.59,2463.85,79534.41,mortgage,6,3
48,79534.41,2734.44,262.46,2471.98,77062.43,mortgage,6,3
49,77062.43,2734.44,254.31,2480.13,74582.3,mortgage,6,3
50,74582.3,2734.44,246.12,2488.32,72093.98,mortgage,6,3
51,72093.98,2734.44,237.91,2496.53,69597.45,mortgage,6,3
52,69597.45,2734.44,229.67,2504.77,67092.68,mortgage,6,3
53,67092.68,2734.44,221.41,2513.03,64579.65,mortgage,6,3
54,64579.65,2734.44,213.11,2521.33,62058.32,mortgage,6,3
55,62058.32,2734.44,204.79,2529.65,59528.67,mortgage,6,3
56,59528.67,2734.44,196.44,2538.0,56990.67,mortgage,6,3
57,56990.67,2734.44,188.07,2546.37,54444.3,mortgage,6,3
58,54444.3,2734.44,179.67,2554.77,51889.53,mortgage,6,3
59,51889.53,2734.44,171.24,2563.2,49326.33,mortgage,6,3
60,49326.33,2734.44,162.78,2571.66,46754.67,mortgage,6,3
61,46754.67,2734.44,154.29,2580.15,44174.52,mortgage,6,3
62,44174.52,2734.44,145.78,2588.66,41585.86,mortgage,6,3
63,41585.86,2734.44,137.23,2597.21,38988.65,mortgage,6,3
64,38988.65,2734.44,128.66,2605.78,36382.87,mortgage,6,3
65,36382.87,2734.44,120.06,2614.38,33768.49,mortgage,6,3
66,33768.49,2734.44,111.44,2623.0,31145.49,mortgage,6,3
67,31145.49,2734.44,102.78,2631.66,28513.83,mortgage,6,3
68,28513.83,2734.44,94.1,2640.34,25873.49,mortgage,6,3
69,25873.49,2734.44,85.38,2649.06,23224.43,mortgage,6,3
70,23224.43,2734.44,76.64,2657.8,20566.63,mortgage,6,3
71,20566.63,2734.44,67.87,2666.57,17900.06,mortgage,6,3
72,17900.06,2734.44,59.07,2675.37,15224.69,mortgage,6,3
73,15224.69,2734.44,50.24,2684.2,12540.49,mortgage,6,3
74,12540.49,2734.44,41.38,2693.06,9847.43,mortgage,6,3
75,9847.43,2734.44,32.5,2701.94,7145.49,mortgage,6,3
76,7145.49,2734.44,23.58,2710.86,4434.63,mortgage,6,3
77,4434.63,2734.44,14.63,2719.81,1714.82,mortgage,6,3
78,1714.82,2734.44,5.66,2728.78,-1013.96,mortgage,6,3
0,20000.0,191.04,108.0,83.04,19916.96,WellsFargo2,6,4
1,19916.96,191.04,107.55,83.49,19833.47,WellsFargo2,6,4
2,19833.47,191.04,107.1,83.94,19749.53,WellsFargo2,6,4
3,19749.53,191.04,106.65,84.39,19665.14,WellsFargo2,6,4
4,19665.14,191.04,106.19,84.85,19580.29,WellsFargo2,6,4
5,19580.29,191.04,105.73,85.31,19494.98,WellsFargo2,6,4
6,19494.98,191.04,105.27,85.77,19409.21,WellsFargo2,6,4
7,19409.21,191.04,104.81,86.23,19322.98,WellsFargo2,6,4
8,19322.98,191.04,104.34,86.7,19236.28,WellsFargo2,6,4
9,19236.28,191.04,103.88,87.16,19149.12,WellsFargo2,6,4
10,19149.12,191.04,103.41,87.63,19061.49,WellsFargo2,6,4
11,19061.49,191.04,102.93,88.11,18973.38,WellsFargo2,6,4
12,18973.38,191.04,102.46,88.58,18884.8,WellsFargo2,6,4
13,18884.8,191.04,101.98,89.06,18795.74,WellsFargo2,6,4
14,18795.74,191.04,101.5,89.54,18706.2,WellsFargo2,6,4
15,18706.2,191.04,101.01,90.03,18616.17,WellsFargo2,6,4
16,18616.17,191.04,100.53,90.51,18525.66,WellsFargo2,6,4
17,18525.66,191.04,100.04,91.0,18434.66,WellsFargo2,6,4
18,18434.66,191.04,99.55,91.49,18343.17,WellsFargo2,6,4
19,18343.17,191.04,99.05,91.99,18251.18,WellsFargo2,6,4
20,18251.18,191.04,98.56,92.48,18158.7,WellsFargo2,6,4
21,18158.7,191.04,98.06,92.98,18065.72,WellsFargo2,6,4
22,18065.72,191.04,97.55,93.49,17972.23,WellsFargo2,6,4
23,17972.23,191.04,97.05,93.99,17878.24,WellsFargo2,6,4
24,17878.24,191.04,96.54,94.5,17783.74,WellsFargo2,6,4
25,17783.74,191.04,96.03,95.01,17688.73,WellsFargo2,6,4
26,17688.73,191.04,95.52,95.52,17593.21,WellsFargo2,6,4
27,17593.21,191.04,95.0,96.04,17497.17,WellsFargo2,6,4
28,17497.17,191.04,94.48,96.56,17400.61,WellsFargo2,6,4
29,17400.61,191.04,93.96,97.08,17303.53,WellsFargo2,6,4
30,17303.53,191.04,93.44,97.6,17205.93,WellsFargo2,6,4
31,17205.93,191.04,92.91,98.13,17107.8,WellsFargo2,6,4
32,17107.8,191.04,92.38,98.66,17009.14,WellsFargo2,6,4
33,17009.14,191.04,91.85,99.19,16909.95,WellsFargo2,6,4
34,16909.95,191.04,91.31,99.73,16810.22,WellsFargo2,6,4
35,16810.22,191.04,90.78,100.26,16709.96,WellsFargo2,6,4
36,16709.96,191.04,90.23,100.81,16609.15,WellsFargo2,6,4
37,16609.15,191.04,89.69,101.35,16507.8,WellsFargo2,6,4
38,16507.8,191.04,89.14,101.9,16405.9,WellsFargo2,6,4
39,16405.9,191.04,88.59,102.45,16303.45,WellsFargo2,6,4
40,16303.45,191.04,88.04,103.0,16200.45,WellsFargo2,6,4
41,16200.45,191.04,87.48,103.56,16096.89,WellsFargo2,6,4
42,16096.89,191.04,86.92,104.12,15992.77,WellsFargo2,6,4
43,15992.77,191.04,86.36,104.68,15888.09,WellsFargo2,6,4
44,15888.09,191.04,85.8,105.24,15782.85,WellsFargo2,6,4
45,15782.85,191.04,85.23,105.81,15677.04,WellsFargo2,6,4
46,15677.04,191.04,84.66,106.38,15570.66,WellsFargo2,6,4
47,15570.66,191.04,84.08,106.96,15463.7,WellsFargo2,6,4
48,15463.7,191.04,83.5,107.54,15356.16,WellsFargo2,6,4
49,15356.16,191.04,82.92,108.12,15248.04,WellsFargo2,6,4
50,15248.04,191.04,82.34,108.7,15139.34,WellsFargo2,6,4
51,15139.34,191.04,81.75,109.29,15030.05,WellsFargo2,6,4
52,15030.05,191.04,81.16,109.88,14920.17,WellsFargo2,6,4
53,14920.17,191.04,80.57,110.47,14809.7,WellsFargo2,6,4
54,14809.7,191.04,79.97,111.07,14698.63,WellsFargo2,6,4
55,14698.63,191.04,79.37,111.67,14586.96,WellsFargo2,6,4
56,14586.96,191.04,78.77,112.27,14474.69,WellsFargo2,6,4
57,14474.69,191.04,78.16,112.88,14361.81,WellsFargo2,6,4
58,14361.81,191.04,77.55,113.49,14248.32,WellsFargo2,6,4
59,14248.32,191.04,76.94,114.1,14134.22,WellsFargo2,6,4
60,14134.22,191.04,76.32,114.72,14019.5,WellsFargo2,6,4
61,14019.5,191.04,75.71,115.33,13904.17,WellsFargo2,6,4
62,13904.17,191.04,75.08,115.96,13788.21,WellsFargo2,6,4
63,13788.21,191.04,74.46,116.58,13671.63,WellsFargo2,6,4
64,13671.63,191.04,73.83,117.21,13554.42,WellsFargo2,6,4
65,13554.42,191.04,73.19,117.85,13436.57,WellsFargo2,6,4
66,13436.57,191.04,72.56,118.48,13318.09,WellsFargo2,6,4
67,13318.09,191.04,71.92,119.12,13198.97,WellsFargo2,6,4
68,13198.97,191.04,71.27,119.77,13079.2,WellsFargo2,6,4
69,13079.2,191.04,70.63,120.41,12958.79,WellsFargo2,6,4
70,12958.79,191.04,69.98,121.06,12837.73,WellsFargo2,6,4
71,12837.73,191.04,69.32,121.72,12716.01,WellsFargo2,6,4
72,12716.01,191.04,68.67,122.37,12593.64,WellsFargo2,6,4
73,12593.64,191.04,68.01,123.03,12470.61,WellsFargo2,6,4
74,12470.61,191.04,67.34,123.7,12346.91,WellsFargo2,6,4
75,12346.91,191.04,66.67,124.37,12222.54,WellsFargo2,6,4
76,12222.54,191.04,66.0,125.04,12097.5,WellsFargo2,6,4
77,12097.5,191.04,65.33,125.71,11971.79,WellsFargo2,6,4
78,11971.79,1205.0,64.65,1140.35,10831.44,WellsFargo2,6,4
79,10831.44,2925.48,58.49,2866.99,7964.45,WellsFargo2,6,4
80,7964.45,2925.48,43.01,2882.47,5081.98,WellsFargo2,6,4
81,5081.98,2925.48,27.44,2898.04,2183.94,WellsFargo2,6,4
82,2183.94,2925.48,11.79,2913.69,-729.75,WellsFargo2,6,4
0,8250.57,84.62,53.63,30.99,8219.58,WellsFargo1,6,5
1,8219.58,84.62,53.43,31.19,8188.39,WellsFargo1,6,5
2,8188.39,84.62,53.22,31.4,8156.99,WellsFargo1,6,5
3,8156.99,84.62,53.02,31.6,8125.39,WellsFargo1,6,5
4,8125.39,84.62,52.82,31.8,8093.59,WellsFargo1,6,5
5,8093.59,84.62,52.61,32.01,8061.58,WellsFargo1,6,5
6,8061.58,84.62,52.4,32.22,8029.36,WellsFargo1,6,5
7,8029.36,84.62,52.19,32.43,7996.93,WellsFargo1,6,5
8,7996.93,84.62,51.98,32.64,7964.29,WellsFargo1,6,5
9,7964.29,84.62,51.77,32.85,7931.44,WellsFargo1,6,5
10,7931.44,84.62,51.55,33.07,7898.37,WellsFargo1,6,5
11,7898.37,84.62,51.34,33.28,7865.09,WellsFargo1,6,5
12,7865.09,84.62,51.12,33.5,7831.59,WellsFargo1,6,5
13,7831.59,84.62,50.91,33.71,7797.88,WellsFargo1,6,5
14,7797.88,84.62,50.69,33.93,7763.95,WellsFargo1,6,5
15,7763.95,84.62,50.47,34.15,7729.8,WellsFargo1,6,5
16,7729.8,84.62,50.24,34.38,7695.42,WellsFargo1,6,5
17,7695.42,84.62,50.02,34.6,7660.82,WellsFargo1,6,5
18,7660.82,84.62,49.8,34.82,7626.0,WellsFargo1,6,5
19,7626.0,84.62,49.57,35.05,7590.95,WellsFargo1,6,5
20,7590.95,84.62,49.34,35.28,7555.67,WellsFargo1,6,5
21,7555.67,84.62,49.11,35.51,7520.16,WellsFargo1,6,5
22,7520.16,84.62,48.88,35.74,7484.42,WellsFargo1,6,5
23,7484.42,84.62,48.65,35.97,7448.45,WellsFargo1,6,5
24,7448.45,84.62,48.41,36.21,7412.24,WellsFargo1,6,5
25,7412.24,84.62,48.18,36.44,7375.8,WellsFargo1,6,5
26,7375.8,84.62,47.94,36.68,7339.12,WellsFargo1,6,5
27,7339.12,84.62,47.7,36.92,7302.2,WellsFargo1,6,5
28,7302.2,84.62,47.46,37.16,7265.04,WellsFargo1,6,5
29,7265.04,84.62,47.22,37.4,7227.64,WellsFargo1,6,5
30,7227.64,84.62,46.98,37.64,7190.0,WellsFargo1,6,5
31,7190.0,84.62,46.73,37.89,7152.11,WellsFargo1,6,5
32,7152.11,84.62,46.49,38.13,7113.98,WellsFargo1,6,5
33,7113.98,84.62,46.24,38.38,7075.6,WellsFargo1,6,5
34,7075.6,84.62,45.99,38.63,7036.97,WellsFargo1,6,5
35,7036.97,84.62,45.74,38.88,6998.09,WellsFargo1,6,5
36,6998.09,84.62,45.49,39.13,6958.96,WellsFargo1,6,5
37,6958.96,84.62,45.23,39.39,6919.57,WellsFargo1,6,5
38,6919.57,84.62,44.98,39.64,6879.93,WellsFargo1,6,5
39,6879.93,84.62,44.72,39.9,6840.03,WellsFargo1,6,5
40,6840.03,84.62,44.46,40.16,6799.87,WellsFargo1,6,5
41,6799.87,84.62,44.2,40.42,6759.45,WellsFargo1,6,5
42,6759.45,84.62,43.94,40.68,6718.77,WellsFargo1,6,5
43,6718.77,84.62,43.67,40.95,6677.82,WellsFargo1,6,5
44,6677.82,84.62,43.41,41.21,6636.61,WellsFargo1,6,5
45,6636.61,84.62,43.14,41.48,6595.13,WellsFargo1,6,5
46,6595.13,84.62,42.87,41.75,6553.38,WellsFargo1,6,5
47,6553.38,84.62,42.6,42.02,6511.36,WellsFargo1,6,5
48,6511.36,84.62,42.32,42.3,6469.06,WellsFargo1,6,5
49,6469.06,84.62,42.05,42.57,6426.49,WellsFargo1,6,5
50,6426.49,84.62,41.77,42.85,6383.64,WellsFargo1,6,5
51,6383.64,84.62,41.49,43.13,6340.51,WellsFargo1,6,5
52,6340.51,84.62,41.21,43.41,6297.1,WellsFargo1,6,5
53,6297.1,84.62,40.93,43.69,6253.41,WellsFargo1,6,5
54,6253.41,84.62,40.65,43.97,6209.44,WellsFargo1,6,5
55,6209.44,84.62,40.36,44.26,6165.18,WellsFargo1,6,5
56,6165.18,84.62,40.07,44.55,6120.63,WellsFargo1,6,5
57,6120.63,84.62,39.78,44.84,6075.79,WellsFargo1,6,5
58,6075.79,84.62,39.49,45.13,6030.66,WellsFargo1,6,5
59,6030.66,84.62,39.2,45.42,5985.24,WellsFargo1,6,5
60,5985.24,84.62,38.9,45.72,5939.52,WellsFargo1,6,5
61,5939.52,84.62,38.61,46.01,5893.51,WellsFargo1,6,5
62,5893.51,84.62,38.31,46.31,5847.2,WellsFargo1,6,5
63,5847.2,84.62,38.01,46.61,5800.59,WellsFargo1,6,5
64,5800.59,84.62,37.7,46.92,5753.67,WellsFargo1,6,5
65,5753.67,84.62,37.4,47.22,5706.45,WellsFargo1,6,5
66,5706.45,84.62,37.09,47.53,5658.92,WellsFargo1,6,5
67,5658.92,84.62,36.78,47.84,5611.08,WellsFargo1,6,5
68,5611.08,84.62,36.47,48.15,5562.93,WellsFargo1,6,5
69,5562.93,84.62,36.16,48.46,5514.47,WellsFargo1,6,5
70,5514.47,84.62,35.84,48.78,5465.69,WellsFargo1,6,5
71,5465.69,84.62,35.53,49.09,5416.6,WellsFargo1,6,5
72,5416.6,84.62,35.21,49.41,5367.19,WellsFargo1,6,5
73,5367.19,84.62,34.89,49.73,5317.46,WellsFargo1,6,5
74,5317.46,84.62,34.56,50.06,5267.4,WellsFargo1,6,5
75,5267.4,84.62,34.24,50.38,5217.02,WellsFargo1,6,5
76,5217.02,84.62,33.91,50.71,5166.31,WellsFargo1,6,5
77,5166.31,84.62,33.58,51.04,5115.27,WellsFargo1,6,5
78,5115.27,84.62,33.25,51.37,5063.9,WellsFargo1,6,5
79,5063.9,84.62,32.92,51.7,5012.2,WellsFargo1,6,5
80,5012.2,84.62,32.58,52.04,4960.16,WellsFargo1,6,5
81,4960.16,84.62,32.24,52.38,4907.78,WellsFargo1,6,5
82,4907.78,814.37,31.9,782.47,4125.31,WellsFargo1,6,5
83,4125.31,3010.1,26.81,2983.29,1142.02,WellsFargo1,6,5
84,1142.02,3010.1,7.42,3002.68,-1860.66,WellsFargo1,6,5
0,4000.0,1070.0,16.0,1054.0,2946.0,testing,7,1
1,2946.0,1070.0,11.78,1058.22,1887.78,testing,7,1
2,1887.78,1070.0,7.55,1062.45,825.33,testing,7,1
3,825.33,1070.0,3.3,1066.7,-241.37,testing,7,1
0,8250.57,84.62,53.63,30.99,8219.58,WellsFargo1,7,2
1,8219.58,84.62,53.43,31.19,8188.39,WellsFargo1,7,2
2,8188.39,84.62,53.22,31.4,8156.99,WellsFargo1,7,2
3,8156.99,325.99,53.02,272.97,7884.02,WellsFargo1,7,2
4,7884.02,1154.62,51.25,1103.37,6780.65,WellsFargo1,7,2
5,6780.65,1154.62,44.07,1110.55,5670.1,WellsFargo1,7,2
6,5670.1,1154.62,36.86,1117.76,4552.34,WellsFargo1,7,2
7,4552.34,1154.62,29.59,1125.03,3427.31,WellsFargo1,7,2
8,3427.31,1154.62,22.28,1132.34,2294.97,WellsFargo1,7,2
9,2294.97,1154.62,14.92,1139.7,1155.27,WellsFargo1,7,2
10,1155.27,1154.62,7.51,1147.11,8.16,WellsFargo1,7,2
11,8.16,1154.62,0.05,1154.57,-1146.41,WellsFargo1,7,2
0,5000.0,333.0,36.0,297.0,4703.0,Car,7,3
1,4703.0,333.0,33.86,299.14,4403.86,Car,7,3
2,4403.86,333.0,31.71,301.29,4102.57,Car,7,3
3,4102.57,333.0,29.54,303.46,3799.11,Car,7,3
4,3799.11,333.0,27.35,305.65,3493.46,Car,7,3
5,3493.46,333.0,25.15,307.85,3185.61,Car,7,3
6,3185.61,333.0,22.94,310.06,2875.55,Car,7,3
7,2875.55,333.0,20.7,312.3,2563.25,Car,7,3
8,2563.25,333.0,18.46,314.54,2248.71,Car,7,3
9,2248.71,333.0,16.19,316.81,1931.9,Car,7,3
10,1931.9,333.0,13.91,319.09,1612.81,Car,7,3
11,1612.81,1479.41,11.61,1467.8,145.01,Car,7,3
12,145.01,1487.62,1.04,1486.58,-1341.57,Car,7,3
0,20000.0,191.04,108.0,83.04,19916.96,WellsFargo2,7,4
1,19916.96,191.04,107.55,83.49,19833.47,WellsFargo2,7,4
2,19833.47,191.04,107.1,83.94,19749.53,WellsFargo2,7,4
3,19749.53,191.04,106.65,84.39,19665.14,WellsFargo2,7,4
4,19665.14,191.04,106.19,84.85,19580.29,WellsFargo2,7,4
5,19580.29,191.04,105.73,85.31,19494.98,WellsFargo2,7,4
6,19494.98,191.04,105.27,85.77,19409.21,WellsFargo2,7,4
7,19409.21,191.04,104.81,86.23,19322.98,WellsFargo2,7,4
8,19322.98,191.04,104.34,86.7,19236.28,WellsFargo2,7,4
9,19236.28,191.04,103.88,87.16,19149.12,WellsFargo2,7,4
10,19149.12,191.04,103.41,87.63,19061.49,WellsFargo2,7,4
11,19061.49,191.04,102.93,88.11,18973.38,WellsFargo2,7,4
12,18973.38,1532.61,102.46,1430.15,17543.23,WellsFargo2,7,4
13,17543.23,1678.66,94.73,1583.93,15959.3,WellsFargo2,7,4
14,15959.3,1678.66,86.18,1592.48,14366.82,WellsFargo2,7,4
15,14366.82,1678.66,77.58,1601.08,12765.74,WellsFargo2,7,4
16,12765.74,1678.66,68.93,1609.73,11156.01,WellsFargo2,7,4
17,11156.01,1678.66,60.24,1618.42,9537.59,WellsFargo2,7,4
18,9537.59,1678.66,51.5,1627.16,7910.43,WellsFargo2,7,4
19,7910.43,1678.66,42.72,1635.94,6274.49,WellsFargo2,7,4
20,6274.49,1678.66,33.88,1644.78,4629.71,WellsFargo2,7,4
21,4629.71,1678.66,25.0,1653.66,2976.05,WellsFargo2,7,4
22,2976.05,1678.66,16.07,1662.59,1313.46,WellsFargo2,7,4
23,1313.46,1678.66,7.09,1671.57,-358.11,WellsFargo2,7,4
0,180000.0,1331.44,594.0,737.44,179262.56,mortgage,7,5
1,179262.56,1331.44,591.57,739.87,178522.69,mortgage,7,5
2,178522.69,1331.44,589.12,742.32,177780.37,mortgage,7,5
3,177780.37,1331.44,586.68,744.76,177035.61,mortgage,7,5
4,177035.61,1331.44,584.22,747.22,176288.39,mortgage,7,5
5,176288.39,1331.44,581.75,749.69,175538.7,mortgage,7,5
6,175538.7,1331.44,579.28,752.16,174786.54,mortgage,7,5
7,174786.54,1331.44,576.8,754.64,174031.9,mortgage,7,5
8,174031.9,1331.44,574.31,757.13,173274.77,mortgage,7,5
9,173274.77,1331.44,571.81,759.63,172515.14,mortgage,7,5
10,172515.14,1331.44,569.3,762.14,171753.0,mortgage,7,5
11,171753.0,1331.44,566.78,764.66,170988.34,mortgage,7,5
12,170988.34,1331.44,564.26,767.18,170221.16,mortgage,7,5
13,170221.16,1331.44,561.73,769.71,169451.45,mortgage,7,5
14,169451.45,1331.44,559.19,772.25,168679.2,mortgage,7,5
15,168679.2,1331.44,556.64,774.8,167904.4,mortgage,7,5
16,167904.4,1331.44,554.08,777.36,167127.04,mortgage,7,5
17,167127.04,1331.44,551.52,779.92,166347.12,mortgage,7,5
18,166347.12,1331.44,548.95,782.49,165564.63,mortgage,7,5
19,165564.63,1331.44,546.36,785.08,164779.55,mortgage,7,5
20,164779.55,1331.44,543.77,787.67,163991.88,mortgage,7,5
21,163991.88,1331.44,541.17,790.27,163201.61,mortgage,7,5
22,163201.61,1331.44,538.57,792.87,162408.74,mortgage,7,5
23,162408.74,1689.55,535.95,1153.6,161255.14,mortgage,7,5
24,161255.14,3010.1,532.14,2477.96,158777.18,mortgage,7,5
25,158777.18,3010.1,523.96,2486.14,156291.04,mortgage,7,5
26,156291.04,3010.1,515.76,2494.34,153796.7,mortgage,7,5
27,153796.7,3010.1,507.53,2502.57,151294.13,mortgage,7,5
28,151294.13,3010.1,499.27,2510.83,148783.3,mortgage,7,5
29,148783.3,3010.1,490.98,2519.12,146264.18,mortgage,7,5
30,146264.18,3010.1,482.67,2527.43,143736.75,mortgage,7,5
31,143736.75,3010.1,474.33,2535.77,141200.98,mortgage,7,5
32,141200.98,3010.1,465.96,2544.14,138656.84,mortgage,7,5
33,138656.84,3010.1,457.57,2552.53,136104.31,mortgage,7,5
34,136104.31,3010.1,449.14,2560.96,133543.35,mortgage,7,5
35,133543.35,3010.1,440.69,2569.41,130973.94,mortgage,7,5
36,130973.94,3010.1,432.21,2577.89,128396.05,mortgage,7,5
37,128396.05,3010.1,423.71,2586.39,125809.66,mortgage,7,5
38,125809.66,3010.1,415.17,2594.93,123214.73,mortgage,7,5
39,123214.73,3010.1,406.61,2603.49,120611.24,mortgage,7,5
40,120611.24,3010.1,398.02,2612.08,117999.16,mortgage,7,5
41,117999.16,3010.1,389.4,2620.7,115378.46,mortgage,7,5
42,115378.46,3010.1,380.75,2629.35,112749.11,mortgage,7,5
43,112749.11,3010.1,372.07,2638.03,110111.08,mortgage,7,5
44,110111.08,3010.1,363.37,2646.73,107464.35,mortgage,7,5
45,107464.35,3010.1,354.63,2655.47,104808.88,mortgage,7,5
46,104808.88,3010.1,345.87,2664.23,102144.65,mortgage,7,5
47,102144.65,3010.1,337.08,2673.02,99471.63,mortgage,7,5
48,99471.63,3010.1,328.26,2681.84,96789.79,mortgage,7,5
49,96789.79,3010.1,319.41,2690.69,94099.1,mortgage,7,5
50,94099.1,3010.1,310.53,2699.57,91399.53,mortgage,7,5
51,91399.53,3010.1,301.62,2708.48,88691.05,mortgage,7,5
52,88691.05,3010.1,292.68,2717.42,85973.63,mortgage,7,5
53,85973.63,3010.1,283.71,2726.39,83247.24,mortgage,7,5
54,83247.24,3010.1,274.72,2735.38,80511.86,mortgage,7,5
55,80511.86,3010.1,265.69,2744.41,77767.45,mortgage,7,5
56,77767.45,3010.1,256.63,2753.47,75013.98,mortgage,7,5
57,75013.98,3010.1,247.55,2762.55,72251.43,mortgage,7,5
58,72251.43,3010.1,238.43,2771.67,69479.76,mortgage,7,5
59,69479.76,3010.1,229.28,2780.82,66698.94,mortgage,7,5
60,66698.94,3010.1,220.11,2789.99,63908.95,mortgage,7,5
61,63908.95,3010.1,210.9,2799.2,61109.75,mortgage,7,5
62,61109.75,3010.1,201.66,2808.44,58301.31,mortgage,7,5
63,58301.31,3010.1,192.39,2817.71,55483.6,mortgage,7,5
64,55483.6,3010.1,183.1,2827.0,52656.6,mortgage,7,5
65,52656.6,3010.1,173.77,2836.33,49820.27,mortgage,7,5
66,49820.27,3010.1,164.41,2845.69,46974.58,mortgage,7,5
67,46974.58,3010.1,155.02,2855.08,44119.5,mortgage,7,5
68,44119.5,3010.1,145.59,2864.51,41254.99,mortgage,7,5
69,41254.99,3010.1,136.14,2873.96,38381.03,mortgage,7,5
70,38381.03,3010.1,126.66,2883.44,35497.59,mortgage,7,5
71,35497.59,3010.1,117.14,2892.96,32604.63,mortgage,7,5
72,32604.63,3010.1,107.6,2902.5,29702.13,mortgage,7,5
73,29702.13,3010.1,98.02,2912.08,26790.05,mortgage,7,5
74,26790.05,3010.1,88.41,2921.69,23868.36,mortgage,7,5
75,23868.36,3010.1,78.77,2931.33,20937.03,mortgage,7,5
76,20937.03,3010.1,69.09,2941.01,17996.02,mortgage,7,5
77,17996.02,3010.1,59.39,2950.71,15045.31,mortgage,7,5
78,15045.31,3010.1,49.65,2960.45,12084.86,mortgage,7,5
79,12084.86,3010.1,39.88,2970.22,9114.64,mortgage,7,5
80,9114.64,3010.1,30.08,2980.02,6134.62,mortgage,7,5
81,6134.62,3010.1,20.24,2989.86,3144.76,mortgage,7,5
82,3144.76,3010.1,10.38,2999.72,145.04,mortgage,7,5
83,145.04,3010.1,0.48,3009.62,-2864.58,mortgage,7,5
0,4000.0,1070.0,16.0,1054.0,2946.0,testing,8,1
1,2946.0,1070.0,11.78,1058.22,1887.78,testing,8,1
2,1887.78,1070.0,7.55,1062.45,825.33,testing,8,1
3,825.33,1070.0,3.3,1066.7,-241.37,testing,8,1
0,8250.57,84.62,53.63,30.99,8219.58,WellsFargo1,8,2
1,8219.58,84.62,53.43,31.19,8188.39,WellsFargo1,8,2
2,8188.39,84.62,53.22,31.4,8156.99,WellsFargo1,8,2
3,8156.99,325.99,53.02,272.97,7884.02,WellsFargo1,8,2
4,7884.02,1154.62,51.25,1103.37,6780.65,WellsFargo1,8,2
5,6780.65,1154.62,44.07,1110.55,5670.1,WellsFargo1,8,2
6,5670.1,1154.62,36.86,1117.76,4552.34,WellsFargo1,8,2
7,4552.34,1154.62,29.59,1125.03,3427.31,WellsFargo1,8,2
8,3427.31,1154.62,22.28,1132.34,2294.97,WellsFargo1,8,2
9,2294.97,1154.62,14.92,1139.7,1155.27,WellsFargo1,8,2
10,1155.27,1154.62,7.51,1147.11,8.16,WellsFargo1,8,2
11,8.16,1154.62,0.05,1154.57,-1146.41,WellsFargo1,8,2
0,5000.0,333.0,36.0,297.0,4703.0,Car,8,3
1,4703.0,333.0,33.86,299.14,4403.86,Car,8,3
2,4403.86,333.0,31.71,301.29,4102.57,Car,8,3
3,4102.57,333.0,29.54,303.46,3799.11,Car,8,3
4,3799.11,333.0,27.35,305.65,3493.46,Car,8,3
5,3493.46,333.0,25.15,307.85,3185.61,Car,8,3
6,3185.61,333.0,22.94,310.06,2875.55,Car,8,3
7,2875.55,333.0,20.7,312.3,2563.25,Car,8,3
8,2563.25,333.0,18.46,314.54,2248.71,Car,8,3
9,2248.71,333.0,16.19,316.81,1931.9,Car,8,3
10,1931.9,333.0,13.91,319.09,1612.81,Car,8,3
11,1612.81,1479.41,11.61,1467.8,145.01,Car,8,3
12,145.01,1487.62,1.04,1486.58,-1341.57,Car,8,3
0,180000.0,1331.44,594.0,737.44,179262.56,mortgage,8,4
1,179262.56,1331.44,591.57,739.87,178522.69,mortgage,8,4
2,178522.69,1331.44,589.12,742.32,177780.37,mortgage,8,4
3,177780.37,1331.44,586.68,744.76,177035.61,mortgage,8,4
4,177035.61,1331.44,584.22,747.22,176288.39,mortgage,8,4
5,176288.39,1331.44,581.75,749.69,175538.7,mortgage,8,4
6,175538.7,1331.44,579.28,752.16,174786.54,mortgage,8,4
7,174786.54,1331.44,576.8,754.64,174031.9,mortgage,8,4
8,174031.9,1331.44,574.31,757.13,173274.77,mortgage,8,4
9,173274.77,1331.44,571.81,759.63,172515.14,mortgage,8,4
10,172515.14,1331.44,569.3,762.14,171753.0,mortgage,8,4
11,171753.0,1331.44,566.78,764.66,170988.34,mortgage,8,4
12,170988.34,2673.01,564.26,2108.75,168879.59,mortgage,8,4
13,168879.59,2819.06,557.3,2261.76,166617.83,mortgage,8,4
14,166617.83,2819.06,549.84,2269.22,164348.61,mortgage,8,4
15,164348.61,2819.06,542.35,2276.71,162071.9,mortgage,8,4
16,162071.9,2819.06,534.84,2284.22,159787.68,mortgage,8,4
17,159787.68,2819.06,527.3,2291.76,157495.92,mortgage,8,4
18,157495.92,2819.06,519.74,2299.32,155196.6,mortgage,8,4
19,155196.6,2819.06,512.15,2306.91,152889.69,mortgage,8,4
20,152889.69,2819.06,504.54,2314.52,150575.17,mortgage,8,4
21,150575.17,2819.06,496.9,2322.16,148253.01,mortgage,8,4
22,148253.01,2819.06,489.23,2329.83,145923.18,mortgage,8,4
23,145923.18,2819.06,481.55,2337.51,143585.67,mortgage,8,4
24,143585.67,2819.06,473.83,2345.23,141240.44,mortgage,8,4
25,141240.44,2819.06,466.09,2352.97,138887.47,mortgage,8,4
26,138887.47,2819.06,458.33,2360.73,136526.74,mortgage,8,4
27,136526.74,2819.06,450.54,2368.52,134158.22,mortgage,8,4
28,134158.22,2819.06,442.72,2376.34,131781.88,mortgage,8,4
29,131781.88,2819.06,434.88,2384.18,129397.7,mortgage,8,4
30,129397.7,2819.06,427.01,2392.05,127005.65,mortgage,8,4
31,127005.65,2819.06,419.12,2399.94,124605.71,mortgage,8,4
32,124605.71,2819.06,411.2,2407.86,122197.85,mortgage,8,4
33,122197.85,2819.06,403.25,2415.81,119782.04,mortgage,8,4
34,119782.04,2819.06,395.28,2423.78,117358.26,mortgage,8,4
35,117358.26,2819.06,387.28,2431.78,114926.48,mortgage,8,4
36,114926.48,2819.06,379.26,2439.8,112486.68,mortgage,8,4
37,112486.68,2819.06,371.21,2447.85,110038.83,mortgage,8,4
38,110038.83,2819.06,363.13,2455.93,107582.9,mortgage,8,4
39,107582.9,2819.06,355.02,2464.04,105118.86,mortgage,8,4
40,105118.86,2819.06,346.89,2472.17,102646.69,mortgage,8,4
41,102646.69,2819.06,338.73,2480.33,100166.36,mortgage,8,4
42,100166.36,2819.06,330.55,2488.51,97677.85,mortgage,8,4
43,97677.85,2819.06,322.34,2496.72,95181.13,mortgage,8,4
44,95181.13,2819.06,314.1,2504.96,92676.17,mortgage,8,4
45,92676.17,2819.06,305.83,2513.23,90162.94,mortgage,8,4
46,90162.94,2819.06,297.54,2521.52,87641.42,mortgage,8,4
47,87641.42,2819.06,289.22,2529.84,85111.58,mortgage,8,4
48,85111.58,2819.06,280.87,2538.19,82573.39,mortgage,8,4
49,82573.39,2819.06,272.49,2546.57,80026.82,mortgage,8,4
50,80026.82,2819.06,264.09,2554.97,77471.85,mortgage,8,4
51,77471.85,2819.06,255.66,2563.4,74908.45,mortgage,8,4
52,74908.45,2819.06,247.2,2571.86,72336.59,mortgage,8,4
53,72336.59,2819.06,238.71,2580.35,69756.24,mortgage,8,4
54,69756.24,2819.06,230.2,2588.86,67167.38,mortgage,8,4
55,67167.38,2819.06,221.65,2597.41,64569.97,mortgage,8,4
56,64569.97,2819.06,213.08,2605.98,61963.99,mortgage,8,4
57,61963.99,2819.06,204.48,2614.58,59349.41,mortgage,8,4
58,59349.41,2819.06,195.85,2623.21,56726.2,mortgage,8,4
59,56726.2,2819.06,187.2,2631.86,54094.34,mortgage,8,4
60,54094.34,2819.06,178.51,2640.55,51453.79,mortgage,8,4
61,51453.79,2819.06,169.8,2649.26,48804.53,mortgage,8,4
62,48804.53,2819.06,161.05,2658.01,46146.52,mortgage,8,4
63,46146.52,2819.06,152.28,2666.78,43479.74,mortgage,8,4
64,43479.74,2819.06,143.48,2675.58,40804.16,mortgage,8,4
65,40804.16,2819.06,134.65,2684.41,38119.75,mortgage,8,4
66,38119.75,2819.06,125.8,2693.26,35426.49,mortgage,8,4
67,35426.49,2819.06,116.91,2702.15,32724.34,mortgage,8,4
68,32724.34,2819.06,107.99,2711.07,30013.27,mortgage,8,4
69,30013.27,2819.06,99.04,2720.02,27293.25,mortgage,8,4
70,27293.25,2819.06,90.07,2728.99,24564.26,mortgage,8,4
71,24564.26,2819.06,81.06,2738.0,21826.26,mortgage,8,4
72,21826.26,2819.06,72.03,2747.03,19079.23,mortgage,8,4
73,19079.23,2819.06,62.96,2756.1,16323.13,mortgage,8,4
74,16323.13,2819.06,53.87,2765.19,13557.94,mortgage,8,4
75,13557.94,2819.06,44.74,2774.32,10783.62,mortgage,8,4
76,10783.62,2819.06,35.59,2783.47,8000.15,mortgage,8,4
77,8000.15,2819.06,26.4,2792.66,5207.49,mortgage,8,4
78,5207.49,2819.06,17.18,2801.88,2405.61,mortgage,8,4
79,2405.61,2819.06,7.94,2811.12,-405.51,mortgage,8,4
0,20000.0,191.04,108.0,83.04,19916.96,WellsFargo2,8,5
1,19916.96,191.04,107.55,83.49,19833.47,WellsFargo2,8,5
2,19833.47,191.04,107.1,83.94,19749.53,WellsFargo2,8,5
3,19749.53,191.04,106.65,84.39,19665.14,WellsFargo2,8,5
4,19665.14,191.04,106.19,84.85,19580.29,WellsFargo2,8,5
5,19580.29,191.04,105.73,85.31,19494.98,WellsFargo2,8,5
6,19494.98,191.04,105.27,85.77,19409.21,WellsFargo2,8,5
7,19409.21,191.04,104.81,86.23,19322.98,WellsFargo2,8,5
8,19322.98,191.04,104.34,86.7,19236.28,WellsFargo2,8,5
9,19236.28,191.04,103.88,87.16,19149.12,WellsFargo2,8,5
10,19149.12,191.04,103.41,87.63,19061.49,WellsFargo2,8,5
11,19061.49,191.04,102.93,88.11,18973.38,WellsFargo2,8,5
12,18973.38,191.04,102.46,88.58,18884.8,WellsFargo2,8,5
13,18884.8,191.04,101.98,89.06,18795.74,WellsFargo2,8,5
14,18795.74,191.04,101.5,89.54,18706.2,WellsFargo2,8,5
15,18706.2,191.04,101.01,90.03,18616.17,WellsFargo2,8,5
16,18616.17,191.04,100.53,90.51,18525.66,WellsFargo2,8,5
17,18525.66,191.04,100.04,91.0,18434.66,WellsFargo2,8,5
18,18434.66,191.04,99.55,91.49,18343.17,WellsFargo2,8,5
19,18343.17,191.04,99.05,91.99,18251.18,WellsFargo2,8,5
20,18251.18,191.04,98.56,92.48,18158.7,WellsFargo2,8,5
21,18158.7,191.04,98.06,92.98,18065.72,WellsFargo2,8,5
22,18065.72,191.04,97.55,93.49,17972.23,WellsFargo2,8,5
23,17972.23,191.04,97.05,93.99,17878.24,WellsFargo2,8,5
24,17878.24,191.04,96.54,94.5,17783.74,WellsFargo2,8,5
25,17783.74,191.04,96.03,95.01,17688.73,WellsFargo2,8,5
26,17688.73,191.04,95.52,95.52,17593.21,WellsFargo2,8,5
27,17593.21,191.04,95.0,96.04,17497.17,WellsFargo2,8,5
28,17497.17,191.04,94.48,96.56,17400.61,WellsFargo2,8,5
29,17400.61,191.04,93.96,97.08,17303.53,WellsFargo2,8,5
30,17303.53,191.04,93.44,97.6,17205.93,WellsFargo2,8,5
31,17205.93,191.04,92.91,98.13,17107.8,WellsFargo2,8,5
32,17107.8,191.04,92.38,98.66,17009.14,WellsFargo2,8,5
33,17009.14,191.04,91.85,99.19,16909.95,WellsFargo2,8,5
34,16909.95,191.04,91.31,99.73,16810.22,WellsFargo2,8,5
35,16810.22,191.04,90.78,100.26,16709.96,WellsFargo2,8,5
36,16709.96,191.04,90.23,100.81,16609.15,WellsFargo2,8,5
37,16609.15,191.04,89.69,101.35,16507.8,WellsFargo2,8,5
38,16507.8,191.04,89.14,101.9,16405.9,WellsFargo2,8,5
39,16405.9,191.04,88.59,102.45,16303.45,WellsFargo2,8,5
40,16303.45,191.04,88.04,103.0,16200.45,WellsFargo2,8,5
41,16200.45,191.04,87.48,103.56,16096.89,WellsFargo2,8,5
42,16096.89,191.04,86.92,104.12,15992.77,WellsFargo2,8,5
43,15992.77,191.04,86.36,104.68,15888.09,WellsFargo2,8,5
44,15888.09,191.04,85.8,105.24,15782.85,WellsFargo2,8,5
45,15782.85,191.04,85.23,105.81,15677.04,WellsFargo2,8,5
46,15677.04,191.04,84.66,106.38,15570.66,WellsFargo2,8,5
47,15570.66,191.04,84.08,106.96,15463.7,WellsFargo2,8,5
48,15463.7,191.04,83.5,107.54,15356.16,WellsFargo2,8,5
49,15356.16,191.04,82.92,108.12,15248.04,WellsFargo2,8,5
50,15248.04,191.04,82.34,108.7,15139.34,WellsFargo2,8,5
51,15139.34,191.04,81.75,109.29,15030.05,WellsFargo2,8,5
52,15030.05,191.04,81.16,109.88,14920.17,WellsFargo2,8,5
53,14920.17,191.04,80.57,110.47,14809.7,WellsFargo2,8,5
54,14809.7,191.04,79.97,111.07,14698.63,WellsFargo2,8,5
55,14698.63,191.04,79.37,111.67,14586.96,WellsFargo2,8,5
56,14586.96,191.04,78.77,112.27,14474.69,WellsFargo2,8,5
57,14474.69,191.04,78.16,112.88,14361.81,WellsFargo2,8,5
58,14361.81,191.04,77.55,113.49,14248.32,WellsFargo2,8,5
59,14248.32,191.04,76.94,114.1,14134.22,WellsFargo2,8,5
60,14134.22,191.04,76.32,114.72,14019.5,WellsFargo2,8,5
61,14019.5,191.04,75.71,115.33,13904.17,WellsFargo2,8,5
62,13904.17,191.04,75.08,115.96,13788.21,WellsFargo2,8,5
63,13788.21,191.04,74.46,116.58,13671.63,WellsFargo2,8,5
64,13671.63,191.04,73.83,117.21,13554.42,WellsFargo2,8,5
65,13554.42,191.04,73.19,117.85,13436.57,WellsFargo2,8,5
66,13436.57,191.04,72.56,118.48,13318.09,WellsFargo2,8,5
67,13318.09,191.04,71.92,119.12,13198.97,WellsFargo2,8,5
68,13198.97,191.04,71.27,119.77,13079.2,WellsFargo2,8,5
69,13079.2,191.04,70.63,120.41,12958.79,WellsFargo2,8,5
70,12958.79,191.04,69.98,121.06,12837.73,WellsFargo2,8,5
71,12837.73,191.04,69.32,121.72,12716.01,WellsFargo2,8,5
72,12716.01,191.04,68.67,122.37,12593.64,WellsFargo2,8,5
73,12593.64,191.04,68.01,123.03,12470.61,WellsFargo2,8,5
74,12470.61,191.04,67.34,123.7,12346.91,WellsFargo2,8,5
75,12346.91,191.04,66.67,124.37,12222.54,WellsFargo2,8,5
76,12222.54,191.04,66.0,125.04,12097.5,WellsFargo2,8,5
77,12097.5,191.04,65.33,125.71,11971.79,WellsFargo2,8,5
78,11971.79,191.04,64.65,126.39,11845.4,WellsFargo2,8,5
79,11845.4,596.55,63.97,532.58,11312.82,WellsFargo2,8,5
80,11312.82,3010.1,61.09,2949.01,8363.81,WellsFargo2,8,5
81,8363.81,3010.1,45.16,2964.94,5398.87,WellsFargo2,8,5
82,5398.87,3010.1,29.15,2980.95,2417.92,WellsFargo2,8,5
83,2417.92,3010.1,13.06,2997.04,-579.12,WellsFargo2,8,5
0,4000.0,1070.0,16.0,1054.0,2946.0,testing,9,1
1,2946.0,1070.0,11.78,1058.22,1887.78,testing,9,1
2,1887.78,1070.0,7.55,1062.45,825.33,testing,9,1
3,825.33,1070.0,3.3,1066.7,-241.37,testing,9,1
0,8250.57,84.62,53.63,30.99,8219.58,WellsFargo1,9,2
1,8219.58,84.62,53.43,31.19,8188.39,WellsFargo1,9,2
2,8188.39,84.62,53.22,31.4,8156.99,WellsFargo1,9,2
3,8156.99,325.99,53.02,272.97,7884.02,WellsFargo1,9,2
4,7884.02,1154.62,51.25,1103.37,6780.65,WellsFargo1,9,2
5,6780.65,1154.62,44.07,1110.55,5670.1,WellsFargo1,9,2
6,5670.1,1154.62,36.86,1117.76,4552.34,WellsFargo1,9,2
7,4552.34,1154.62,29.59,1125.03,3427.31,WellsFargo1,9,2
8,3427.31,1154.62,22.28,1132.34,2294.97,WellsFargo1,9,2
9,2294.97,1154.62,14.92,1139.7,1155.27,WellsFargo1,9,2
10,1155.27,1154.62,7.51,1147.11,8.16,WellsFargo1,9,2
11,8.16,1154.62,0.05,1154.57,-1146.41,WellsFargo1,9,2
0,20000.0,191.04,108.0,83.04,19916.96,WellsFargo2,9,3
1,19916.96,191.04,107.55,83.49,19833.47,WellsFargo2,9,3
2,19833.47,191.04,107.1,83.94,19749.53,WellsFargo2,9,3
3,19749.53,191.04,106.65,84.39,19665.14,WellsFargo2,9,3
4,19665.14,191.04,106.19,84.85,19580.29,WellsFargo2,9,3
5,19580.29,191.04,105.73,85.31,19494.98,WellsFargo2,9,3
6,19494.98,191.04,105.27,85.77,19409.21,WellsFargo2,9,3
7,19409.21,191.04,104.81,86.23,19322.98,WellsFargo2,9,3
8,19322.98,191.04,104.34,86.7,19236.28,WellsFargo2,9,3
9,19236.28,191.04,103.88,87.16,19149.12,WellsFargo2,9,3
10,19149.12,191.04,103.41,87.63,19061.49,WellsFargo2,9,3
11,19061.49,1337.45,102.93,1234.52,17826.97,WellsFargo2,9,3
12,17826.97,1345.66,96.27,1249.39,16577.58,WellsFargo2,9,3
13,16577.58,1345.66,89.52,1256.14,15321.44,WellsFargo2,9,3
14,15321.44,1345.66,82.74,1262.92,14058.52,WellsFargo2,9,3
15,14058.52,1345.66,75.92,1269.74,12788.78,WellsFargo2,9,3
16,12788.78,1345.66,69.06,1276.6,11512.18,WellsFargo2,9,3
17,11512.18,1345.66,62.17,1283.49,10228.69,WellsFargo2,9,3
18,10228.69,1345.66,55.23,1290.43,8938.26,WellsFargo2,9,3
19,8938.26,1345.66,48.27,1297.39,7640.87,WellsFargo2,9,3
20,7640.87,1345.66,41.26,1304.4,6336.47,WellsFargo2,9,3
21,6336.47,1345.66,34.22,1311.44,5025.03,WellsFargo2,9,3
22,5025.03,1345.66,27.14,1318.52,3706.51,WellsFargo2,9,3
23,3706.51,1345.66,20.02,1325.64,2380.87,WellsFargo2,9,3
24,2380.87,1345.66,12.86,1332.8,1048.07,WellsFargo2,9,3
25,1048.07,1345.66,5.66,1340.0,-291.93,WellsFargo2,9,3
0,5000.0,333.0,36.0,297.0,4703.0,Car,9,4
1,4703.0,333.0,33.86,299.14,4403.86,Car,9,4
2,4403.86,333.0,31.71,301.29,4102.57,Car,9,4
3,4102.57,333.0,29.54,303.46,3799.11,Car,9,4
4,3799.11,333.0,27.35,305.65,3493.46,Car,9,4
5,3493.46,333.0,25.15,307.85,3185.61,Car,9,4
6,3185.61,333.0,22.94,310.06,2875.55,Car,9,4
7,2875.55,333.0,20.7,312.3,2563.25,Car,9,4
8,2563.25,333.0,18.46,314.54,2248.71,Car,9,4
9,2248.71,333.0,16.19,316.81,1931.9,Car,9,4
10,1931.9,333.0,13.91,319.09,1612.81,Car,9,4
11,1612.81,333.0,11.61,321.39,1291.42,Car,9,4
12,1291.42,333.0,9.3,323.7,967.72,Car,9,4
13,967.72,333.0,6.97,326.03,641.69,Car,9,4
14,641.69,333.0,4.62,328.38,313.31,Car,9,4
15,313.31,333.0,2.26,330.74,-17.43,Car,9,4
0,180000.0,1331.44,594.0,737.44,179262.56,mortgage,9,5
1,179262.56,1331.44,591.57,739.87,178522.69,mortgage,9,5
2,178522.69,1331.44,589.12,742.32,177780.37,mortgage,9,5
3,177780.37,1331.44,586.68,744.76,177035.61,mortgage,9,5
4,177035.61,1331.44,584.22,747.22,176288.39,mortgage,9,5
5,176288.39,1331.44,581.75,749.69,175538.7,mortgage,9,5
6,175538.7,1331.44,579.28,752.16,174786.54,mortgage,9,5
7,174786.54,1331.44,576.8,754.64,174031.9,mortgage,9,5
8,174031.9,1331.44,574.31,757.13,173274.77,mortgage,9,5
9,173274.77,1331.44,571.81,759.63,172515.14,mortgage,9,5
10,172515.14,1331.44,569.3,762.14,171753.0,mortgage,9,5
11,171753.0,1331.44,566.78,764.66,170988.34,mortgage,9,5
12,170988.34,1331.44,564.26,767.18,170221.16,mortgage,9,5
13,170221.16,1331.44,561.73,769.71,169451.45,mortgage,9,5
14,169451.45,1331.44,559.19,772.25,168679.2,mortgage,9,5
15,168679.2,1348.87,556.64,792.23,167886.97,mortgage,9,5
16,167886.97,3010.1,554.03,2456.07,165430.9,mortgage,9,5
17,165430.9,3010.1,545.92,2464.18,162966.72,mortgage,9,5
18,162966.72,3010.1,537.79,2472.31,160494.41,mortgage,9,5
19,160494.41,3010.1,529.63,2480.47,158013.94,mortgage,9,5
20,158013.94,3010.1,521.45,2488.65,155525.29,mortgage,9,5
21,155525.29,3010.1,513.23,2496.87,153028.42,mortgage,9,5
22,153028.42,3010.1,504.99,2505.11,150523.31,mortgage,9,5
23,150523.31,3010.1,496.73,2513.37,148009.94,mortgage,9,5
24,148009.94,3010.1,488.43,2521.67,145488.27,mortgage,9,5
25,145488.27,3010.1,480.11,2529.99,142958.28,mortgage,9,5
26,142958.28,3010.1,471.76,2538.34,140419.94,mortgage,9,5
27,140419.94,3010.1,463.39,2546.71,137873.23,mortgage,9,5
28,137873.23,3010.1,454.98,2555.12,135318.11,mortgage,9,5
29,135318.11,3010.1,446.55,2563.55,132754.56,mortgage,9,5
30,132754.56,3010.1,438.09,2572.01,130182.55,mortgage,9,5
31,130182.55,3010.1,429.6,2580.5,127602.05,mortgage,9,5
32,127602.05,3010.1,421.09,2589.01,125013.04,mortgage,9,5
33,125013.04,3010.1,412.54,2597.56,122415.48,mortgage,9,5
34,122415.48,3010.1,403.97,2606.13,119809.35,mortgage,9,5
35,119809.35,3010.1,395.37,2614.73,117194.62,mortgage,9,5
36,117194.62,3010.1,386.74,2623.36,114571.26,mortgage,9,5
37,114571.26,3010.1,378.09,2632.01,111939.25,mortgage,9,5
38,111939.25,3010.1,369.4,2640.7,109298.55,mortgage,9,5
39,109298.55,3010.1,360.69,2649.41,106649.14,mortgage,9,5
40,106649.14,3010.1,351.94,2658.16,103990.98,mortgage,9,5
41,103990.98,3010.1,343.17,2666.93,101324.05,mortgage,9,5
42,101324.05,3010.1,334.37,2675.73,98648.32,mortgage,9,5
43,98648.32,3010.1,325.54,2684.56,95963.76,mortgage,9,5
44,95963.76,3010.1,316.68,2693.42,93270.34,mortgage,9,5
45,93270.34,3010.1,307.79,2702.31,90568.03,mortgage,9,5
46,90568.03,3010.1,298.87,2711.23,87856.8,mortgage,9,5
47,87856.8,3010.1,289.93,2720.17,85136.63,mortgage,9,5
48,85136.63,3010.1,280.95,2729.15,82407.48,mortgage,9,5
49,82407.48,3010.1,271.94,2738.16,79669.32,mortgage,9,5
50,79669.32,3010.1,262.91,2747.19,76922.13,mortgage,9,5
51,76922.13,3010.1,253.84,2756.26,74165.87,mortgage,9,5
52,74165.87,3010.1,244.75,2765.35,71400.52,mortgage,9,5
53,71400.52,3010.1,235.62,2774.48,68626.04,mortgage,9,5
54,68626.04,3010.1,226.47,2783.63,65842.41,mortgage,9,5
55,65842.41,3010.1,217.28,2792.82,63049.59,mortgage,9,5
56,63049.59,3010.1,208.06,2802.04,60247.55,mortgage,9,5
57,60247.55,3010.1,198.82,2811.28,57436.27,mortgage,9,5
58,57436.27,3010.1,189.54,2820.56,54615.71,mortgage,9,5
59,54615.71,3010.1,180.23,2829.87,51785.84,mortgage,9,5
60,51785.84,3010.1,170.89,2839.21,48946.63,mortgage,9,5
61,48946.63,3010.1,161.52,2848.58,46098.05,mortgage,9,5
62,46098.05,3010.1,152.12,2857.98,43240.07,mortgage,9,5
63,43240.07,3010.1,142.69,2867.41,40372.66,mortgage,9,5
64,40372.66,3010.1,133.23,2876.87,37495.79,mortgage,9,5
65,37495.79,3010.1,123.74,2886.36,34609.43,mortgage,9,5
66,34609.43,3010.1,114.21,2895.89,31713.54,mortgage,9,5
67,31713.54,3010.1,104.65,2905.45,28808.09,mortgage,9,5
68,28808.09,3010.1,95.07,2915.03,25893.06,mortgage,9,5
69,25893.06,3010.1,85.45,2924.65,22968.41,mortgage,9,5
70,22968.41,3010.1,75.8,2934.3,20034.11,mortgage,9,5
71,20034.11,3010.1,66.11,2943.99,17090.12,mortgage,9,5
72,17090.12,3010.1,56.4,2953.7,14136.42,mortgage,9,5
73,14136.42,3010.1,46.65,2963.45,11172.97,mortgage,9,5
74,11172.97,3010.1,36.87,2973.23,8199.74,mortgage,9,5
75,8199.74,3010.1,27.06,2983.04,5216.7,mortgage,9,5
76,5216.7,3010.1,17.22,2992.88,2223.82,mortgage,9,5
77,2223.82,3010.1,7.34,3002.76,-778.94,mortgage,9,5
0,4000.0,1070.0,16.0,1054.0,2946.0,testing,10,1
1,2946.0,1070.0,11.78,1058.22,1887.78,testing,10,1
2,1887.78,1070.0,7.55,1062.45,825.33,testing,10,1
3,825.33,1070.0,3.3,1066.7,-241.37,testing,10,1
0,8250.57,84.62,53.63,30.99,8219.58,WellsFargo1,10,2
1,8219.58,84.62,53.43,31.19,8188.39,WellsFargo1,10,2
2,8188.39,84.62,53.22,31.4,8156.99,WellsFargo1,10,2
3,8156.99,325.99,53.02,272.97,7884.02,WellsFargo1,10,2
4,7884.02,1154.62,51.25,1103.37,6780.65,WellsFargo1,10,2
5,6780.65,1154.62,44.07,1110.55,5670.1,WellsFargo1,10,2
6,5670.1,1154.62,36.86,1117.76,4552.34,WellsFargo1,10,2
7,4552.34,1154.62,29.59,1125.03,3427.31,WellsFargo1,10,2
8,3427.31,1154.62,22.28,1132.34,2294.97,WellsFargo1,10,2
9,2294.97,1154.62,14.92,1139.7,1155.27,WellsFargo1,10,2
10,1155.27,1154.62,7.51,1147.11,8.16,WellsFargo1,10,2
11,8.16,1154.62,0.05,1154.57,-1146.41,WellsFargo1,10,2
0,20000.0,191.04,108.0,83.04,19916.96,WellsFargo2,10,3
1,19916.96,191.04,107.55,83.49,19833.47,WellsFargo2,10,3
2,19833.47,191.04,107.1,83.94,19749.53,WellsFargo2,10,3
3,19749.53,191.04,106.65,84.39,19665.14,WellsFargo2,10,3
4,19665.14,191.04,106.19,84.85,19580.29,WellsFargo2,10,3
5,19580.29,191.04,105.73,85.31,19494.98,WellsFargo2,10,3
6,19494.98,191.04,105.27,85.77,19409.21,WellsFargo2,10,3
7,19409.21,191.04,104.81,86.23,19322.98,WellsFargo2,10,3
8,19322.98,191.04,104.34,86.7,19236.28,WellsFargo2,10,3
9,19236.28,191.04,103.88,87.16,19149.12,WellsFargo2,10,3
10,19149.12,191.04,103.41,87.63,19061.49,WellsFargo2,10,3
11,19061.49,1337.45,102.93,1234.52,17826.97,WellsFargo2,10,3
12,17826.97,1345.66,96.27,1249.39,16577.58,WellsFargo2,10,3
13,16577.58,1345.66,89.52,1256.14,15321.44,WellsFargo2,10,3
14,15321.44,1345.66,82.74,1262.92,14058.52,WellsFargo2,10,3
15,14058.52,1345.66,75.92,1269.74,12788.78,WellsFargo2,10,3
16,12788.78,1345.66,69.06,1276.6,11512.18,WellsFargo2,10,3
17,11512.18,1345.66,62.17,1283.49,10228.69,WellsFargo2,10,3
18,10228.69,1345.66,55.23,1290.43,8938.26,WellsFargo2,10,3
19,8938.26,1345.66,48.27,1297.39,7640.87,WellsFargo2,10,3
20,7640.87,1345.66,41.26,1304.4,6336.47,WellsFargo2,10,3
21,6336.47,1345.66,34.22,1311.44,5025.03,WellsFargo2,10,3
22,5025.03,1345.66,27.14,1318.52,3706.51,WellsFargo2,10,3
23,3706.51,1345.66,20.02,1325.64,2380.87,WellsFargo2,10,3
24,2380.87,1345.66,12.86,1332.8,1048.07,WellsFargo2,10,3
25,1048.07,1345.66,5.66,1340.0,-291.93,WellsFargo2,10,3
0,180000.0,1331.44,594.0,737.44,179262.56,mortgage,10,4
1,179262.56,1331.44,591.57,739.87,178522.69,mortgage,10,4
2,178522.69,1331.44,589.12,742.32,177780.37,mortgage,10,4
3,177780.37,1331.44,586.68,744.76,177035.61,mortgage,10,4
4,177035.61,1331.44,584.22,747.22,176288.39,mortgage,10,4
5,176288.39,1331.44,581.75,749.69,175538.7,mortgage,10,4
6,175538.7,1331.44,579.28,752.16,174786.54,mortgage,10,4
7,174786.54,1331.44,576.8,754.64,174031.9,mortgage,10,4
8,174031.9,1331.44,574.31,757.13,173274.77,mortgage,10,4
9,173274.77,1331.44,571.81,759.63,172515.14,mortgage,10,4
10,172515.14,1331.44,569.3,762.14,171753.0,mortgage,10,4
11,171753.0,1331.44,566.78,764.66,170988.34,mortgage,10,4
12,170988.34,1331.44,564.26,767.18,170221.16,mortgage,10,4
13,170221.16,1331.44,561.73,769.71,169451.45,mortgage,10,4
14,169451.45,1331.44,559.19,772.25,168679.2,mortgage,10,4
15,168679.2,1331.44,556.64,774.8,167904.4,mortgage,10,4
16,167904.4,1331.44,554.08,777.36,167127.04,mortgage,10,4
17,167127.04,1331.44,551.52,779.92,166347.12,mortgage,10,4
18,166347.12,1331.44,548.95,782.49,165564.63,mortgage,10,4
19,165564.63,1331.44,546.36,785.08,164779.55,mortgage,10,4
20,164779.55,1331.44,543.77,787.67,163991.88,mortgage,10,4
21,163991.88,1331.44,541.17,790.27,163201.61,mortgage,10,4
22,163201.61,1331.44,538.57,792.87,162408.74,mortgage,10,4
23,162408.74,1331.44,535.95,795.49,161613.25,mortgage,10,4
24,161613.25,1331.44,533.32,798.12,160815.13,mortgage,10,4
25,160815.13,1623.37,530.69,1092.68,159722.45,mortgage,10,4
26,159722.45,2677.1,527.08,2150.02,157572.43,mortgage,10,4
27,157572.43,2677.1,519.99,2157.11,155415.32,mortgage,10,4
28,155415.32,2677.1,512.87,2164.23,153251.09,mortgage,10,4
29,153251.09,2677.1,505.73,2171.37,151079.72,mortgage,10,4
30,151079.72,2677.1,498.56,2178.54,148901.18,mortgage,10,4
31,148901.18,2677.1,491.37,2185.73,146715.45,mortgage,10,4
32,146715.45,2677.1,484.16,2192.94,144522.51,mortgage,10,4
33,144522.51,2677.1,476.92,2200.18,142322.33,mortgage,10,4
34,142322.33,2677.1,469.66,2207.44,140114.89,mortgage,10,4
35,140114.89,2677.1,462.38,2214.72,137900.17,mortgage,10,4
36,137900.17,2677.1,455.07,2222.03,135678.14,mortgage,10,4
37,135678.14,2677.1,447.74,2229.36,133448.78,mortgage,10,4
38,133448.78,2677.1,440.38,2236.72,131212.06,mortgage,10,4
39,131212.06,2677.1,433.0,2244.1,128967.96,mortgage,10,4
40,128967.96,2677.1,425.59,2251.51,126716.45,mortgage,10,4
41,126716.45,2677.1,418.16,2258.94,124457.51,mortgage,10,4
42,124457.51,2677.1,410.71,2266.39,122191.12,mortgage,10,4
43,122191.12,2677.1,403.23,2273.87,119917.25,mortgage,10,4
44,119917.25,2677.1,395.73,2281.37,117635.88,mortgage,10,4
45,117635.88,2677.1,388.2,2288.9,115346.98,mortgage,10,4
46,115346.98,2677.1,380.65,2296.45,113050.53,mortgage,10,4
47,113050.53,2677.1,373.07,2304.03,110746.5,mortgage,10,4
48,110746.5,2677.1,365.46,2311.64,108434.86,mortgage,10,4
49,108434.86,2677.1,357.84,2319.26,106115.6,mortgage,10,4
50,106115.6,2677.1,350.18,2326.92,103788.68,mortgage,10,4
51,103788.68,2677.1,342.5,2334.6,101454.08,mortgage,10,4
52,101454.08,2677.1,334.8,2342.3,99111.78,mortgage,10,4
53,99111.78,2677.1,327.07,2350.03,96761.75,mortgage,10,4
54,96761.75,2677.1,319.31,2357.79,94403.96,mortgage,10,4
55,94403.96,2677.1,311.53,2365.57,92038.39,mortgage,10,4
56,92038.39,2677.1,303.73,2373.37,89665.02,mortgage,10,4
57,89665.02,2677.1,295.89,2381.21,87283.81,mortgage,10,4
58,87283.81,2677.1,288.04,2389.06,84894.75,mortgage,10,4
59,84894.75,2677.1,280.15,2396.95,82497.8,mortgage,10,4
60,82497.8,2677.1,272.24,2404.86,80092.94,mortgage,10,4
61,80092.94,2677.1,264.31,2412.79,77680.15,mortgage,10,4
62,77680.15,2677.1,256.34,2420.76,75259.39,mortgage,10,4
63,75259.39,2677.1,248.36,2428.74,72830.65,mortgage,10,4
64,72830.65,2677.1,240.34,2436.76,70393.89,mortgage,10,4
65,70393.89,2677.1,232.3,2444.8,67949.09,mortgage,10,4
66,67949.09,2677.1,224.23,2452.87,65496.22,mortgage,10,4
67,65496.22,2677.1,216.14,2460.96,63035.26,mortgage,10,4
68,63035.26,2677.1,208.02,2469.08,60566.18,mortgage,10,4
69,60566.18,2677.1,199.87,2477.23,58088.95,mortgage,10,4
70,58088.95,2677.1,191.69,2485.41,55603.54,mortgage,10,4
71,55603.54,2677.1,183.49,2493.61,53109.93,mortgage,10,4
72,53109.93,2677.1,175.26,2501.84,50608.09,mortgage,10,4
73,50608.09,2677.1,167.01,2510.09,48098.0,mortgage,10,4
74,48098.0,2677.1,158.72,2518.38,45579.62,mortgage,10,4
75,45579.62,2677.1,150.41,2526.69,43052.93,mortgage,10,4
76,43052.93,2677.1,142.07,2535.03,40517.9,mortgage,10,4
77,40517.9,2677.1,133.71,2543.39,37974.51,mortgage,10,4
78,37974.51,2677.1,125.32,2551.78,35422.73,mortgage,10,4
79,35422.73,2677.1,116.9,2560.2,32862.53,mortgage,10,4
80,32862.53,2677.1,108.45,2568.65,30293.88,mortgage,10,4
81,30293.88,2677.1,99.97,2577.13,27716.75,mortgage,10,4
82,27716.75,2677.1,91.47,2585.63,25131.12,mortgage,10,4
83,25131.12,2677.1,82.93,2594.17,22536.95,mortgage,10,4
84,22536.95,2677.1,74.37,2602.73,19934.22,mortgage,10,4
85,19934.22,2677.1,65.78,2611.32,17322.9,mortgage,10,4
86,17322.9,2677.1,57.17,2619.93,14702.97,mortgage,10,4
87,14702.97,2677.1,48.52,2628.58,12074.39,mortgage,10,4
88,12074.39,2677.1,39.85,2637.25,9437.14,mortgage,10,4
89,9437.14,2677.1,31.14,2645.96,6791.18,mortgage,10,4
90,6791.18,2677.1,22.41,2654.69,4136.49,mortgage,10,4
91,4136.49,2677.1,13.65,2663.45,1473.04,mortgage,10,4
92,1473.04,2677.1,4.86,2672.24,-1199.2,mortgage,10,4
0,5000.0,333.0,36.0,297.0,4703.0,Car,10,5
1,4703.0,333.0,33.86,299.14,4403.86,Car,10,5
2,4403.86,333.0,31.71,301.29,4102.57,Car,10,5
3,4102.57,333.0,29.54,303.46,3799.11,Car,10,5
4,3799.11,333.0,27.35,305.65,3493.46,Car,10,5
5,3493.46,333.0,25.15,307.85,3185.61,Car,10,5
6,3185.61,333.0,22.94,310.06,2875.55,Car,10,5
7,2875.55,333.0,20.7,312.3,2563.25,Car,10,5
8,2563.25,333.0,18.46,314.54,2248.71,Car,10,5
9,2248.71,333.0,16.19,316.81,1931.9,Car,10,5
10,1931.9,333.0,13.91,319.09,1612.81,Car,10,5
11,1612.81,333.0,11.61,321.39,1291.42,Car,10,5
12,1291.42,333.0,9.3,323.7,967.72,Car,10,5
13,967.72,333.0,6.97,326.03,641.69,Car,10,5
14,641.69,333.0,4.62,328.38,313.31,Car,10,5
15,313.31,333.0,2.26,330.74,-17.43,Car,10,5
0,4000.0,1070.0,16.0,1054.0,2946.0,testing,11,1
1,2946.0,1070.0,11.78,1058.22,1887.78,testing,11,1
2,1887.78,1070.0,7.55,1062.45,825.33,testing,11,1
3,825.33,1070.0,3.3,1066.7,-241.37,testing,11,1
0,8250.57,84.62,53.63,30.99,8219.58,WellsFargo1,11,2
1,8219.58,84.62,53.43,31.19,8188.39,WellsFargo1,11,2
2,8188.39,84.62,53.22,31.4,8156.99,WellsFargo1,11,2
3,8156.99,325.99,53.02,272.97,7884.02,WellsFargo1,11,2
4,7884.02,1154.62,51.25,1103.37,6780.65,WellsFargo1,11,2
5,6780.65,1154.62,44.07,1110.55,5670.1,WellsFargo1,11,2
6,5670.1,1154.62,36.86,1117.76,4552.34,WellsFargo1,11,2
7,4552.34,1154.62,29.59,1125.03,3427.31,WellsFargo1,11,2
8,3427.31,1154.62,22.28,1132.34,2294.97,WellsFargo1,11,2
9,2294.97,1154.62,14.92,1139.7,1155.27,WellsFargo1,11,2
10,1155.27,1154.62,7.51,1147.11,8.16,WellsFargo1,11,2
11,8.16,1154.62,0.05,1154.57,-1146.41,WellsFargo1,11,2
0,180000.0,1331.44,594.0,737.44,179262.56,mortgage,11,3
1,179262.56,1331.44,591.57,739.87,178522.69,mortgage,11,3
2,178522.69,1331.44,589.12,742.32,177780.37,mortgage,11,3
3,177780.37,1331.44,586.68,744.76,177035.61,mortgage,11,3
4,177035.61,1331.44,584.22,747.22,176288.39,mortgage,11,3
5,176288.39,1331.44,581.75,749.69,175538.7,mortgage,11,3
6,175538.7,1331.44,579.28,752.16,174786.54,mortgage,11,3
7,174786.54,1331.44,576.8,754.64,174031.9,mortgage,11,3
8,174031.9,1331.44,574.31,757.13,173274.77,mortgage,11,3
9,173274.77,1331.44,571.81,759.63,172515.14,mortgage,11,3
10,172515.14,1331.44,569.3,762.14,171753.0,mortgage,11,3
11,171753.0,2477.85,566.78,1911.07,169841.93,mortgage,11,3
12,169841.93,2486.06,560.48,1925.58,167916.35,mortgage,11,3
13,167916.35,2486.06,554.12,1931.94,165984.41,mortgage,11,3
14,165984.41,2486.06,547.75,1938.31,164046.1,mortgage,11,3
15,164046.1,2486.06,541.35,1944.71,162101.39,mortgage,11,3
16,162101.39,2486.06,534.93,1951.13,160150.26,mortgage,11,3
17,160150.26,2486.06,528.5,1957.56,158192.7,mortgage,11,3
18,158192.7,2486.06,522.04,1964.02,156228.68,mortgage,11,3
19,156228.68,2486.06,515.55,1970.51,154258.17,mortgage,11,3
20,154258.17,2486.06,509.05,1977.01,152281.16,mortgage,11,3
21,152281.16,2486.06,502.53,1983.53,150297.63,mortgage,11,3
22,150297.63,2486.06,495.98,1990.08,148307.55,mortgage,11,3
23,148307.55,2486.06,489.41,1996.65,146310.9,mortgage,11,3
24,146310.9,2486.06,482.83,2003.23,144307.67,mortgage,11,3
25,144307.67,2486.06,476.22,2009.84,142297.83,mortgage,11,3
26,142297.83,2486.06,469.58,2016.48,140281.35,mortgage,11,3
27,140281.35,2486.06,462.93,2023.13,138258.22,mortgage,11,3
28,138258.22,2486.06,456.25,2029.81,136228.41,mortgage,11,3
29,136228.41,2486.06,449.55,2036.51,134191.9,mortgage,11,3
30,134191.9,2486.06,442.83,2043.23,132148.67,mortgage,11,3
31,132148.67,2486.06,436.09,2049.97,130098.7,mortgage,11,3
32,130098.7,2486.06,429.33,2056.73,128041.97,mortgage,11,3
33,128041.97,2486.06,422.54,2063.52,125978.45,mortgage,11,3
34,125978.45,2486.06,415.73,2070.33,123908.12,mortgage,11,3
35,123908.12,2486.06,408.9,2077.16,121830.96,mortgage,11,3
36,121830.96,2486.06,402.04,2084.02,119746.94,mortgage,11,3
37,119746.94,2486.06,395.16,2090.9,117656.04,mortgage,11,3
38,117656.04,2486.06,388.26,2097.8,115558.24,mortgage,11,3
39,115558.24,2486.06,381.34,2104.72,113453.52,mortgage,11,3
40,113453.52,2486.06,374.4,2111.66,111341.86,mortgage,11,3
41,111341.86,2486.06,367.43,2118.63,109223.23,mortgage,11,3
42,109223.23,2486.06,360.44,2125.62,107097.61,mortgage,11,3
43,107097.61,2486.06,353.42,2132.64,104964.97,mortgage,11,3
44,104964.97,2486.06,346.38,2139.68,102825.29,mortgage,11,3
45,102825.29,2486.06,339.32,2146.74,100678.55,mortgage,11,3
46,100678.55,2486.06,332.24,2153.82,98524.73,mortgage,11,3
47,98524.73,2486.06,325.13,2160.93,96363.8,mortgage,11,3
48,96363.8,2486.06,318.0,2168.06,94195.74,mortgage,11,3
49,94195.74,2486.06,310.85,2175.21,92020.53,mortgage,11,3
50,92020.53,2486.06,303.67,2182.39,89838.14,mortgage,11,3
51,89838.14,2486.06,296.47,2189.59,87648.55,mortgage,11,3
52,87648.55,2486.06,289.24,2196.82,85451.73,mortgage,11,3
53,85451.73,2486.06,281.99,2204.07,83247.66,mortgage,11,3
54,83247.66,2486.06,274.72,2211.34,81036.32,mortgage,11,3
55,81036.32,2486.06,267.42,2218.64,78817.68,mortgage,11,3
56,78817.68,2486.06,260.1,2225.96,76591.72,mortgage,11,3
57,76591.72,2486.06,252.75,2233.31,74358.41,mortgage,11,3
58,74358.41,2486.06,245.38,2240.68,72117.73,mortgage,11,3
59,72117.73,2486.06,237.99,2248.07,69869.66,mortgage,11,3
60,69869.66,2486.06,230.57,2255.49,67614.17,mortgage,11,3
61,67614.17,2486.06,223.13,2262.93,65351.24,mortgage,11,3
62,65351.24,2486.06,215.66,2270.4,63080.84,mortgage,11,3
63,63080.84,2486.06,208.17,2277.89,60802.95,mortgage,11,3
64,60802.95,2486.06,200.65,2285.41,58517.54,mortgage,11,3
65,58517.54,2486.06,193.11,2292.95,56224.59,mortgage,11,3
66,56224.59,2486.06,185.54,2300.52,53924.07,mortgage,11,3
67,53924.07,2486.06,177.95,2308.11,51615.96,mortgage,11,3
68,51615.96,2486.06,170.33,2315.73,49300.23,mortgage,11,3
69,49300.23,2486.06,162.69,2323.37,46976.86,mortgage,11,3
70,46976.86,2486.06,155.02,2331.04,44645.82,mortgage,11,3
71,44645.82,2486.06,147.33,2338.73,42307.09,mortgage,11,3
72,42307.09,2486.06,139.61,2346.45,39960.64,mortgage,11,3
73,39960.64,2486.06,131.87,2354.19,37606.45,mortgage,11,3
74,37606.45,2486.06,124.1,2361.96,35244.49,mortgage,11,3
75,35244.49,2486.06,116.31,2369.75,32874.74,mortgage,11,3
76,32874.74,2486.06,108.49,2377.57,30497.17,mortgage,11,3
77,30497.17,2486.06,100.64,2385.42,28111.75,mortgage,11,3
78,28111.75,2486.06,92.77,2393.29,25718.46,mortgage,11,3
79,25718.46,2486.06,84.87,2401.19,23317.27,mortgage,11,3
80,23317.27,2486.06,76.95,2409.11,20908.16,mortgage,11,3
81,20908.16,2486.06,69.0,2417.06,18491.1,mortgage,11,3
82,18491.1,2486.06,61.02,2425.04,16066.06,mortgage,11,3
83,16066.06,2486.06,53.02,2433.04,13633.02,mortgage,11,3
84,13633.02,2486.06,44.99,2441.07,11191.95,mortgage,11,3
85,11191.95,2486.06,36.93,2449.13,8742.82,mortgage,11,3
86,8742.82,2486.06,28.85,2457.21,6285.61,mortgage,11,3
87,6285.61,2486.06,20.74,2465.32,3820.29,mortgage,11,3
88,3820.29,2486.06,12.61,2473.45,1346.84,mortgage,11,3
89,1346.84,2486.06,4.44,2481.62,-1134.78,mortgage,11,3
0,5000.0,333.0,36.0,297.0,4703.0,Car,11,4
1,4703.0,333.0,33.86,299.14,4403.86,Car,11,4
2,4403.86,333.0,31.71,301.29,4102.57,Car,11,4
3,4102.57,333.0,29.54,303.46,3799.11,Car,11,4
4,3799.11,333.0,27.35,305.65,3493.46,Car,11,4
5,3493.46,333.0,25.15,307.85,3185.61,Car,11,4
6,3185.61,333.0,22.94,310.06,2875.55,Car,11,4
7,2875.55,333.0,20.7,312.3,2563.25,Car,11,4
8,2563.25,333.0,18.46,314.54,2248.71,Car,11,4
9,2248.71,333.0,16.19,316.81,1931.9,Car,11,4
10,1931.9,333.0,13.91,319.09,1612.81,Car,11,4
11,1612.81,333.0,11.61,321.39,1291.42,Car,11,4
12,1291.42,333.0,9.3,323.7,967.72,Car,11,4
13,967.72,333.0,6.97,326.03,641.69,Car,11,4
14,641.69,333.0,4.62,328.38,313.31,Car,11,4
15,313.31,333.0,2.26,330.74,-17.43,Car,11,4
0,20000.0,191.04,108.0,83.04,19916.96,WellsFargo2,11,5
1,19916.96,191.04,107.55,83.49,19833.47,WellsFargo2,11,5
2,19833.47,191.04,107.1,83.94,19749.53,WellsFargo2,11,5
3,19749.53,191.04,106.65,84.39,19665.14,WellsFargo2,11,5
4,19665.14,191.04,106.19,84.85,19580.29,WellsFargo2,11,5
5,19580.29,191.04,105.73,85.31,19494.98,WellsFargo2,11,5
6,19494.98,191.04,105.27,85.77,19409.21,WellsFargo2,11,5
7,19409.21,191.04,104.81,86.23,19322.98,WellsFargo2,11,5
8,19322.98,191.04,104.34,86.7,19236.28,WellsFargo2,11,5
9,19236.28,191.04,103.88,87.16,19149.12,WellsFargo2,11,5
10,19149.12,191.04,103.41,87.63,19061.49,WellsFargo2,11,5
11,19061.49,191.04,102.93,88.11,18973.38,WellsFargo2,11,5
12,18973.38,191.04,102.46,88.58,18884.8,WellsFargo2,11,5
13,18884.8,191.04,101.98,89.06,18795.74,WellsFargo2,11,5
14,18795.74,191.04,101.5,89.54,18706.2,WellsFargo2,11,5
15,18706.2,208.47,101.01,107.46,18598.74,WellsFargo2,11,5
16,18598.74,3010.1,100.43,2909.67,15689.07,WellsFargo2,11,5
17,15689.07,3010.1,84.72,2925.38,12763.69,WellsFargo2,11,5
18,12763.69,3010.1,68.92,2941.18,9822.51,WellsFargo2,11,5
19,9822.51,3010.1,53.04,2957.06,6865.45,WellsFargo2,11,5
20,6865.45,3010.1,37.07,2973.03,3892.42,WellsFargo2,11,5
21,3892.42,3010.1,21.02,2989.08,903.34,WellsFargo2,11,5
22,903.34,3010.1,4.88,3005.22,-2101.88,WellsFargo2,11,5
0,4000.0,1070.0,16.0,1054.0,2946.0,testing,12,1
1,2946.0,1070.0,11.78,1058.22,1887.78,testing,12,1
2,1887.78,1070.0,7.55,1062.45,825.33,testing,12,1
3,825.33,1070.0,3.3,1066.7,-241.37,testing,12,1
0,8250.57,84.62,53.63,30.99,8219.58,WellsFargo1,12,2
1,8219.58,84.62,53.43,31.19,8188.39,WellsFargo1,12,2
2,8188.39,84.62,53.22,31.4,8156.99,WellsFargo1,12,2
3,8156.99,325.99,53.02,272.97,7884.02,WellsFargo1,12,2
4,7884.02,1154.62,51.25,1103.37,6780.65,WellsFargo1,12,2
5,6780.65,1154.62,44.07,1110.55,5670.1,WellsFargo1,12,2
6,5670.1,1154.62,36.86,1117.76,4552.34,WellsFargo1,12,2
7,4552.34,1154.62,29.59,1125.03,3427.31,WellsFargo1,12,2
8,3427.31,1154.62,22.28,1132.34,2294.97,WellsFargo1,12,2
9,2294.97,1154.62,14.92,1139.7,1155.27,WellsFargo1,12,2
10,1155.27,1154.62,7.51,1147.11,8.16,WellsFargo1,12,2
11,8.16,1154.62,0.05,1154.57,-1146.41,WellsFargo1,12,2
0,180000.0,1331.44,594.0,737.44,179262.56,mortgage,12,3
1,179262.56,1331.44,591.57,739.87,178522.69,mortgage,12,3
2,178522.69,1331.44,589.12,742.32,177780.37,mortgage,12,3
3,177780.37,1331.44,586.68,744.76,177035.61,mortgage,12,3
4,177035.61,1331.44,584.22,747.22,176288.39,mortgage,12,3
5,176288.39,1331.44,581.75,749.69,175538.7,mortgage,12,3
6,175538.7,1331.44,579.28,752.16,174786.54,mortgage,12,3
7,174786.54,1331.44,576.8,754.64,174031.9,mortgage,12,3
8,174031.9,1331.44,574.31,757.13,173274.77,mortgage,12,3
9,173274.77,1331.44,571.81,759.63,172515.14,mortgage,12,3
10,172515.14,1331.44,569.3,762.14,171753.0,mortgage,12,3
11,171753.0,2477.85,566.78,1911.07,169841.93,mortgage,12,3
12,169841.93,2486.06,560.48,1925.58,167916.35,mortgage,12,3
13,167916.35,2486.06,554.12,1931.94,165984.41,mortgage,12,3
14,165984.41,2486.06,547.75,1938.31,164046.1,mortgage,12,3
15,164046.1,2486.06,541.35,1944.71,162101.39,mortgage,12,3
16,162101.39,2486.06,534.93,1951.13,160150.26,mortgage,12,3
17,160150.26,2486.06,528.5,1957.56,158192.7,mortgage,12,3
18,158192.7,2486.06,522.04,1964.02,156228.68,mortgage,12,3
19,156228.68,2486.06,515.55,1970.51,154258.17,mortgage,12,3
20,154258.17,2486.06,509.05,1977.01,152281.16,mortgage,12,3
21,152281.16,2486.06,502.53,1983.53,150297.63,mortgage,12,3
22,150297.63,2486.06,495.98,1990.08,148307.55,mortgage,12,3
23,148307.55,2486.06,489.41,1996.65,146310.9,mortgage,12,3
24,146310.9,2486.06,482.83,2003.23,144307.67,mortgage,12,3
25,144307.67,2486.06,476.22,2009.84,142297.83,mortgage,12,3
26,142297.83,2486.06,469.58,2016.48,140281.35,mortgage,12,3
27,140281.35,2486.06,462.93,2023.13,138258.22,mortgage,12,3
28,138258.22,2486.06,456.25,2029.81,136228.41,mortgage,12,3
29,136228.41,2486.06,449.55,2036.51,134191.9,mortgage,12,3
30,134191.9,2486.06,442.83,2043.23,132148.67,mortgage,12,3
31,132148.67,2486.06,436.09,2049.97,130098.7,mortgage,12,3
32,130098.7,2486.06,429.33,2056.73,128041.97,mortgage,12,3
33,128041.97,2486.06,422.54,2063.52,125978.45,mortgage,12,3
34,125978.45,2486.06,415.73,2070.33,123908.12,mortgage,12,3
35,123908.12,2486.06,408.9,2077.16,121830.96,mortgage,12,3
36,121830.96,2486.06,402.04,2084.02,119746.94,mortgage,12,3
37,119746.94,2486.06,395.16,2090.9,117656.04,mortgage,12,3
38,117656.04,2486.06,388.26,2097.8,115558.24,mortgage,12,3
39,115558.24,2486.06,381.34,2104.72,113453.52,mortgage,12,3
40,113453.52,2486.06,374.4,2111.66,111341.86,mortgage,12,3
41,111341.86,2486.06,367.43,2118.63,109223.23,mortgage,12,3
42,109223.23,2486.06,360.44,2125.62,107097.61,mortgage,12,3
43,107097.61,2486.06,353.42,2132.64,104964.97,mortgage,12,3
44,104964.97,2486.06,346.38,2139.68,102825.29,mortgage,12,3
45,102825.29,2486.06,339.32,2146.74,100678.55,mortgage,12,3
46,100678.55,2486.06,332.24,2153.82,98524.73,mortgage,12,3
47,98524.73,2486.06,325.13,2160.93,96363.8,mortgage,12,3
48,96363.8,2486.06,318.0,2168.06,94195.74,mortgage,12,3
49,94195.74,2486.06,310.85,2175.21,92020.53,mortgage,12,3
50,92020.53,2486.06,303.67,2182.39,89838.14,mortgage,12,3
51,89838.14,2486.06,296.47,2189.59,87648.55,mortgage,12,3
52,87648.55,2486.06,289.24,2196.82,85451.73,mortgage,12,3
53,85451.73,2486.06,281.99,2204.07,83247.66,mortgage,12,3
54,83247.66,2486.06,274.72,2211.34,81036.32,mortgage,12,3
55,81036.32,2486.06,267.42,2218.64,78817.68,mortgage,12,3
56,78817.68,2486.06,260.1,2225.96,76591.72,mortgage,12,3
57,76591.72,2486.06,252.75,2233.31,74358.41,mortgage,12,3
58,74358.41,2486.06,245.38,2240.68,72117.73,mortgage,12,3
59,72117.73,2486.06,237.99,2248.07,69869.66,mortgage,12,3
60,69869.66,2486.06,230.57,2255.49,67614.17,mortgage,12,3
61,67614.17,2486.06,223.13,2262.93,65351.24,mortgage,12,3
62,65351.24,2486.06,215.66,2270.4,63080.84,mortgage,12,3
63,63080.84,2486.06,208.17,2277.89,60802.95,mortgage,12,3
64,60802.95,2486.06,200.65,2285.41,58517.54,mortgage,12,3
65,58517.54,2486.06,193.11,2292.95,56224.59,mortgage,12,3
66,56224.59,2486.06,185.54,2300.52,53924.07,mortgage,12,3
67,53924.07,2486.06,177.95,2308.11,51615.96,mortgage,12,3
68,51615.96,2486.06,170.33,2315.73,49300.23,mortgage,12,3
69,49300.23,2486.06,162.69,2323.37,46976.86,mortgage,12,3
70,46976.86,2486.06,155.02,2331.04,44645.82,mortgage,12,3
71,44645.82,2486.06,147.33,2338.73,42307.09,mortgage,12,3
72,42307.09,2486.06,139.61,2346.45,39960.64,mortgage,12,3
73,39960.64,2486.06,131.87,2354.19,37606.45,mortgage,12,3
74,37606.45,2486.06,124.1,2361.96,35244.49,mortgage,12,3
75,35244.49,2486.06,116.31,2369.75,32874.74,mortgage,12,3
76,32874.74,2486.06,108.49,2377.57,30497.17,mortgage,12,3
77,30497.17,2486.06,100.64,2385.42,28111.75,mortgage,12,3
78,28111.75,2486.06,92.77,2393.29,25718.46,mortgage,12,3
79,25718.46,2486.06,84.87,2401.19,23317.27,mortgage,12,3
80,23317.27,2486.06,76.95,2409.11,20908.16,mortgage,12,3
81,20908.16,2486.06,69.0,2417.06,18491.1,mortgage,12,3
82,18491.1,2486.06,61.02,2425.04,16066.06,mortgage,12,3
83,16066.06,2486.06,53.02,2433.04,13633.02,mortgage,12,3
84,13633.02,2486.06,44.99,2441.07,11191.95,mortgage,12,3
85,11191.95,2486.06,36.93,2449.13,8742.82,mortgage,12,3
86,8742.82,2486.06,28.85,2457.21,6285.61,mortgage,12,3
87,6285.61,2486.06,20.74,2465.32,3820.29,mortgage,12,3
88,3820.29,2486.06,12.61,2473.45,1346.84,mortgage,12,3
89,1346.84,2486.06,4.44,2481.62,-1134.78,mortgage,12,3
0,20000.0,191.04,108.0,83.04,19916.96,WellsFargo2,12,4
1,19916.96,191.04,107.55,83.49,19833.47,WellsFargo2,12,4
2,19833.47,191.04,107.1,83.94,19749.53,WellsFargo2,12,4
3,19749.53,191.04,106.65,84.39,19665.14,WellsFargo2,12,4
4,19665.14,191.04,106.19,84.85,19580.29,WellsFargo2,12,4
5,19580.29,191.04,105.73,85.31,19494.98,WellsFargo2,12,4
6,19494.98,191.04,105.27,85.77,19409.21,WellsFargo2,12,4
7,19409.21,191.04,104.81,86.23,19322.98,WellsFargo2,12,4
8,19322.98,191.04,104.34,86.7,19236.28,WellsFargo2,12,4
9,19236.28,191.04,103.88,87.16,19149.12,WellsFargo2,12,4
10,19149.12,191.04,103.41,87.63,19061.49,WellsFargo2,12,4
11,19061.49,191.04,102.93,88.11,18973.38,WellsFargo2,12,4
12,18973.38,191.04,102.46,88.58,18884.8,WellsFargo2,12,4
13,18884.8,191.04,101.98,89.06,18795.74,WellsFargo2,12,4
14,18795.74,191.04,101.5,89.54,18706.2,WellsFargo2,12,4
15,18706.2,191.04,101.01,90.03,18616.17,WellsFargo2,12,4
16,18616.17,191.04,100.53,90.51,18525.66,WellsFargo2,12,4
17,18525.66,191.04,100.04,91.0,18434.66,WellsFargo2,12,4
18,18434.66,191.04,99.55,91.49,18343.17,WellsFargo2,12,4
19,18343.17,191.04,99.05,91.99,18251.18,WellsFargo2,12,4
20,18251.18,191.04,98.56,92.48,18158.7,WellsFargo2,12,4
21,18158.7,191.04,98.06,92.98,18065.72,WellsFargo2,12,4
22,18065.72,191.04,97.55,93.49,17972.23,WellsFargo2,12,4
23,17972.23,191.04,97.05,93.99,17878.24,WellsFargo2,12,4
24,17878.24,191.04,96.54,94.5,17783.74,WellsFargo2,12,4
25,17783.74,191.04,96.03,95.01,17688.73,WellsFargo2,12,4
26,17688.73,191.04,95.52,95.52,17593.21,WellsFargo2,12,4
27,17593.21,191.04,95.0,96.04,17497.17,WellsFargo2,12,4
28,17497.17,191.04,94.48,96.56,17400.61,WellsFargo2,12,4
29,17400.61,191.04,93.96,97.08,17303.53,WellsFargo2,12,4
30,17303.53,191.04,93.44,97.6,17205.93,WellsFargo2,12,4
31,17205.93,191.04,92.91,98.13,17107.8,WellsFargo2,12,4
32,17107.8,191.04,92.38,98.66,17009.14,WellsFargo2,12,4
33,17009.14,191.04,91.85,99.19,16909.95,WellsFargo2,12,4
34,16909.95,191.04,91.31,99.73,16810.22,WellsFargo2,12,4
35,16810.22,191.04,90.78,100.26,16709.96,WellsFargo2,12,4
36,16709.96,191.04,90.23,100.81,16609.15,WellsFargo2,12,4
37,16609.15,191.04,89.69,101.35,16507.8,WellsFargo2,12,4
38,16507.8,191.04,89.14,101.9,16405.9,WellsFargo2,12,4
39,16405.9,191.04,88.59,102.45,16303.45,WellsFargo2,12,4
40,16303.45,191.04,88.04,103.0,16200.45,WellsFargo2,12,4
41,16200.45,191.04,87.48,103.56,16096.89,WellsFargo2,12,4
42,16096.89,191.04,86.92,104.12,15992.77,WellsFargo2,12,4
43,15992.77,191.04,86.36,104.68,15888.09,WellsFargo2,12,4
44,15888.09,191.04,85.8,105.24,15782.85,WellsFargo2,12,4
45,15782.85,191.04,85.23,105.81,15677.04,WellsFargo2,12,4
46,15677.04,191.04,84.66,106.38,15570.66,WellsFargo2,12,4
47,15570.66,191.04,84.08,106.96,15463.7,WellsFargo2,12,4
48,15463.7,191.04,83.5,107.54,15356.16,WellsFargo2,12,4
49,15356.16,191.04,82.92,108.12,15248.04,WellsFargo2,12,4
50,15248.04,191.04,82.34,108.7,15139.34,WellsFargo2,12,4
51,15139.34,191.04,81.75,109.29,15030.05,WellsFargo2,12,4
52,15030.05,191.04,81.16,109.88,14920.17,WellsFargo2,12,4
53,14920.17,191.04,80.57,110.47,14809.7,WellsFargo2,12,4
54,14809.7,191.04,79.97,111.07,14698.63,WellsFargo2,12,4
55,14698.63,191.04,79.37,111.67,14586.96,WellsFargo2,12,4
56,14586.96,191.04,78.77,112.27,14474.69,WellsFargo2,12,4
57,14474.69,191.04,78.16,112.88,14361.81,WellsFargo2,12,4
58,14361.81,191.04,77.55,113.49,14248.32,WellsFargo2,12,4
59,14248.32,191.04,76.94,114.1,14134.22,WellsFargo2,12,4
60,14134.22,191.04,76.32,114.72,14019.5,WellsFargo2,12,4
61,14019.5,191.04,75.71,115.33,13904.17,WellsFargo2,12,4
62,13904.17,191.04,75.08,115.96,13788.21,WellsFargo2,12,4
63,13788.21,191.04,74.46,116.58,13671.63,WellsFargo2,12,4
64,13671.63,191.04,73.83,117.21,13554.42,WellsFargo2,12,4
65,13554.42,191.04,73.19,117.85,13436.57,WellsFargo2,12,4
66,13436.57,191.04,72.56,118.48,13318.09,WellsFargo2,12,4
67,13318.09,191.04,71.92,119.12,13198.97,WellsFargo2,12,4
68,13198.97,191.04,71.27,119.77,13079.2,WellsFargo2,12,4
69,13079.2,191.04,70.63,120.41,12958.79,WellsFargo2,12,4
70,12958.79,191.04,69.98,121.06,12837.73,WellsFargo2,12,4
71,12837.73,191.04,69.32,121.72,12716.01,WellsFargo2,12,4
72,12716.01,191.04,68.67,122.37,12593.64,WellsFargo2,12,4
73,12593.64,191.04,68.01,123.03,12470.61,WellsFargo2,12,4
74,12470.61,191.04,67.34,123.7,12346.91,WellsFargo2,12,4
75,12346.91,191.04,66.67,124.37,12222.54,WellsFargo2,12,4
76,12222.54,191.04,66.0,125.04,12097.5,WellsFargo2,12,4
77,12097.5,191.04,65.33,125.71,11971.79,WellsFargo2,12,4
78,11971.79,191.04,64.65,126.39,11845.4,WellsFargo2,12,4
79,11845.4,191.04,63.97,127.07,11718.33,WellsFargo2,12,4
80,11718.33,191.04,63.28,127.76,11590.57,WellsFargo2,12,4
81,11590.57,191.04,62.59,128.45,11462.12,WellsFargo2,12,4
82,11462.12,191.04,61.9,129.14,11332.98,WellsFargo2,12,4
83,11332.98,191.04,61.2,129.84,11203.14,WellsFargo2,12,4
84,11203.14,191.04,60.5,130.54,11072.6,WellsFargo2,12,4
85,11072.6,191.04,59.79,131.25,10941.35,WellsFargo2,12,4
86,10941.35,191.04,59.08,131.96,10809.39,WellsFargo2,12,4
87,10809.39,191.04,58.37,132.67,10676.72,WellsFargo2,12,4
88,10676.72,191.04,57.65,133.39,10543.33,WellsFargo2,12,4
89,10543.33,1325.82,56.93,1268.89,9274.44,WellsFargo2,12,4
90,9274.44,2677.1,50.08,2627.02,6647.42,WellsFargo2,12,4
91,6647.42,2677.1,35.9,2641.2,4006.22,WellsFargo2,12,4
92,4006.22,2677.1,21.63,2655.47,1350.75,WellsFargo2,12,4
93,1350.75,2677.1,7.29,2669.81,-1319.06,WellsFargo2,12,4
0,5000.0,333.0,36.0,297.0,4703.0,Car,12,5
1,4703.0,333.0,33.86,299.14,4403.86,Car,12,5
2,4403.86,333.0,31.71,301.29,4102.57,Car,12,5
3,4102.57,333.0,29.54,303.46,3799.11,Car,12,5
4,3799.11,333.0,27.35,305.65,3493.46,Car,12,5
5,3493.46,333.0,25.15,307.85,3185.61,Car,12,5
6,3185.61,333.0,22.94,310.06,2875.55,Car,12,5
7,2875.55,333.0,20.7,312.3,2563.25,Car,12,5
8,2563.25,333.0,18.46,314.54,2248.71,Car,12,5
9,2248.71,333.0,16.19,316.81,1931.9,Car,12,5
10,1931.9,333.0,13.91,319.09,1612.81,Car,12,5
11,1612.81,333.0,11.61,321.39,1291.42,Car,12,5
12,1291.42,333.0,9.3,323.7,967.72,Car,12,5
13,967.72,333.0,6.97,326.03,641.69,Car,12,5
14,641.69,333.0,4.62,328.38,313.31,Car,12,5
15,313.31,333.0,2.26,330.74,-17.43,Car,12,5
0,4000.0,1070.0,16.0,1054.0,2946.0,testing,13,1
1,2946.0,1070.0,11.78,1058.22,1887.78,testing,13,1
2,1887.78,1070.0,7.55,1062.45,825.33,testing,13,1
3,825.33,1070.0,3.3,1066.7,-241.37,testing,13,1
0,20000.0,191.04,108.0,83.04,19916.96,WellsFargo2,13,2
1,19916.96,191.04,107.55,83.49,19833.47,WellsFargo2,13,2
2,19833.47,191.04,107.1,83.94,19749.53,WellsFargo2,13,2
3,19749.53,432.41,106.65,325.76,19423.77,WellsFargo2,13,2
4,19423.77,1261.04,104.89,1156.15,18267.62,WellsFargo2,13,2
5,18267.62,1261.04,98.65,1162.39,17105.23,WellsFargo2,13,2
6,17105.23,1261.04,92.37,1168.67,15936.56,WellsFargo2,13,2
7,15936.56,1261.04,86.06,1174.98,14761.58,WellsFargo2,13,2
8,14761.58,1261.04,79.71,1181.33,13580.25,WellsFargo2,13,2
9,13580.25,1261.04,73.33,1187.71,12392.54,WellsFargo2,13,2
10,12392.54,1261.04,66.92,1194.12,11198.42,WellsFargo2,13,2
11,11198.42,1261.04,60.47,1200.57,9997.85,WellsFargo2,13,2
12,9997.85,1261.04,53.99,1207.05,8790.8,WellsFargo2,13,2
13,8790.8,1261.04,47.47,1213.57,7577.23,WellsFargo2,13,2
14,7577.23,1261.04,40.92,1220.12,6357.11,WellsFargo2,13,2
15,6357.11,1261.04,34.33,1226.71,5130.4,WellsFargo2,13,2
16,5130.4,1261.04,27.7,1233.34,3897.06,WellsFargo2,13,2
17,3897.06,1261.04,21.04,1240.0,2657.06,WellsFargo2,13,2
18,2657.06,1261.04,14.35,1246.69,1410.37,WellsFargo2,13,2
19,1410.37,1261.04,7.62,1253.42,156.95,WellsFargo2,13,2
20,156.95,1261.04,0.85,1260.19,-1103.24,WellsFargo2,13,2
0,5000.0,333.0,36.0,297.0,4703.0,Car,13,3
1,4703.0,333.0,33.86,299.14,4403.86,Car,13,3
2,4403.86,333.0,31.71,301.29,4102.57,Car,13,3
3,4102.57,333.0,29.54,303.46,3799.11,Car,13,3
4,3799.11,333.0,27.35,305.65,3493.46,Car,13,3
5,3493.46,333.0,25.15,307.85,3185.61,Car,13,3
6,3185.61,333.0,22.94,310.06,2875.55,Car,13,3
7,2875.55,333.0,20.7,312.3,2563.25,Car,13,3
8,2563.25,333.0,18.46,314.54,2248.71,Car,13,3
9,2248.71,333.0,16.19,316.81,1931.9,Car,13,3
10,1931.9,333.0,13.91,319.09,1612.81,Car,13,3
11,1612.81,333.0,11.61,321.39,1291.42,Car,13,3
12,1291.42,333.0,9.3,323.7,967.72,Car,13,3
13,967.72,333.0,6.97,326.03,641.69,Car,13,3
14,641.69,333.0,4.62,328.38,313.31,Car,13,3
15,313.31,333.0,2.26,330.74,-17.43,Car,13,3
0,8250.57,84.62,53.63,30.99,8219.58,WellsFargo1,13,4
1,8219.58,84.62,53.43,31.19,8188.39,WellsFargo1,13,4
2,8188.39,84.62,53.22,31.4,8156.99,WellsFargo1,13,4
3,8156.99,84.62,53.02,31.6,8125.39,WellsFargo1,13,4
4,8125.39,84.62,52.82,31.8,8093.59,WellsFargo1,13,4
5,8093.59,84.62,52.61,32.01,8061.58,WellsFargo1,13,4
6,8061.58,84.62,52.4,32.22,8029.36,WellsFargo1,13,4
7,8029.36,84.62,52.19,32.43,7996.93,WellsFargo1,13,4
8,7996.93,84.62,51.98,32.64,7964.29,WellsFargo1,13,4
9,7964.29,84.62,51.77,32.85,7931.44,WellsFargo1,13,4
10,7931.44,84.62,51.55,33.07,7898.37,WellsFargo1,13,4
11,7898.37,84.62,51.34,33.28,7865.09,WellsFargo1,13,4
12,7865.09,84.62,51.12,33.5,7831.59,WellsFargo1,13,4
13,7831.59,84.62,50.91,33.71,7797.88,WellsFargo1,13,4
14,7797.88,84.62,50.69,33.93,7763.95,WellsFargo1,13,4
15,7763.95,102.05,50.47,51.58,7712.37,WellsFargo1,13,4
16,7712.37,1678.66,50.13,1628.53,6083.84,WellsFargo1,13,4
17,6083.84,1678.66,39.54,1639.12,4444.72,WellsFargo1,13,4
18,4444.72,1678.66,28.89,1649.77,2794.95,WellsFargo1,13,4
19,2794.95,1678.66,18.17,1660.49,1134.46,WellsFargo1,13,4
20,1134.46,1678.66,7.37,1671.29,-536.83,WellsFargo1,13,4
0,180000.0,1331.44,594.0,737.44,179262.56,mortgage,13,5
1,179262.56,1331.44,591.57,739.87,178522.69,mortgage,13,5
2,178522.69,1331.44,589.12,742.32,177780.37,mortgage,13,5
3,177780.37,1331.44,586.68,744.76,177035.61,mortgage,13,5
4,177035.61,1331.44,584.22,747.22,176288.39,mortgage,13,5
5,176288.39,1331.44,581.75,749.69,175538.7,mortgage,13,5
6,175538.7,1331.44,579.28,752.16,174786.54,mortgage,13,5
7,174786.54,1331.44,576.8,754.64,174031.9,mortgage,13,5
8,174031.9,1331.44,574.31,757.13,173274.77,mortgage,13,5
9,173274.77,1331.44,571.81,759.63,172515.14,mortgage,13,5
10,172515.14,1331.44,569.3,762.14,171753.0,mortgage,13,5
11,171753.0,1331.44,566.78,764.66,170988.34,mortgage,13,5
12,170988.34,1331.44,564.26,767.18,170221.16,mortgage,13,5
13,170221.16,1331.44,561.73,769.71,169451.45,mortgage,13,5
14,169451.45,1331.44,559.19,772.25,168679.2,mortgage,13,5
15,168679.2,1331.44,556.64,774.8,167904.4,mortgage,13,5
16,167904.4,1331.44,554.08,777.36,167127.04,mortgage,13,5
17,167127.04,1331.44,551.52,779.92,166347.12,mortgage,13,5
18,166347.12,1331.44,548.95,782.49,165564.63,mortgage,13,5
19,165564.63,1331.44,546.36,785.08,164779.55,mortgage,13,5
20,164779.55,1868.27,543.77,1324.5,163455.05,mortgage,13,5
21,163455.05,3010.1,539.4,2470.7,160984.35,mortgage,13,5
22,160984.35,3010.1,531.25,2478.85,158505.5,mortgage,13,5
23,158505.5,3010.1,523.07,2487.03,156018.47,mortgage,13,5
24,156018.47,3010.1,514.86,2495.24,153523.23,mortgage,13,5
25,153523.23,3010.1,506.63,2503.47,151019.76,mortgage,13,5
26,151019.76,3010.1,498.37,2511.73,148508.03,mortgage,13,5
27,148508.03,3010.1,490.08,2520.02,145988.01,mortgage,13,5
28,145988.01,3010.1,481.76,2528.34,143459.67,mortgage,13,5
29,143459.67,3010.1,473.42,2536.68,140922.99,mortgage,13,5
30,140922.99,3010.1,465.05,2545.05,138377.94,mortgage,13,5
31,138377.94,3010.1,456.65,2553.45,135824.49,mortgage,13,5
32,135824.49,3010.1,448.22,2561.88,133262.61,mortgage,13,5
33,133262.61,3010.1,439.77,2570.33,130692.28,mortgage,13,5
34,130692.28,3010.1,431.28,2578.82,128113.46,mortgage,13,5
35,128113.46,3010.1,422.77,2587.33,125526.13,mortgage,13,5
36,125526.13,3010.1,414.24,2595.86,122930.27,mortgage,13,5
37,122930.27,3010.1,405.67,2604.43,120325.84,mortgage,13,5
38,120325.84,3010.1,397.08,2613.02,117712.82,mortgage,13,5
39,117712.82,3010.1,388.45,2621.65,115091.17,mortgage,13,5
40,115091.17,3010.1,379.8,2630.3,112460.87,mortgage,13,5
41,112460.87,3010.1,371.12,2638.98,109821.89,mortgage,13,5
42,109821.89,3010.1,362.41,2647.69,107174.2,mortgage,13,5
43,107174.2,3010.1,353.67,2656.43,104517.77,mortgage,13,5
44,104517.77,3010.1,344.91,2665.19,101852.58,mortgage,13,5
45,101852.58,3010.1,336.11,2673.99,99178.59,mortgage,13,5
46,99178.59,3010.1,327.29,2682.81,96495.78,mortgage,13,5
47,96495.78,3010.1,318.44,2691.66,93804.12,mortgage,13,5
48,93804.12,3010.1,309.55,2700.55,91103.57,mortgage,13,5
49,91103.57,3010.1,300.64,2709.46,88394.11,mortgage,13,5
50,88394.11,3010.1,291.7,2718.4,85675.71,mortgage,13,5
51,85675.71,3010.1,282.73,2727.37,82948.34,mortgage,13,5
52,82948.34,3010.1,273.73,2736.37,80211.97,mortgage,13,5
53,80211.97,3010.1,264.7,2745.4,77466.57,mortgage,13,5
54,77466.57,3010.1,255.64,2754.46,74712.11,mortgage,13,5
55,74712.11,3010.1,246.55,2763.55,71948.56,mortgage,13,5
56,71948.56,3010.1,237.43,2772.67,69175.89,mortgage,13,5
57,69175.89,3010.1,228.28,2781.82,66394.07,mortgage,13,5
58,66394.07,3010.1,219.1,2791.0,63603.07,mortgage,13,5
59,63603.07,3010.1,209.89,2800.21,60802.86,mortgage,13,5
60,60802.86,3010.1,200.65,2809.45,57993.41,mortgage,13,5
61,57993.41,3010.1,191.38,2818.72,55174.69,mortgage,13,5
62,55174.69,3010.1,182.08,2828.02,52346.67,mortgage,13,5
63,52346.67,3010.1,172.74,2837.36,49509.31,mortgage,13,5
64,49509.31,3010.1,163.38,2846.72,46662.59,mortgage,13,5
65,46662.59,3010.1,153.99,2856.11,43806.48,mortgage,13,5
66,43806.48,3010.1,144.56,2865.54,40940.94,mortgage,13,5
67,40940.94,3010.1,135.11,2874.99,38065.95,mortgage,13,5
68,38065.95,3010.1,125.62,2884.48,35181.47,mortgage,13,5
69,35181.47,3010.1,116.1,2894.0,32287.47,mortgage,13,5
70,32287.47,3010.1,106.55,2903.55,29383.92,mortgage,13,5
71,29383.92,3010.1,96.97,2913.13,26470.79,mortgage,13,5
72,26470.79,3010.1,87.35,2922.75,23548.04,mortgage,13,5
73,23548.04,3010.1,77.71,2932.39,20615.65,mortgage,13,5
74,20615.65,3010.1,68.03,2942.07,17673.58,mortgage,13,5
75,17673.58,3010.1,58.32,2951.78,14721.8,mortgage,13,5
76,14721.8,3010.1,48.58,2961.52,11760.28,mortgage,13,5
77,11760.28,3010.1,38.81,2971.29,8788.99,mortgage,13,5
78,8788.99,3010.1,29.0,2981.1,5807.89,mortgage,13,5
79,5807.89,3010.1,19.17,2990.93,2816.96,mortgage,13,5
80,2816.96,3010.1,9.3,3000.8,-183.84,mortgage,13,5
0,4000.0,1070.0,16.0,1054.0,2946.0,testing,14,1
1,2946.0,1070.0,11.78,1058.22,1887.78,testing,14,1
2,1887.78,1070.0,7.55,1062.45,825.33,testing,14,1
3,825.33,1070.0,3.3,1066.7,-241.37,testing,14,1
0,20000.0,191.04,108.0,83.04,19916.96,WellsFargo2,14,2
1,19916.96,191.04,107.55,83.49,19833.47,WellsFargo2,14,2
2,19833.47,191.04,107.1,83.94,19749.53,WellsFargo2,14,2
3,19749.53,432.41,106.65,325.76,19423.77,WellsFargo2,14,2
4,19423.77,1261.04,104.89,1156.15,18267.62,WellsFargo2,14,2
5,18267.62,1261.04,98.65,1162.39,17105.23,WellsFargo2,14,2
6,17105.23,1261.04,92.37,1168.67,15936.56,WellsFargo2,14,2
7,15936.56,1261.04,86.06,1174.98,14761.58,WellsFargo2,14,2
8,14761.58,1261.04,79.71,1181.33,13580.25,WellsFargo2,14,2
9,13580.25,1261.04,73.33,1187.71,12392.54,WellsFargo2,14,2
10,12392.54,1261.04,66.92,1194.12,11198.42,WellsFargo2,14,2
11,11198.42,1261.04,60.47,1200.57,9997.85,WellsFargo2,14,2
12,9997.85,1261.04,53.99,1207.05,8790.8,WellsFargo2,14,2
13,8790.8,1261.04,47.47,1213.57,7577.23,WellsFargo2,14,2
14,7577.23,1261.04,40.92,1220.12,6357.11,WellsFargo2,14,2
15,6357.11,1261.04,34.33,1226.71,5130.4,WellsFargo2,14,2
16,5130.4,1261.04,27.7,1233.34,3897.06,WellsFargo2,14,2
17,3897.06,1261.04,21.04,1240.0,2657.06,WellsFargo2,14,2
18,2657.06,1261.04,14.35,1246.69,1410.37,WellsFargo2,14,2
19,1410.37,1261.04,7.62,1253.42,156.95,WellsFargo2,14,2
20,156.95,1261.04,0.85,1260.19,-1103.24,WellsFargo2,14,2
0,5000.0,333.0,36.0,297.0,4703.0,Car,14,3
1,4703.0,333.0,33.86,299.14,4403.86,Car,14,3
2,4403.86,333.0,31.71,301.29,4102.57,Car,14,3
3,4102.57,333.0,29.54,303.46,3799.11,Car,14,3
4,3799.11,333.0,27.35,305.65,3493.46,Car,14,3
5,3493.46,333.0,25.15,307.85,3185.61,Car,14,3
6,3185.61,333.0,22.94,310.06,2875.55,Car,14,3
7,2875.55,333.0,20.7,312.3,2563.25,Car,14,3
8,2563.25,333.0,18.46,314.54,2248.71,Car,14,3
9,2248.71,333.0,16.19,316.81,1931.9,Car,14,3
10,1931.9,333.0,13.91,319.09,1612.81,Car,14,3
11,1612.81,333.0,11.61,321.39,1291.42,Car,14,3
12,1291.42,333.0,9.3,323.7,967.72,Car,14,3
13,967.72,333.0,6.97,326.03,641.69,Car,14,3
14,641.69,333.0,4.62,328.38,313.31,Car,14,3
15,313.31,333.0,2.26,330.74,-17.43,Car,14,3
0,180000.0,1331.44,594.0,737.44,179262.56,mortgage,14,4
1,179262.56,1331.44,591.57,739.87,178522.69,mortgage,14,4
2,178522.69,1331.44,589.12,742.32,177780.37,mortgage,14,4
3,177780.37,1331.44,586.68,744.76,177035.61,mortgage,14,4
4,177035.61,1331.44,584.22,747.22,176288.39,mortgage,14,4
5,176288.39,1331.44,581.75,749.69,175538.7,mortgage,14,4
6,175538.7,1331.44,579.28,752.16,174786.54,mortgage,14,4
7,174786.54,1331.44,576.8,754.64,174031.9,mortgage,14,4
8,174031.9,1331.44,574.31,757.13,173274.77,mortgage,14,4
9,173274.77,1331.44,571.81,759.63,172515.14,mortgage,14,4
10,172515.14,1331.44,569.3,762.14,171753.0,mortgage,14,4
11,171753.0,1331.44,566.78,764.66,170988.34,mortgage,14,4
12,170988.34,1331.44,564.26,767.18,170221.16,mortgage,14,4
13,170221.16,1331.44,561.73,769.71,169451.45,mortgage,14,4
14,169451.45,1331.44,559.19,772.25,168679.2,mortgage,14,4
15,168679.2,1348.87,556.64,792.23,167886.97,mortgage,14,4
16,167886.97,2925.48,554.03,2371.45,165515.52,mortgage,14,4
17,165515.52,2925.48,546.2,2379.28,163136.24,mortgage,14,4
18,163136.24,2925.48,538.35,2387.13,160749.11,mortgage,14,4
19,160749.11,2925.48,530.47,2395.01,158354.1,mortgage,14,4
20,158354.1,2925.48,522.57,2402.91,155951.19,mortgage,14,4
21,155951.19,2925.48,514.64,2410.84,153540.35,mortgage,14,4
22,153540.35,2925.48,506.68,2418.8,151121.55,mortgage,14,4
23,151121.55,2925.48,498.7,2426.78,148694.77,mortgage,14,4
24,148694.77,2925.48,490.69,2434.79,146259.98,mortgage,14,4
25,146259.98,2925.48,482.66,2442.82,143817.16,mortgage,14,4
26,143817.16,2925.48,474.6,2450.88,141366.28,mortgage,14,4
27,141366.28,2925.48,466.51,2458.97,138907.31,mortgage,14,4
28,138907.31,2925.48,458.39,2467.09,136440.22,mortgage,14,4
29,136440.22,2925.48,450.25,2475.23,133964.99,mortgage,14,4
30,133964.99,2925.48,442.08,2483.4,131481.59,mortgage,14,4
31,131481.59,2925.48,433.89,2491.59,128990.0,mortgage,14,4
32,128990.0,2925.48,425.67,2499.81,126490.19,mortgage,14,4
33,126490.19,2925.48,417.42,2508.06,123982.13,mortgage,14,4
34,123982.13,2925.48,409.14,2516.34,121465.79,mortgage,14,4
35,121465.79,2925.48,400.84,2524.64,118941.15,mortgage,14,4
36,118941.15,2925.48,392.51,2532.97,116408.18,mortgage,14,4
37,116408.18,2925.48,384.15,2541.33,113866.85,mortgage,14,4
38,113866.85,2925.48,375.76,2549.72,111317.13,mortgage,14,4
39,111317.13,2925.48,367.35,2558.13,108759.0,mortgage,14,4
40,108759.0,2925.48,358.9,2566.58,106192.42,mortgage,14,4
41,106192.42,2925.48,350.43,2575.05,103617.37,mortgage,14,4
42,103617.37,2925.48,341.94,2583.54,101033.83,mortgage,14,4
43,101033.83,2925.48,333.41,2592.07,98441.76,mortgage,14,4
44,98441.76,2925.48,324.86,2600.62,95841.14,mortgage,14,4
45,95841.14,2925.48,316.28,2609.2,93231.94,mortgage,14,4
46,93231.94,2925.48,307.67,2617.81,90614.13,mortgage,14,4
47,90614.13,2925.48,299.03,2626.45,87987.68,mortgage,14,4
48,87987.68,2925.48,290.36,2635.12,85352.56,mortgage,14,4
49,85352.56,2925.48,281.66,2643.82,82708.74,mortgage,14,4
50,82708.74,2925.48,272.94,2652.54,80056.2,mortgage,14,4
51,80056.2,2925.48,264.19,2661.29,77394.91,mortgage,14,4
52,77394.91,2925.48,255.4,2670.08,74724.83,mortgage,14,4
53,74724.83,2925.48,246.59,2678.89,72045.94,mortgage,14,4
54,72045.94,2925.48,237.75,2687.73,69358.21,mortgage,14,4
55,69358.21,2925.48,228.88,2696.6,66661.61,mortgage,14,4
56,66661.61,2925.48,219.98,2705.5,63956.11,mortgage,14,4
57,63956.11,2925.48,211.06,2714.42,61241.69,mortgage,14,4
58,61241.69,2925.48,202.1,2723.38,58518.31,mortgage,14,4
59,58518.31,2925.48,193.11,2732.37,55785.94,mortgage,14,4
60,55785.94,2925.48,184.09,2741.39,53044.55,mortgage,14,4
61,53044.55,2925.48,175.05,2750.43,50294.12,mortgage,14,4
62,50294.12,2925.48,165.97,2759.51,47534.61,mortgage,14,4
63,47534.61,2925.48,156.86,2768.62,44765.99,mortgage,14,4
64,44765.99,2925.48,147.73,2777.75,41988.24,mortgage,14,4
65,41988.24,2925.48,138.56,2786.92,39201.32,mortgage,14,4
66,39201.32,2925.48,129.36,2796.12,36405.2,mortgage,14,4
67,36405.2,2925.48,120.14,2805.34,33599.86,mortgage,14,4
68,33599.86,2925.48,110.88,2814.6,30785.26,mortgage,14,4
69,30785.26,2925.48,101.59,2823.89,27961.37,mortgage,14,4
70,27961.37,2925.48,92.27,2833.21,25128.16,mortgage,14,4
71,25128.16,2925.48,82.92,2842.56,22285.6,mortgage,14,4
72,22285.6,2925.48,73.54,2851.94,19433.66,mortgage,14,4
73,19433.66,2925.48,64.13,2861.35,16572.31,mortgage,14,4
74,16572.31,2925.48,54.69,2870.79,13701.52,mortgage,14,4
75,13701.52,2925.48,45.22,2880.26,10821.26,mortgage,14,4
76,10821.26,2925.48,35.71,2889.77,7931.49,mortgage,14,4
77,7931.49,2925.48,26.17,2899.31,5032.18,mortgage,14,4
78,5032.18,2925.48,16.61,2908.87,2123.31,mortgage,14,4
79,2123.31,2925.48,7.01,2918.47,-795.16,mortgage,14,4
0,8250.57,84.62,53.63,30.99,8219.58,WellsFargo1,14,5
1,8219.58,84.62,53.43,31.19,8188.39,WellsFargo1,14,5
2,8188.39,84.62,53.22,31.4,8156.99,WellsFargo1,14,5
3,8156.99,84.62,53.02,31.6,8125.39,WellsFargo1,14,5
4,8125.39,84.62,52.82,31.8,8093.59,WellsFargo1,14,5
5,8093.59,84.62,52.61,32.01,8061.58,WellsFargo1,14,5
6,8061.58,84.62,52.4,32.22,8029.36,WellsFargo1,14,5
7,8029.36,84.62,52.19,32.43,7996.93,WellsFargo1,14,5
8,7996.93,84.62,51.98,32.64,7964.29,WellsFargo1,14,5
9,7964.29,84.62,51.77,32.85,7931.44,WellsFargo1,14,5
10,7931.44,84.62,51.55,33.07,7898.37,WellsFargo1,14,5
11,7898.37,84.62,51.34,33.28,7865.09,WellsFargo1,14,5
12,7865.09,84.62,51.12,33.5,7831.59,WellsFargo1,14,5
13,7831.59,84.62,50.91,33.71,7797.88,WellsFargo1,14,5
14,7797.88,84.62,50.69,33.93,7763.95,WellsFargo1,14,5
15,7763.95,84.62,50.47,34.15,7729.8,WellsFargo1,14,5
16,7729.8,84.62,50.24,34.38,7695.42,WellsFargo1,14,5
17,7695.42,84.62,50.02,34.6,7660.82,WellsFargo1,14,5
18,7660.82,84.62,49.8,34.82,7626.0,WellsFargo1,14,5
19,7626.0,84.62,49.57,35.05,7590.95,WellsFargo1,14,5
20,7590.95,84.62,49.34,35.28,7555.67,WellsFargo1,14,5
21,7555.67,84.62,49.11,35.51,7520.16,WellsFargo1,14,5
22,7520.16,84.62,48.88,35.74,7484.42,WellsFargo1,14,5
23,7484.42,84.62,48.65,35.97,7448.45,WellsFargo1,14,5
24,7448.45,84.62,48.41,36.21,7412.24,WellsFargo1,14,5
25,7412.24,84.62,48.18,36.44,7375.8,WellsFargo1,14,5
26,7375.8,84.62,47.94,36.68,7339.12,WellsFargo1,14,5
27,7339.12,84.62,47.7,36.92,7302.2,WellsFargo1,14,5
28,7302.2,84.62,47.46,37.16,7265.04,WellsFargo1,14,5
29,7265.04,84.62,47.22,37.4,7227.64,WellsFargo1,14,5
30,7227.64,84.62,46.98,37.64,7190.0,WellsFargo1,14,5
31,7190.0,84.62,46.73,37.89,7152.11,WellsFargo1,14,5
32,7152.11,84.62,46.49,38.13,7113.98,WellsFargo1,14,5
33,7113.98,84.62,46.24,38.38,7075.6,WellsFargo1,14,5
34,7075.6,84.62,45.99,38.63,7036.97,WellsFargo1,14,5
35,7036.97,84.62,45.74,38.88,6998.09,WellsFargo1,14,5
36,6998.09,84.62,45.49,39.13,6958.96,WellsFargo1,14,5
37,6958.96,84.62,45.23,39.39,6919.57,WellsFargo1,14,5
38,6919.57,84.62,44.98,39.64,6879.93,WellsFargo1,14,5
39,6879.93,84.62,44.72,39.9,6840.03,WellsFargo1,14,5
40,6840.03,84.62,44.46,40.16,6799.87,WellsFargo1,14,5
41,6799.87,84.62,44.2,40.42,6759.45,WellsFargo1,14,5
42,6759.45,84.62,43.94,40.68,6718.77,WellsFargo1,14,5
43,6718.77,84.62,43.67,40.95,6677.82,WellsFargo1,14,5
44,6677.82,84.62,43.41,41.21,6636.61,WellsFargo1,14,5
45,6636.61,84.62,43.14,41.48,6595.13,WellsFargo1,14,5
46,6595.13,84.62,42.87,41.75,6553.38,WellsFargo1,14,5
47,6553.38,84.62,42.6,42.02,6511.36,WellsFargo1,14,5
48,6511.36,84.62,42.32,42.3,6469.06,WellsFargo1,14,5
49,6469.06,84.62,42.05,42.57,6426.49,WellsFargo1,14,5
50,6426.49,84.62,41.77,42.85,6383.64,WellsFargo1,14,5
51,6383.64,84.62,41.49,43.13,6340.51,WellsFargo1,14,5
52,6340.51,84.62,41.21,43.41,6297.1,WellsFargo1,14,5
53,6297.1,84.62,40.93,43.69,6253.41,WellsFargo1,14,5
54,6253.41,84.62,40.65,43.97,6209.44,WellsFargo1,14,5
55,6209.44,84.62,40.36,44.26,6165.18,WellsFargo1,14,5
56,6165.18,84.62,40.07,44.55,6120.63,WellsFargo1,14,5
57,6120.63,84.62,39.78,44.84,6075.79,WellsFargo1,14,5
58,6075.79,84.62,39.49,45.13,6030.66,WellsFargo1,14,5
59,6030.66,84.62,39.2,45.42,5985.24,WellsFargo1,14,5
60,5985.24,84.62,38.9,45.72,5939.52,WellsFargo1,14,5
61,5939.52,84.62,38.61,46.01,5893.51,WellsFargo1,14,5
62,5893.51,84.62,38.31,46.31,5847.2,WellsFargo1,14,5
63,5847.2,84.62,38.01,46.61,5800.59,WellsFargo1,14,5
64,5800.59,84.62,37.7,46.92,5753.67,WellsFargo1,14,5
65,5753.67,84.62,37.4,47.22,5706.45,WellsFargo1,14,5
66,5706.45,84.62,37.09,47.53,5658.92,WellsFargo1,14,5
67,5658.92,84.62,36.78,47.84,5611.08,WellsFargo1,14,5
68,5611.08,84.62,36.47,48.15,5562.93,WellsFargo1,14,5
69,5562.93,84.62,36.16,48.46,5514.47,WellsFargo1,14,5
70,5514.47,84.62,35.84,48.78,5465.69,WellsFargo1,14,5
71,5465.69,84.62,35.53,49.09,5416.6,WellsFargo1,14,5
72,5416.6,84.62,35.21,49.41,5367.19,WellsFargo1,14,5
73,5367.19,84.62,34.89,49.73,5317.46,WellsFargo1,14,5
74,5317.46,84.62,34.56,50.06,5267.4,WellsFargo1,14,5
75,5267.4,84.62,34.24,50.38,5217.02,WellsFargo1,14,5
76,5217.02,84.62,33.91,50.71,5166.31,WellsFargo1,14,5
77,5166.31,84.62,33.58,51.04,5115.27,WellsFargo1,14,5
78,5115.27,84.62,33.25,51.37,5063.9,WellsFargo1,14,5
79,5063.9,879.78,32.92,846.86,4217.04,WellsFargo1,14,5
80,4217.04,3010.1,27.41,2982.69,1234.35,WellsFargo1,14,5
81,1234.35,3010.1,8.02,3002.08,-1767.73,WellsFargo1,14,5
0,4000.0,1070.0,16.0,1054.0,2946.0,testing,15,1
1,2946.0,1070.0,11.78,1058.22,1887.78,testing,15,1
2,1887.78,1070.0,7.55,1062.45,825.33,testing,15,1
3,825.33,1070.0,3.3,1066.7,-241.37,testing,15,1
0,20000.0,191.04,108.0,83.04,19916.96,WellsFargo2,15,2
1,19916.96,191.04,107.55,83.49,19833.47,WellsFargo2,15,2
2,19833.47,191.04,107.1,83.94,19749.53,WellsFargo2,15,2
3,19749.53,432.41,106.65,325.76,19423.77,WellsFargo2,15,2
4,19423.77,1261.04,104.89,1156.15,18267.62,WellsFargo2,15,2
5,18267.62,1261.04,98.65,1162.39,17105.23,WellsFargo2,15,2
6,17105.23,1261.04,92.37,1168.67,15936.56,WellsFargo2,15,2
7,15936.56,1261.04,86.06,1174.98,14761.58,WellsFargo2,15,2
8,14761.58,1261.04,79.71,1181.33,13580.25,WellsFargo2,15,2
9,13580.25,1261.04,73.33,1187.71,12392.54,WellsFargo2,15,2
10,12392.54,1261.04,66.92,1194.12,11198.42,WellsFargo2,15,2
11,11198.42,1261.04,60.47,1200.57,9997.85,WellsFargo2,15,2
12,9997.85,1261.04,53.99,1207.05,8790.8,WellsFargo2,15,2
13,8790.8,1261.04,47.47,1213.57,7577.23,WellsFargo2,15,2
14,7577.23,1261.04,40.92,1220.12,6357.11,WellsFargo2,15,2
15,6357.11,1261.04,34.33,1226.71,5130.4,WellsFargo2,15,2
16,5130.4,1261.04,27.7,1233.34,3897.06,WellsFargo2,15,2
17,3897.06,1261.04,21.04,1240.0,2657.06,WellsFargo2,15,2
18,2657.06,1261.04,14.35,1246.69,1410.37,WellsFargo2,15,2
19,1410.37,1261.04,7.62,1253.42,156.95,WellsFargo2,15,2
20,156.95,1261.04,0.85,1260.19,-1103.24,WellsFargo2,15,2
0,8250.57,84.62,53.63,30.99,8219.58,WellsFargo1,15,3
1,8219.58,84.62,53.43,31.19,8188.39,WellsFargo1,15,3
2,8188.39,84.62,53.22,31.4,8156.99,WellsFargo1,15,3
3,8156.99,84.62,53.02,31.6,8125.39,WellsFargo1,15,3
4,8125.39,84.62,52.82,31.8,8093.59,WellsFargo1,15,3
5,8093.59,84.62,52.61,32.01,8061.58,WellsFargo1,15,3
6,8061.58,84.62,52.4,32.22,8029.36,WellsFargo1,15,3
7,8029.36,84.62,52.19,32.43,7996.93,WellsFargo1,15,3
8,7996.93,84.62,51.98,32.64,7964.29,WellsFargo1,15,3
9,7964.29,84.62,51.77,32.85,7931.44,WellsFargo1,15,3
10,7931.44,84.62,51.55,33.07,7898.37,WellsFargo1,15,3
11,7898.37,84.62,51.34,33.28,7865.09,WellsFargo1,15,3
12,7865.09,84.62,51.12,33.5,7831.59,WellsFargo1,15,3
13,7831.59,84.62,50.91,33.71,7797.88,WellsFargo1,15,3
14,7797.88,84.62,50.69,33.93,7763.95,WellsFargo1,15,3
15,7763.95,84.62,50.47,34.15,7729.8,WellsFargo1,15,3
16,7729.8,84.62,50.24,34.38,7695.42,WellsFargo1,15,3
17,7695.42,84.62,50.02,34.6,7660.82,WellsFargo1,15,3
18,7660.82,84.62,49.8,34.82,7626.0,WellsFargo1,15,3
19,7626.0,84.62,49.57,35.05,7590.95,WellsFargo1,15,3
20,7590.95,1187.86,49.34,1138.52,6452.43,WellsFargo1,15,3
21,6452.43,1345.66,41.94,1303.72,5148.71,WellsFargo1,15,3
22,5148.71,1345.66,33.47,1312.19,3836.52,WellsFargo1,15,3
23,3836.52,1345.66,24.94,1320.72,2515.8,WellsFargo1,15,3
24,2515.8,1345.66,16.35,1329.31,1186.49,WellsFargo1,15,3
25,1186.49,1345.66,7.71,1337.95,-151.46,WellsFargo1,15,3
0,5000.0,333.0,36.0,297.0,4703.0,Car,15,4
1,4703.0,333.0,33.86,299.14,4403.86,Car,15,4
2,4403.86,333.0,31.71,301.29,4102.57,Car,15,4
3,4102.57,333.0,29.54,303.46,3799.11,Car,15,4
4,3799.11,333.0,27.35,305.65,3493.46,Car,15,4
5,3493.46,333.0,25.15,307.85,3185.61,Car,15,4
6,3185.61,333.0,22.94,310.06,2875.55,Car,15,4
7,2875.55,333.0,20.7,312.3,2563.25,Car,15,4
8,2563.25,333.0,18.46,314.54,2248.71,Car,15,4
9,2248.71,333.0,16.19,316.81,1931.9,Car,15,4
10,1931.9,333.0,13.91,319.09,1612.81,Car,15,4
11,1612.81,333.0,11.61,321.39,1291.42,Car,15,4
12,1291.42,333.0,9.3,323.7,967.72,Car,15,4
13,967.72,333.0,6.97,326.03,641.69,Car,15,4
14,641.69,333.0,4.62,328.38,313.31,Car,15,4
15,313.31,333.0,2.26,330.74,-17.43,Car,15,4
0,180000.0,1331.44,594.0,737.44,179262.56,mortgage,15,5
1,179262.56,1331.44,591.57,739.87,178522.69,mortgage,15,5
2,178522.69,1331.44,589.12,742.32,177780.37,mortgage,15,5
3,177780.37,1331.44,586.68,744.76,177035.61,mortgage,15,5
4,177035.61,1331.44,584.22,747.22,176288.39,mortgage,15,5
5,176288.39,1331.44,581.75,749.69,175538.7,mortgage,15,5
6,175538.7,1331.44,579.28,752.16,174786.54,mortgage,15,5
7,174786.54,1331.44,576.8,754.64,174031.9,mortgage,15,5
8,174031.9,1331.44,574.31,757.13,173274.77,mortgage,15,5
9,173274.77,1331.44,571.81,759.63,172515.14,mortgage,15,5
10,172515.14,1331.44,569.3,762.14,171753.0,mortgage,15,5
11,171753.0,1331.44,566.78,764.66,170988.34,mortgage,15,5
12,170988.34,1331.44,564.26,767.18,170221.16,mortgage,15,5
13,170221.16,1331.44,561.73,769.71,169451.45,mortgage,15,5
14,169451.45,1331.44,559.19,772.25,168679.2,mortgage,15,5
15,168679.2,1348.87,556.64,792.23,167886.97,mortgage,15,5
16,167886.97,3010.1,554.03,2456.07,165430.9,mortgage,15,5
17,165430.9,3010.1,545.92,2464.18,162966.72,mortgage,15,5
18,162966.72,3010.1,537.79,2472.31,160494.41,mortgage,15,5
19,160494.41,3010.1,529.63,2480.47,158013.94,mortgage,15,5
20,158013.94,3010.1,521.45,2488.65,155525.29,mortgage,15,5
21,155525.29,3010.1,513.23,2496.87,153028.42,mortgage,15,5
22,153028.42,3010.1,504.99,2505.11,150523.31,mortgage,15,5
23,150523.31,3010.1,496.73,2513.37,148009.94,mortgage,15,5
24,148009.94,3010.1,488.43,2521.67,145488.27,mortgage,15,5
25,145488.27,3010.1,480.11,2529.99,142958.28,mortgage,15,5
26,142958.28,3010.1,471.76,2538.34,140419.94,mortgage,15,5
27,140419.94,3010.1,463.39,2546.71,137873.23,mortgage,15,5
28,137873.23,3010.1,454.98,2555.12,135318.11,mortgage,15,5
29,135318.11,3010.1,446.55,2563.55,132754.56,mortgage,15,5
30,132754.56,3010.1,438.09,2572.01,130182.55,mortgage,15,5
31,130182.55,3010.1,429.6,2580.5,127602.05,mortgage,15,5
32,127602.05,3010.1,421.09,2589.01,125013.04,mortgage,15,5
33,125013.04,3010.1,412.54,2597.56,122415.48,mortgage,15,5
34,122415.48,3010.1,403.97,2606.13,119809.35,mortgage,15,5
35,119809.35,3010.1,395.37,2614.73,117194.62,mortgage,15,5
36,117194.62,3010.1,386.74,2623.36,114571.26,mortgage,15,5
37,114571.26,3010.1,378.09,2632.01,111939.25,mortgage,15,5
38,111939.25,3010.1,369.4,2640.7,109298.55,mortgage,15,5
39,109298.55,3010.1,360.69,2649.41,106649.14,mortgage,15,5
40,106649.14,3010.1,351.94,2658.16,103990.98,mortgage,15,5
41,103990.98,3010.1,343.17,2666.93,101324.05,mortgage,15,5
42,101324.05,3010.1,334.37,2675.73,98648.32,mortgage,15,5
43,98648.32,3010.1,325.54,2684.56,95963.76,mortgage,15,5
44,95963.76,3010.1,316.68,2693.42,93270.34,mortgage,15,5
45,93270.34,3010.1,307.79,2702.31,90568.03,mortgage,15,5
46,90568.03,3010.1,298.87,2711.23,87856.8,mortgage,15,5
47,87856.8,3010.1,289.93,2720.17,85136.63,mortgage,15,5
48,85136.63,3010.1,280.95,2729.15,82407.48,mortgage,15,5
49,82407.48,3010.1,271.94,2738.16,79669.32,mortgage,15,5
50,79669.32,3010.1,262.91,2747.19,76922.13,mortgage,15,5
51,76922.13,3010.1,253.84,2756.26,74165.87,mortgage,15,5
52,74165.87,3010.1,244.75,2765.35,71400.52,mortgage,15,5
53,71400.52,3010.1,235.62,2774.48,68626.04,mortgage,15,5
54,68626.04,3010.1,226.47,2783.63,65842.41,mortgage,15,5
55,65842.41,3010.1,217.28,2792.82,63049.59,mortgage,15,5
56,63049.59,3010.1,208.06,2802.04,60247.55,mortgage,15,5
57,60247.55,3010.1,198.82,2811.28,57436.27,mortgage,15,5
58,57436.27,3010.1,189.54,2820.56,54615.71,mortgage,15,5
59,54615.71,3010.1,180.23,2829.87,51785.84,mortgage,15,5
60,51785.84,3010.1,170.89,2839.21,48946.63,mortgage,15,5
61,48946.63,3010.1,161.52,2848.58,46098.05,mortgage,15,5
62,46098.05,3010.1,152.12,2857.98,43240.07,mortgage,15,5
63,43240.07,3010.1,142.69,2867.41,40372.66,mortgage,15,5
64,40372.66,3010.1,133.23,2876.87,37495.79,mortgage,15,5
65,37495.79,3010.1,123.74,2886.36,34609.43,mortgage,15,5
66,34609.43,3010.1,114.21,2895.89,31713.54,mortgage,15,5
67,31713.54,3010.1,104.65,2905.45,28808.09,mortgage,15,5
68,28808.09,3010.1,95.07,2915.03,25893.06,mortgage,15,5
69,25893.06,3010.1,85.45,2924.65,22968.41,mortgage,15,5
70,22968.41,3010.1,75.8,2934.3,20034.11,mortgage,15,5
71,20034.11,3010.1,66.11,2943.99,17090.12,mortgage,15,5
72,17090.12,3010.1,56.4,2953.7,14136.42,mortgage,15,5
73,14136.42,3010.1,46.65,2963.45,11172.97,mortgage,15,5
74,11172.97,3010.1,36.87,2973.23,8199.74,mortgage,15,5
75,8199.74,3010.1,27.06,2983.04,5216.7,mortgage,15,5
76,5216.7,3010.1,17.22,2992.88,2223.82,mortgage,15,5
77,2223.82,3010.1,7.34,3002.76,-778.94,mortgage,15,5
0,4000.0,1070.0,16.0,1054.0,2946.0,testing,16,1
1,2946.0,1070.0,11.78,1058.22,1887.78,testing,16,1
2,1887.78,1070.0,7.55,1062.45,825.33,testing,16,1
3,825.33,1070.0,3.3,1066.7,-241.37,testing,16,1
0,20000.0,191.04,108.0,83.04,19916.96,WellsFargo2,16,2
1,19916.96,191.04,107.55,83.49,19833.47,WellsFargo2,16,2
2,19833.47,191.04,107.1,83.94,19749.53,WellsFargo2,16,2
3,19749.53,432.41,106.65,325.76,19423.77,WellsFargo2,16,2
4,19423.77,1261.04,104.89,1156.15,18267.62,WellsFargo2,16,2
5,18267.62,1261.04,98.65,1162.39,17105.23,WellsFargo2,16,2
6,17105.23,1261.04,92.37,1168.67,15936.56,WellsFargo2,16,2
7,15936.56,1261.04,86.06,1174.98,14761.58,WellsFargo2,16,2
8,14761.58,1261.04,79.71,1181.33,13580.25,WellsFargo2,16,2
9,13580.25,1261.04,73.33,1187.71,12392.54,WellsFargo2,16,2
10,12392.54,1261.04,66.92,1194.12,11198.42,WellsFargo2,16,2
11,11198.42,1261.04,60.47,1200.57,9997.85,WellsFargo2,16,2
12,9997.85,1261.04,53.99,1207.05,8790.8,WellsFargo2,16,2
13,8790.8,1261.04,47.47,1213.57,7577.23,WellsFargo2,16,2
14,7577.23,1261.04,40.92,1220.12,6357.11,WellsFargo2,16,2
15,6357.11,1261.04,34.33,1226.71,5130.4,WellsFargo2,16,2
16,5130.4,1261.04,27.7,1233.34,3897.06,WellsFargo2,16,2
17,3897.06,1261.04,21.04,1240.0,2657.06,WellsFargo2,16,2
18,2657.06,1261.04,14.35,1246.69,1410.37,WellsFargo2,16,2
19,1410.37,1261.04,7.62,1253.42,156.95,WellsFargo2,16,2
20,156.95,1261.04,0.85,1260.19,-1103.24,WellsFargo2,16,2
0,8250.57,84.62,53.63,30.99,8219.58,WellsFargo1,16,3
1,8219.58,84.62,53.43,31.19,8188.39,WellsFargo1,16,3
2,8188.39,84.62,53.22,31.4,8156.99,WellsFargo1,16,3
3,8156.99,84.62,53.02,31.6,8125.39,WellsFargo1,16,3
4,8125.39,84.62,52.82,31.8,8093.59,WellsFargo1,16,3
5,8093.59,84.62,52.61,32.01,8061.58,WellsFargo1,16,3
6,8061.58,84.62,52.4,32.22,8029.36,WellsFargo1,16,3
7,8029.36,84.62,52.19,32.43,7996.93,WellsFargo1,16,3
8,7996.93,84.62,51.98,32.64,7964.29,WellsFargo1,16,3
9,7964.29,84.62,51.77,32.85,7931.44,WellsFargo1,16,3
10,7931.44,84.62,51.55,33.07,7898.37,WellsFargo1,16,3
11,7898.37,84.62,51.34,33.28,7865.09,WellsFargo1,16,3
12,7865.09,84.62,51.12,33.5,7831.59,WellsFargo1,16,3
13,7831.59,84.62,50.91,33.71,7797.88,WellsFargo1,16,3
14,7797.88,84.62,50.69,33.93,7763.95,WellsFargo1,16,3
15,7763.95,84.62,50.47,34.15,7729.8,WellsFargo1,16,3
16,7729.8,84.62,50.24,34.38,7695.42,WellsFargo1,16,3
17,7695.42,84.62,50.02,34.6,7660.82,WellsFargo1,16,3
18,7660.82,84.62,49.8,34.82,7626.0,WellsFargo1,16,3
19,7626.0,84.62,49.57,35.05,7590.95,WellsFargo1,16,3
20,7590.95,1187.86,49.34,1138.52,6452.43,WellsFargo1,16,3
21,6452.43,1345.66,41.94,1303.72,5148.71,WellsFargo1,16,3
22,5148.71,1345.66,33.47,1312.19,3836.52,WellsFargo1,16,3
23,3836.52,1345.66,24.94,1320.72,2515.8,WellsFargo1,16,3
24,2515.8,1345.66,16.35,1329.31,1186.49,WellsFargo1,16,3
25,1186.49,1345.66,7.71,1337.95,-151.46,WellsFargo1,16,3
0,180000.0,1331.44,594.0,737.44,179262.56,mortgage,16,4
1,179262.56,1331.44,591.57,739.87,178522.69,mortgage,16,4
2,178522.69,1331.44,589.12,742.32,177780.37,mortgage,16,4
3,177780.37,1331.44,586.68,744.76,177035.61,mortgage,16,4
4,177035.61,1331.44,584.22,747.22,176288.39,mortgage,16,4
5,176288.39,1331.44,581.75,749.69,175538.7,mortgage,16,4
6,175538.7,1331.44,579.28,752.16,174786.54,mortgage,16,4
7,174786.54,1331.44,576.8,754.64,174031.9,mortgage,16,4
8,174031.9,1331.44,574.31,757.13,173274.77,mortgage,16,4
9,173274.77,1331.44,571.81,759.63,172515.14,mortgage,16,4
10,172515.14,1331.44,569.3,762.14,171753.0,mortgage,16,4
11,171753.0,1331.44,566.78,764.66,170988.34,mortgage,16,4
12,170988.34,1331.44,564.26,767.18,170221.16,mortgage,16,4
13,170221.16,1331.44,561.73,769.71,169451.45,mortgage,16,4
14,169451.45,1331.44,559.19,772.25,168679.2,mortgage,16,4
15,168679.2,1331.44,556.64,774.8,167904.4,mortgage,16,4
16,167904.4,1331.44,554.08,777.36,167127.04,mortgage,16,4
17,167127.04,1331.44,551.52,779.92,166347.12,mortgage,16,4
18,166347.12,1331.44,548.95,782.49,165564.63,mortgage,16,4
19,165564.63,1331.44,546.36,785.08,164779.55,mortgage,16,4
20,164779.55,1331.44,543.77,787.67,163991.88,mortgage,16,4
21,163991.88,1331.44,541.17,790.27,163201.61,mortgage,16,4
22,163201.61,1331.44,538.57,792.87,162408.74,mortgage,16,4
23,162408.74,1331.44,535.95,795.49,161613.25,mortgage,16,4
24,161613.25,1331.44,533.32,798.12,160815.13,mortgage,16,4
25,160815.13,1482.9,530.69,952.21,159862.92,mortgage,16,4
26,159862.92,2677.1,527.55,2149.55,157713.37,mortgage,16,4
27,157713.37,2677.1,520.45,2156.65,155556.72,mortgage,16,4
28,155556.72,2677.1,513.34,2163.76,153392.96,mortgage,16,4
29,153392.96,2677.1,506.2,2170.9,151222.06,mortgage,16,4
30,151222.06,2677.1,499.03,2178.07,149043.99,mortgage,16,4
31,149043.99,2677.1,491.85,2185.25,146858.74,mortgage,16,4
32,146858.74,2677.1,484.63,2192.47,144666.27,mortgage,16,4
33,144666.27,2677.1,477.4,2199.7,142466.57,mortgage,16,4
34,142466.57,2677.1,470.14,2206.96,140259.61,mortgage,16,4
35,140259.61,2677.1,462.86,2214.24,138045.37,mortgage,16,4
36,138045.37,2677.1,455.55,2221.55,135823.82,mortgage,16,4
37,135823.82,2677.1,448.22,2228.88,133594.94,mortgage,16,4
38,133594.94,2677.1,440.86,2236.24,131358.7,mortgage,16,4
39,131358.7,2677.1,433.48,2243.62,129115.08,mortgage,16,4
40,129115.08,2677.1,426.08,2251.02,126864.06,mortgage,16,4
41,126864.06,2677.1,418.65,2258.45,124605.61,mortgage,16,4
42,124605.61,2677.1,411.2,2265.9,122339.71,mortgage,16,4
43,122339.71,2677.1,403.72,2273.38,120066.33,mortgage,16,4
44,120066.33,2677.1,396.22,2280.88,117785.45,mortgage,16,4
45,117785.45,2677.1,388.69,2288.41,115497.04,mortgage,16,4
46,115497.04,2677.1,381.14,2295.96,113201.08,mortgage,16,4
47,113201.08,2677.1,373.56,2303.54,110897.54,mortgage,16,4
48,110897.54,2677.1,365.96,2311.14,108586.4,mortgage,16,4
49,108586.4,2677.1,358.34,2318.76,106267.64,mortgage,16,4
50,106267.64,2677.1,350.68,2326.42,103941.22,mortgage,16,4
51,103941.22,2677.1,343.01,2334.09,101607.13,mortgage,16,4
52,101607.13,2677.1,335.3,2341.8,99265.33,mortgage,16,4
53,99265.33,2677.1,327.58,2349.52,96915.81,mortgage,16,4
54,96915.81,2677.1,319.82,2357.28,94558.53,mortgage,16,4
55,94558.53,2677.1,312.04,2365.06,92193.47,mortgage,16,4
56,92193.47,2677.1,304.24,2372.86,89820.61,mortgage,16,4
57,89820.61,2677.1,296.41,2380.69,87439.92,mortgage,16,4
58,87439.92,2677.1,288.55,2388.55,85051.37,mortgage,16,4
59,85051.37,2677.1,280.67,2396.43,82654.94,mortgage,16,4
60,82654.94,2677.1,272.76,2404.34,80250.6,mortgage,16,4
61,80250.6,2677.1,264.83,2412.27,77838.33,mortgage,16,4
62,77838.33,2677.1,256.87,2420.23,75418.1,mortgage,16,4
63,75418.1,2677.1,248.88,2428.22,72989.88,mortgage,16,4
64,72989.88,2677.1,240.87,2436.23,70553.65,mortgage,16,4
65,70553.65,2677.1,232.83,2444.27,68109.38,mortgage,16,4
66,68109.38,2677.1,224.76,2452.34,65657.04,mortgage,16,4
67,65657.04,2677.1,216.67,2460.43,63196.61,mortgage,16,4
68,63196.61,2677.1,208.55,2468.55,60728.06,mortgage,16,4
69,60728.06,2677.1,200.4,2476.7,58251.36,mortgage,16,4
70,58251.36,2677.1,192.23,2484.87,55766.49,mortgage,16,4
71,55766.49,2677.1,184.03,2493.07,53273.42,mortgage,16,4
72,53273.42,2677.1,175.8,2501.3,50772.12,mortgage,16,4
73,50772.12,2677.1,167.55,2509.55,48262.57,mortgage,16,4
74,48262.57,2677.1,159.27,2517.83,45744.74,mortgage,16,4
75,45744.74,2677.1,150.96,2526.14,43218.6,mortgage,16,4
76,43218.6,2677.1,142.62,2534.48,40684.12,mortgage,16,4
77,40684.12,2677.1,134.26,2542.84,38141.28,mortgage,16,4
78,38141.28,2677.1,125.87,2551.23,35590.05,mortgage,16,4
79,35590.05,2677.1,117.45,2559.65,33030.4,mortgage,16,4
80,33030.4,2677.1,109.0,2568.1,30462.3,mortgage,16,4
81,30462.3,2677.1,100.53,2576.57,27885.73,mortgage,16,4
82,27885.73,2677.1,92.02,2585.08,25300.65,mortgage,16,4
83,25300.65,2677.1,83.49,2593.61,22707.04,mortgage,16,4
84,22707.04,2677.1,74.93,2602.17,20104.87,mortgage,16,4
85,20104.87,2677.1,66.35,2610.75,17494.12,mortgage,16,4
86,17494.12,2677.1,57.73,2619.37,14874.75,mortgage,16,4
87,14874.75,2677.1,49.09,2628.01,12246.74,mortgage,16,4
88,12246.74,2677.1,40.41,2636.69,9610.05,mortgage,16,4
89,9610.05,2677.1,31.71,2645.39,6964.66,mortgage,16,4
90,6964.66,2677.1,22.98,2654.12,4310.54,mortgage,16,4
91,4310.54,2677.1,14.22,2662.88,1647.66,mortgage,16,4
92,1647.66,2677.1,5.44,2671.66,-1024.0,mortgage,16,4
0,5000.0,333.0,36.0,297.0,4703.0,Car,16,5
1,4703.0,333.0,33.86,299.14,4403.86,Car,16,5
2,4403.86,333.0,31.71,301.29,4102.57,Car,16,5
3,4102.57,333.0,29.54,303.46,3799.11,Car,16,5
4,3799.11,333.0,27.35,305.65,3493.46,Car,16,5
5,3493.46,333.0,25.15,307.85,3185.61,Car,16,5
6,3185.61,333.0,22.94,310.06,2875.55,Car,16,5
7,2875.55,333.0,20.7,312.3,2563.25,Car,16,5
8,2563.25,333.0,18.46,314.54,2248.71,Car,16,5
9,2248.71,333.0,16.19,316.81,1931.9,Car,16,5
10,1931.9,333.0,13.91,319.09,1612.81,Car,16,5
11,1612.81,333.0,11.61,321.39,1291.42,Car,16,5
12,1291.42,333.0,9.3,323.7,967.72,Car,16,5
13,967.72,333.0,6.97,326.03,641.69,Car,16,5
14,641.69,333.0,4.62,328.38,313.31,Car,16,5
15,313.31,333.0,2.26,330.74,-17.43,Car,16,5
0,4000.0,1070.0,16.0,1054.0,2946.0,testing,17,1
1,2946.0,1070.0,11.78,1058.22,1887.78,testing,17,1
2,1887.78,1070.0,7.55,1062.45,825.33,testing,17,1
3,825.33,1070.0,3.3,1066.7,-241.37,testing,17,1
0,20000.0,191.04,108.0,83.04,19916.96,WellsFargo2,17,2
1,19916.96,191.04,107.55,83.49,19833.47,WellsFargo2,17,2
2,19833.47,191.04,107.1,83.94,19749.53,WellsFargo2,17,2
3,19749.53,432.41,106.65,325.76,19423.77,WellsFargo2,17,2
4,19423.77,1261.04,104.89,1156.15,18267.62,WellsFargo2,17,2
5,18267.62,1261.04,98.65,1162.39,17105.23,WellsFargo2,17,2
6,17105.23,1261.04,92.37,1168.67,15936.56,WellsFargo2,17,2
7,15936.56,1261.04,86.06,1174.98,14761.58,WellsFargo2,17,2
8,14761.58,1261.04,79.71,1181.33,13580.25,WellsFargo2,17,2
9,13580.25,1261.04,73.33,1187.71,12392.54,WellsFargo2,17,2
10,12392.54,1261.04,66.92,1194.12,11198.42,WellsFargo2,17,2
11,11198.42,1261.04,60.47,1200.57,9997.85,WellsFargo2,17,2
12,9997.85,1261.04,53.99,1207.05,8790.8,WellsFargo2,17,2
13,8790.8,1261.04,47.47,1213.57,7577.23,WellsFargo2,17,2
14,7577.23,1261.04,40.92,1220.12,6357.11,WellsFargo2,17,2
15,6357.11,1261.04,34.33,1226.71,5130.4,WellsFargo2,17,2
16,5130.4,1261.04,27.7,1233.34,3897.06,WellsFargo2,17,2
17,3897.06,1261.04,21.04,1240.0,2657.06,WellsFargo2,17,2
18,2657.06,1261.04,14.35,1246.69,1410.37,WellsFargo2,17,2
19,1410.37,1261.04,7.62,1253.42,156.95,WellsFargo2,17,2
20,156.95,1261.04,0.85,1260.19,-1103.24,WellsFargo2,17,2
0,180000.0,1331.44,594.0,737.44,179262.56,mortgage,17,3
1,179262.56,1331.44,591.57,739.87,178522.69,mortgage,17,3
2,178522.69,1331.44,589.12,742.32,177780.37,mortgage,17,3
3,177780.37,1331.44,586.68,744.76,177035.61,mortgage,17,3
4,177035.61,1331.44,584.22,747.22,176288.39,mortgage,17,3
5,176288.39,1331.44,581.75,749.69,175538.7,mortgage,17,3
6,175538.7,1331.44,579.28,752.16,174786.54,mortgage,17,3
7,174786.54,1331.44,576.8,754.64,174031.9,mortgage,17,3
8,174031.9,1331.44,574.31,757.13,173274.77,mortgage,17,3
9,173274.77,1331.44,571.81,759.63,172515.14,mortgage,17,3
10,172515.14,1331.44,569.3,762.14,171753.0,mortgage,17,3
11,171753.0,1331.44,566.78,764.66,170988.34,mortgage,17,3
12,170988.34,1331.44,564.26,767.18,170221.16,mortgage,17,3
13,170221.16,1331.44,561.73,769.71,169451.45,mortgage,17,3
14,169451.45,1331.44,559.19,772.25,168679.2,mortgage,17,3
15,168679.2,1331.44,556.64,774.8,167904.4,mortgage,17,3
16,167904.4,1331.44,554.08,777.36,167127.04,mortgage,17,3
17,167127.04,1331.44,551.52,779.92,166347.12,mortgage,17,3
18,166347.12,1331.44,548.95,782.49,165564.63,mortgage,17,3
19,165564.63,1331.44,546.36,785.08,164779.55,mortgage,17,3
20,164779.55,2434.68,543.77,1890.91,162888.64,mortgage,17,3
21,162888.64,2592.48,537.53,2054.95,160833.69,mortgage,17,3
22,160833.69,2592.48,530.75,2061.73,158771.96,mortgage,17,3
23,158771.96,2592.48,523.95,2068.53,156703.43,mortgage,17,3
24,156703.43,2592.48,517.12,2075.36,154628.07,mortgage,17,3
25,154628.07,2592.48,510.27,2082.21,152545.86,mortgage,17,3
26,152545.86,2592.48,503.4,2089.08,150456.78,mortgage,17,3
27,150456.78,2592.48,496.51,2095.97,148360.81,mortgage,17,3
28,148360.81,2592.48,489.59,2102.89,146257.92,mortgage,17,3
29,146257.92,2592.48,482.65,2109.83,144148.09,mortgage,17,3
30,144148.09,2592.48,475.69,2116.79,142031.3,mortgage,17,3
31,142031.3,2592.48,468.7,2123.78,139907.52,mortgage,17,3
32,139907.52,2592.48,461.69,2130.79,137776.73,mortgage,17,3
33,137776.73,2592.48,454.66,2137.82,135638.91,mortgage,17,3
34,135638.91,2592.48,447.61,2144.87,133494.04,mortgage,17,3
35,133494.04,2592.48,440.53,2151.95,131342.09,mortgage,17,3
36,131342.09,2592.48,433.43,2159.05,129183.04,mortgage,17,3
37,129183.04,2592.48,426.3,2166.18,127016.86,mortgage,17,3
38,127016.86,2592.48,419.16,2173.32,124843.54,mortgage,17,3
39,124843.54,2592.48,411.98,2180.5,122663.04,mortgage,17,3
40,122663.04,2592.48,404.79,2187.69,120475.35,mortgage,17,3
41,120475.35,2592.48,397.57,2194.91,118280.44,mortgage,17,3
42,118280.44,2592.48,390.33,2202.15,116078.29,mortgage,17,3
43,116078.29,2592.48,383.06,2209.42,113868.87,mortgage,17,3
44,113868.87,2592.48,375.77,2216.71,111652.16,mortgage,17,3
45,111652.16,2592.48,368.45,2224.03,109428.13,mortgage,17,3
46,109428.13,2592.48,361.11,2231.37,107196.76,mortgage,17,3
47,107196.76,2592.48,353.75,2238.73,104958.03,mortgage,17,3
48,104958.03,2592.48,346.36,2246.12,102711.91,mortgage,17,3
49,102711.91,2592.48,338.95,2253.53,100458.38,mortgage,17,3
50,100458.38,2592.48,331.51,2260.97,98197.41,mortgage,17,3
51,98197.41,2592.48,324.05,2268.43,95928.98,mortgage,17,3
52,95928.98,2592.48,316.57,2275.91,93653.07,mortgage,17,3
53,93653.07,2592.48,309.06,2283.42,91369.65,mortgage,17,3
54,91369.65,2592.48,301.52,2290.96,89078.69,mortgage,17,3
55,89078.69,2592.48,293.96,2298.52,86780.17,mortgage,17,3
56,86780.17,2592.48,286.37,2306.11,84474.06,mortgage,17,3
57,84474.06,2592.48,278.76,2313.72,82160.34,mortgage,17,3
58,82160.34,2592.48,271.13,2321.35,79838.99,mortgage,17,3
59,79838.99,2592.48,263.47,2329.01,77509.98,mortgage,17,3
60,77509.98,2592.48,255.78,2336.7,75173.28,mortgage,17,3
61,75173.28,2592.48,248.07,2344.41,72828.87,mortgage,17,3
62,72828.87,2592.48,240.34,2352.14,70476.73,mortgage,17,3
63,70476.73,2592.48,232.57,2359.91,68116.82,mortgage,17,3
64,68116.82,2592.48,224.79,2367.69,65749.13,mortgage,17,3
65,65749.13,2592.48,216.97,2375.51,63373.62,mortgage,17,3
66,63373.62,2592.48,209.13,2383.35,60990.27,mortgage,17,3
67,60990.27,2592.48,201.27,2391.21,58599.06,mortgage,17,3
68,58599.06,2592.48,193.38,2399.1,56199.96,mortgage,17,3
69,56199.96,2592.48,185.46,2407.02,53792.94,mortgage,17,3
70,53792.94,2592.48,177.52,2414.96,51377.98,mortgage,17,3
71,51377.98,2592.48,169.55,2422.93,48955.05,mortgage,17,3
72,48955.05,2592.48,161.55,2430.93,46524.12,mortgage,17,3
73,46524.12,2592.48,153.53,2438.95,44085.17,mortgage,17,3
74,44085.17,2592.48,145.48,2447.0,41638.17,mortgage,17,3
75,41638.17,2592.48,137.41,2455.07,39183.1,mortgage,17,3
76,39183.1,2592.48,129.3,2463.18,36719.92,mortgage,17,3
77,36719.92,2592.48,121.18,2471.3,34248.62,mortgage,17,3
78,34248.62,2592.48,113.02,2479.46,31769.16,mortgage,17,3
79,31769.16,2592.48,104.84,2487.64,29281.52,mortgage,17,3
80,29281.52,2592.48,96.63,2495.85,26785.67,mortgage,17,3
81,26785.67,2592.48,88.39,2504.09,24281.58,mortgage,17,3
82,24281.58,2592.48,80.13,2512.35,21769.23,mortgage,17,3
83,21769.23,2592.48,71.84,2520.64,19248.59,mortgage,17,3
84,19248.59,2592.48,63.52,2528.96,16719.63,mortgage,17,3
85,16719.63,2592.48,55.17,2537.31,14182.32,mortgage,17,3
86,14182.32,2592.48,46.8,2545.68,11636.64,mortgage,17,3
87,11636.64,2592.48,38.4,2554.08,9082.56,mortgage,17,3
88,9082.56,2592.48,29.97,2562.51,6520.05,mortgage,17,3
89,6520.05,2592.48,21.52,2570.96,3949.09,mortgage,17,3
90,3949.09,2592.48,13.03,2579.45,1369.64,mortgage,17,3
91,1369.64,2592.48,4.52,2587.96,-1218.32,mortgage,17,3
0,5000.0,333.0,36.0,297.0,4703.0,Car,17,4
1,4703.0,333.0,33.86,299.14,4403.86,Car,17,4
2,4403.86,333.0,31.71,301.29,4102.57,Car,17,4
3,4102.57,333.0,29.54,303.46,3799.11,Car,17,4
4,3799.11,333.0,27.35,305.65,3493.46,Car,17,4
5,3493.46,333.0,25.15,307.85,3185.61,Car,17,4
6,3185.61,333.0,22.94,310.06,2875.55,Car,17,4
7,2875.55,333.0,20.7,312.3,2563.25,Car,17,4
8,2563.25,333.0,18.46,314.54,2248.71,Car,17,4
9,2248.71,333.0,16.19,316.81,1931.9,Car,17,4
10,1931.9,333.0,13.91,319.09,1612.81,Car,17,4
11,1612.81,333.0,11.61,321.39,1291.42,Car,17,4
12,1291.42,333.0,9.3,323.7,967.72,Car,17,4
13,967.72,333.0,6.97,326.03,641.69,Car,17,4
14,641.69,333.0,4.62,328.38,313.31,Car,17,4
15,313.31,333.0,2.26,330.74,-17.43,Car,17,4
0,8250.57,84.62,53.63,30.99,8219.58,WellsFargo1,17,5
1,8219.58,84.62,53.43,31.19,8188.39,WellsFargo1,17,5
2,8188.39,84.62,53.22,31.4,8156.99,WellsFargo1,17,5
3,8156.99,84.62,53.02,31.6,8125.39,WellsFargo1,17,5
4,8125.39,84.62,52.82,31.8,8093.59,WellsFargo1,17,5
5,8093.59,84.62,52.61,32.01,8061.58,WellsFargo1,17,5
6,8061.58,84.62,52.4,32.22,8029.36,WellsFargo1,17,5
7,8029.36,84.62,52.19,32.43,7996.93,WellsFargo1,17,5
8,7996.93,84.62,51.98,32.64,7964.29,WellsFargo1,17,5
9,7964.29,84.62,51.77,32.85,7931.44,WellsFargo1,17,5
10,7931.44,84.62,51.55,33.07,7898.37,WellsFargo1,17,5
11,7898.37,84.62,51.34,33.28,7865.09,WellsFargo1,17,5
12,7865.09,84.62,51.12,33.5,7831.59,WellsFargo1,17,5
13,7831.59,84.62,50.91,33.71,7797.88,WellsFargo1,17,5
14,7797.88,84.62,50.69,33.93,7763.95,WellsFargo1,17,5
15,7763.95,102.05,50.47,51.58,7712.37,WellsFargo1,17,5
16,7712.37,3010.1,50.13,2959.97,4752.4,WellsFargo1,17,5
17,4752.4,3010.1,30.89,2979.21,1773.19,WellsFargo1,17,5
18,1773.19,3010.1,11.53,2998.57,-1225.38,WellsFargo1,17,5
0,4000.0,1070.0,16.0,1054.0,2946.0,testing,18,1
1,2946.0,1070.0,11.78,1058.22,1887.78,testing,18,1
2,1887.78,1070.0,7.55,1062.45,825.33,testing,18,1
3,825.33,1070.0,3.3,1066.7,-241.37,testing,18,1
0,20000.0,191.04,108.0,83.04,19916.96,WellsFargo2,18,2
1,19916.96,191.04,107.55,83.49,19833.47,WellsFargo2,18,2
2,19833.47,191.04,107.1,83.94,19749.53,WellsFargo2,18,2
3,19749.53,432.41,106.65,325.76,19423.77,WellsFargo2,18,2
4,19423.77,1261.04,104.89,1156.15,18267.62,WellsFargo2,18,2
5,18267.62,1261.04,98.65,1162.39,17105.23,WellsFargo2,18,2
6,17105.23,1261.04,92.37,1168.67,15936.56,WellsFargo2,18,2
7,15936.56,1261.04,86.06,1174.98,14761.58,WellsFargo2,18,2
8,14761.58,1261.04,79.71,1181.33,13580.25,WellsFargo2,18,2
9,13580.25,1261.04,73.33,1187.71,12392.54,WellsFargo2,18,2
10,12392.54,1261.04,66.92,1194.12,11198.42,WellsFargo2,18,2
11,11198.42,1261.04,60.47,1200.57,9997.85,WellsFargo2,18,2
12,9997.85,1261.04,53.99,1207.05,8790.8,WellsFargo2,18,2
13,8790.8,1261.04,47.47,1213.57,7577.23,WellsFargo2,18,2
14,7577.23,1261.04,40.92,1220.12,6357.11,WellsFargo2,18,2
15,6357.11,1261.04,34.33,1226.71,5130.4,WellsFargo2,18,2
16,5130.4,1261.04,27.7,1233.34,3897.06,WellsFargo2,18,2
17,3897.06,1261.04,21.04,1240.0,2657.06,WellsFargo2,18,2
18,2657.06,1261.04,14.35,1246.69,1410.37,WellsFargo2,18,2
19,1410.37,1261.04,7.62,1253.42,156.95,WellsFargo2,18,2
20,156.95,1261.04,0.85,1260.19,-1103.24,WellsFargo2,18,2
0,180000.0,1331.44,594.0,737.44,179262.56,mortgage,18,3
1,179262.56,1331.44,591.57,739.87,178522.69,mortgage,18,3
2,178522.69,1331.44,589.12,742.32,177780.37,mortgage,18,3
3,177780.37,1331.44,586.68,744.76,177035.61,mortgage,18,3
4,177035.61,1331.44,584.22,747.22,176288.39,mortgage,18,3
5,176288.39,1331.44,581.75,749.69,175538.7,mortgage,18,3
6,175538.7,1331.44,579.28,752.16,174786.54,mortgage,18,3
7,174786.54,1331.44,576.8,754.64,174031.9,mortgage,18,3
8,174031.9,1331.44,574.31,757.13,173274.77,mortgage,18,3
9,173274.77,1331.44,571.81,759.63,172515.14,mortgage,18,3
10,172515.14,1331.44,569.3,762.14,171753.0,mortgage,18,3
11,171753.0,1331.44,566.78,764.66,170988.34,mortgage,18,3
12,170988.34,1331.44,564.26,767.18,170221.16,mortgage,18,3
13,170221.16,1331.44,561.73,769.71,169451.45,mortgage,18,3
14,169451.45,1331.44,559.19,772.25,168679.2,mortgage,18,3
15,168679.2,1331.44,556.64,774.8,167904.4,mortgage,18,3
16,167904.4,1331.44,554.08,777.36,167127.04,mortgage,18,3
17,167127.04,1331.44,551.52,779.92,166347.12,mortgage,18,3
18,166347.12,1331.44,548.95,782.49,165564.63,mortgage,18,3
19,165564.63,1331.44,546.36,785.08,164779.55,mortgage,18,3
20,164779.55,2434.68,543.77,1890.91,162888.64,mortgage,18,3
21,162888.64,2592.48,537.53,2054.95,160833.69,mortgage,18,3
22,160833.69,2592.48,530.75,2061.73,158771.96,mortgage,18,3
23,158771.96,2592.48,523.95,2068.53,156703.43,mortgage,18,3
24,156703.43,2592.48,517.12,2075.36,154628.07,mortgage,18,3
25,154628.07,2592.48,510.27,2082.21,152545.86,mortgage,18,3
26,152545.86,2592.48,503.4,2089.08,150456.78,mortgage,18,3
27,150456.78,2592.48,496.51,2095.97,148360.81,mortgage,18,3
28,148360.81,2592.48,489.59,2102.89,146257.92,mortgage,18,3
29,146257.92,2592.48,482.65,2109.83,144148.09,mortgage,18,3
30,144148.09,2592.48,475.69,2116.79,142031.3,mortgage,18,3
31,142031.3,2592.48,468.7,2123.78,139907.52,mortgage,18,3
32,139907.52,2592.48,461.69,2130.79,137776.73,mortgage,18,3
33,137776.73,2592.48,454.66,2137.82,135638.91,mortgage,18,3
34,135638.91,2592.48,447.61,2144.87,133494.04,mortgage,18,3
35,133494.04,2592.48,440.53,2151.95,131342.09,mortgage,18,3
36,131342.09,2592.48,433.43,2159.05,129183.04,mortgage,18,3
37,129183.04,2592.48,426.3,2166.18,127016.86,mortgage,18,3
38,127016.86,2592.48,419.16,2173.32,124843.54,mortgage,18,3
39,124843.54,2592.48,411.98,2180.5,122663.04,mortgage,18,3
40,122663.04,2592.48,404.79,2187.69,120475.35,mortgage,18,3
41,120475.35,2592.48,397.57,2194.91,118280.44,mortgage,18,3
42,118280.44,2592.48,390.33,2202.15,116078.29,mortgage,18,3
43,116078.29,2592.48,383.06,2209.42,113868.87,mortgage,18,3
44,113868.87,2592.48,375.77,2216.71,111652.16,mortgage,18,3
45,111652.16,2592.48,368.45,2224.03,109428.13,mortgage,18,3
46,109428.13,2592.48,361.11,2231.37,107196.76,mortgage,18,3
47,107196.76,2592.48,353.75,2238.73,104958.03,mortgage,18,3
48,104958.03,2592.48,346.36,2246.12,102711.91,mortgage,18,3
49,102711.91,2592.48,338.95,2253.53,100458.38,mortgage,18,3
50,100458.38,2592.48,331.51,2260.97,98197.41,mortgage,18,3
51,98197.41,2592.48,324.05,2268.43,95928.98,mortgage,18,3
52,95928.98,2592.48,316.57,2275.91,93653.07,mortgage,18,3
53,93653.07,2592.48,309.06,2283.42,91369.65,mortgage,18,3
54,91369.65,2592.48,301.52,2290.96,89078.69,mortgage,18,3
55,89078.69,2592.48,293.96,2298.52,86780.17,mortgage,18,3
56,86780.17,2592.48,286.37,2306.11,84474.06,mortgage,18,3
57,84474.06,2592.48,278.76,2313.72,82160.34,mortgage,18,3
58,82160.34,2592.48,271.13,2321.35,79838.99,mortgage,18,3
59,79838.99,2592.48,263.47,2329.01,77509.98,mortgage,18,3
60,77509.98,2592.48,255.78,2336.7,75173.28,mortgage,18,3
61,75173.28,2592.48,248.07,2344.41,72828.87,mortgage,18,3
62,72828.87,2592.48,240.34,2352.14,70476.73,mortgage,18,3
63,70476.73,2592.48,232.57,2359.91,68116.82,mortgage,18,3
64,68116.82,2592.48,224.79,2367.69,65749.13,mortgage,18,3
65,65749.13,2592.48,216.97,2375.51,63373.62,mortgage,18,3
66,63373.62,2592.48,209.13,2383.35,60990.27,mortgage,18,3
67,60990.27,2592.48,201.27,2391.21,58599.06,mortgage,18,3
68,58599.06,2592.48,193.38,2399.1,56199.96,mortgage,18,3
69,56199.96,2592.48,185.46,2407.02,53792.94,mortgage,18,3
70,53792.94,2592.48,177.52,2414.96,51377.98,mortgage,18,3
71,51377.98,2592.48,169.55,2422.93,48955.05,mortgage,18,3
72,48955.05,2592.48,161.55,2430.93,46524.12,mortgage,18,3
73,46524.12,2592.48,153.53,2438.95,44085.17,mortgage,18,3
74,44085.17,2592.48,145.48,2447.0,41638.17,mortgage,18,3
75,41638.17,2592.48,137.41,2455.07,39183.1,mortgage,18,3
76,39183.1,2592.48,129.3,2463.18,36719.92,mortgage,18,3
77,36719.92,2592.48,121.18,2471.3,34248.62,mortgage,18,3
78,34248.62,2592.48,113.02,2479.46,31769.16,mortgage,18,3
79,31769.16,2592.48,104.84,2487.64,29281.52,mortgage,18,3
80,29281.52,2592.48,96.63,2495.85,26785.67,mortgage,18,3
81,26785.67,2592.48,88.39,2504.09,24281.58,mortgage,18,3
82,24281.58,2592.48,80.13,2512.35,21769.23,mortgage,18,3
83,21769.23,2592.48,71.84,2520.64,19248.59,mortgage,18,3
84,19248.59,2592.48,63.52,2528.96,16719.63,mortgage,18,3
85,16719.63,2592.48,55.17,2537.31,14182.32,mortgage,18,3
86,14182.32,2592.48,46.8,2545.68,11636.64,mortgage,18,3
87,11636.64,2592.48,38.4,2554.08,9082.56,mortgage,18,3
88,9082.56,2592.48,29.97,2562.51,6520.05,mortgage,18,3
89,6520.05,2592.48,21.52,2570.96,3949.09,mortgage,18,3
90,3949.09,2592.48,13.03,2579.45,1369.64,mortgage,18,3
91,1369.64,2592.48,4.52,2587.96,-1218.32,mortgage,18,3
0,8250.57,84.62,53.63,30.99,8219.58,WellsFargo1,18,4
1,8219.58,84.62,53.43,31.19,8188.39,WellsFargo1,18,4
2,8188.39,84.62,53.22,31.4,8156.99,WellsFargo1,18,4
3,8156.99,84.62,53.02,31.6,8125.39,WellsFargo1,18,4
4,8125.39,84.62,52.82,31.8,8093.59,WellsFargo1,18,4
5,8093.59,84.62,52.61,32.01,8061.58,WellsFargo1,18,4
6,8061.58,84.62,52.4,32.22,8029.36,WellsFargo1,18,4
7,8029.36,84.62,52.19,32.43,7996.93,WellsFargo1,18,4
8,7996.93,84.62,51.98,32.64,7964.29,WellsFargo1,18,4
9,7964.29,84.62,51.77,32.85,7931.44,WellsFargo1,18,4
10,7931.44,84.62,51.55,33.07,7898.37,WellsFargo1,18,4
11,7898.37,84.62,51.34,33.28,7865.09,WellsFargo1,18,4
12,7865.09,84.62,51.12,33.5,7831.59,WellsFargo1,18,4
13,7831.59,84.62,50.91,33.71,7797.88,WellsFargo1,18,4
14,7797.88,84.62,50.69,33.93,7763.95,WellsFargo1,18,4
15,7763.95,84.62,50.47,34.15,7729.8,WellsFargo1,18,4
16,7729.8,84.62,50.24,34.38,7695.42,WellsFargo1,18,4
17,7695.42,84.62,50.02,34.6,7660.82,WellsFargo1,18,4
18,7660.82,84.62,49.8,34.82,7626.0,WellsFargo1,18,4
19,7626.0,84.62,49.57,35.05,7590.95,WellsFargo1,18,4
20,7590.95,84.62,49.34,35.28,7555.67,WellsFargo1,18,4
21,7555.67,84.62,49.11,35.51,7520.16,WellsFargo1,18,4
22,7520.16,84.62,48.88,35.74,7484.42,WellsFargo1,18,4
23,7484.42,84.62,48.65,35.97,7448.45,WellsFargo1,18,4
24,7448.45,84.62,48.41,36.21,7412.24,WellsFargo1,18,4
25,7412.24,84.62,48.18,36.44,7375.8,WellsFargo1,18,4
26,7375.8,84.62,47.94,36.68,7339.12,WellsFargo1,18,4
27,7339.12,84.62,47.7,36.92,7302.2,WellsFargo1,18,4
28,7302.2,84.62,47.46,37.16,7265.04,WellsFargo1,18,4
29,7265.04,84.62,47.22,37.4,7227.64,WellsFargo1,18,4
30,7227.64,84.62,46.98,37.64,7190.0,WellsFargo1,18,4
31,7190.0,84.62,46.73,37.89,7152.11,WellsFargo1,18,4
32,7152.11,84.62,46.49,38.13,7113.98,WellsFargo1,18,4
33,7113.98,84.62,46.24,38.38,7075.6,WellsFargo1,18,4
34,7075.6,84.62,45.99,38.63,7036.97,WellsFargo1,18,4
35,7036.97,84.62,45.74,38.88,6998.09,WellsFargo1,18,4
36,6998.09,84.62,45.49,39.13,6958.96,WellsFargo1,18,4
37,6958.96,84.62,45.23,39.39,6919.57,WellsFargo1,18,4
38,6919.57,84.62,44.98,39.64,6879.93,WellsFargo1,18,4
39,6879.93,84.62,44.72,39.9,6840.03,WellsFargo1,18,4
40,6840.03,84.62,44.46,40.16,6799.87,WellsFargo1,18,4
41,6799.87,84.62,44.2,40.42,6759.45,WellsFargo1,18,4
42,6759.45,84.62,43.94,40.68,6718.77,WellsFargo1,18,4
43,6718.77,84.62,43.67,40.95,6677.82,WellsFargo1,18,4
44,6677.82,84.62,43.41,41.21,6636.61,WellsFargo1,18,4
45,6636.61,84.62,43.14,41.48,6595.13,WellsFargo1,18,4
46,6595.13,84.62,42.87,41.75,6553.38,WellsFargo1,18,4
47,6553.38,84.62,42.6,42.02,6511.36,WellsFargo1,18,4
48,6511.36,84.62,42.32,42.3,6469.06,WellsFargo1,18,4
49,6469.06,84.62,42.05,42.57,6426.49,WellsFargo1,18,4
50,6426.49,84.62,41.77,42.85,6383.64,WellsFargo1,18,4
51,6383.64,84.62,41.49,43.13,6340.51,WellsFargo1,18,4
52,6340.51,84.62,41.21,43.41,6297.1,WellsFargo1,18,4
53,6297.1,84.62,40.93,43.69,6253.41,WellsFargo1,18,4
54,6253.41,84.62,40.65,43.97,6209.44,WellsFargo1,18,4
55,6209.44,84.62,40.36,44.26,6165.18,WellsFargo1,18,4
56,6165.18,84.62,40.07,44.55,6120.63,WellsFargo1,18,4
57,6120.63,84.62,39.78,44.84,6075.79,WellsFargo1,18,4
58,6075.79,84.62,39.49,45.13,6030.66,WellsFargo1,18,4
59,6030.66,84.62,39.2,45.42,5985.24,WellsFargo1,18,4
60,5985.24,84.62,38.9,45.72,5939.52,WellsFargo1,18,4
61,5939.52,84.62,38.61,46.01,5893.51,WellsFargo1,18,4
62,5893.51,84.62,38.31,46.31,5847.2,WellsFargo1,18,4
63,5847.2,84.62,38.01,46.61,5800.59,WellsFargo1,18,4
64,5800.59,84.62,37.7,46.92,5753.67,WellsFargo1,18,4
65,5753.67,84.62,37.4,47.22,5706.45,WellsFargo1,18,4
66,5706.45,84.62,37.09,47.53,5658.92,WellsFargo1,18,4
67,5658.92,84.62,36.78,47.84,5611.08,WellsFargo1,18,4
68,5611.08,84.62,36.47,48.15,5562.93,WellsFargo1,18,4
69,5562.93,84.62,36.16,48.46,5514.47,WellsFargo1,18,4
70,5514.47,84.62,35.84,48.78,5465.69,WellsFargo1,18,4
71,5465.69,84.62,35.53,49.09,5416.6,WellsFargo1,18,4
72,5416.6,84.62,35.21,49.41,5367.19,WellsFargo1,18,4
73,5367.19,84.62,34.89,49.73,5317.46,WellsFargo1,18,4
74,5317.46,84.62,34.56,50.06,5267.4,WellsFargo1,18,4
75,5267.4,84.62,34.24,50.38,5217.02,WellsFargo1,18,4
76,5217.02,84.62,33.91,50.71,5166.31,WellsFargo1,18,4
77,5166.31,84.62,33.58,51.04,5115.27,WellsFargo1,18,4
78,5115.27,84.62,33.25,51.37,5063.9,WellsFargo1,18,4
79,5063.9,84.62,32.92,51.7,5012.2,WellsFargo1,18,4
80,5012.2,84.62,32.58,52.04,4960.16,WellsFargo1,18,4
81,4960.16,84.62,32.24,52.38,4907.78,WellsFargo1,18,4
82,4907.78,84.62,31.9,52.72,4855.06,WellsFargo1,18,4
83,4855.06,84.62,31.56,53.06,4802.0,WellsFargo1,18,4
84,4802.0,84.62,31.21,53.41,4748.59,WellsFargo1,18,4
85,4748.59,84.62,30.87,53.75,4694.84,WellsFargo1,18,4
86,4694.84,84.62,30.52,54.1,4640.74,WellsFargo1,18,4
87,4640.74,84.62,30.16,54.46,4586.28,WellsFargo1,18,4
88,4586.28,84.62,29.81,54.81,4531.47,WellsFargo1,18,4
89,4531.47,84.62,29.45,55.17,4476.3,WellsFargo1,18,4
90,4476.3,84.62,29.1,55.52,4420.78,WellsFargo1,18,4
91,4420.78,1302.94,28.74,1274.2,3146.58,WellsFargo1,18,4
92,3146.58,2677.1,20.45,2656.65,489.93,WellsFargo1,18,4
93,489.93,2677.1,3.18,2673.92,-2183.99,WellsFargo1,18,4
0,5000.0,333.0,36.0,297.0,4703.0,Car,18,5
1,4703.0,333.0,33.86,299.14,4403.86,Car,18,5
2,4403.86,333.0,31.71,301.29,4102.57,Car,18,5
3,4102.57,333.0,29.54,303.46,3799.11,Car,18,5
4,3799.11,333.0,27.35,305.65,3493.46,Car,18,5
5,3493.46,333.0,25.15,307.85,3185.61,Car,18,5
6,3185.61,333.0,22.94,310.06,2875.55,Car,18,5
7,2875.55,333.0,20.7,312.3,2563.25,Car,18,5
8,2563.25,333.0,18.46,314.54,2248.71,Car,18,5
9,2248.71,333.0,16.19,316.81,1931.9,Car,18,5
10,1931.9,333.0,13.91,319.09,1612.81,Car,18,5
11,1612.81,333.0,11.61,321.39,1291.42,Car,18,5
12,1291.42,333.0,9.3,323.7,967.72,Car,18,5
13,967.72,333.0,6.97,326.03,641.69,Car,18,5
14,641.69,333.0,4.62,328.38,313.31,Car,18,5
15,313.31,333.0,2.26,330.74,-17.43,Car,18,5
0,4000.0,1070.0,16.0,1054.0,2946.0,testing,19,1
1,2946.0,1070.0,11.78,1058.22,1887.78,testing,19,1
2,1887.78,1070.0,7.55,1062.45,825.33,testing,19,1
3,825.33,1070.0,3.3,1066.7,-241.37,testing,19,1
0,180000.0,1331.44,594.0,737.44,179262.56,mortgage,19,2
1,179262.56,1331.44,591.57,739.87,178522.69,mortgage,19,2
2,178522.69,1331.44,589.12,742.32,177780.37,mortgage,19,2
3,177780.37,1572.81,586.68,986.13,176794.24,mortgage,19,2
4,176794.24,2401.44,583.42,1818.02,174976.22,mortgage,19,2
5,174976.22,2401.44,577.42,1824.02,173152.2,mortgage,19,2
6,173152.2,2401.44,571.4,1830.04,171322.16,mortgage,19,2
7,171322.16,2401.44,565.36,1836.08,169486.08,mortgage,19,2
8,169486.08,2401.44,559.3,1842.14,167643.94,mortgage,19,2
9,167643.94,2401.44,553.23,1848.21,165795.73,mortgage,19,2
10,165795.73,2401.44,547.13,1854.31,163941.42,mortgage,19,2
11,163941.42,2401.44,541.01,1860.43,162080.99,mortgage,19,2
12,162080.99,2401.44,534.87,1866.57,160214.42,mortgage,19,2
13,160214.42,2401.44,528.71,1872.73,158341.69,mortgage,19,2
14,158341.69,2401.44,522.53,1878.91,156462.78,mortgage,19,2
15,156462.78,2401.44,516.33,1885.11,154577.67,mortgage,19,2
16,154577.67,2401.44,510.11,1891.33,152686.34,mortgage,19,2
17,152686.34,2401.44,503.86,1897.58,150788.76,mortgage,19,2
18,150788.76,2401.44,497.6,1903.84,148884.92,mortgage,19,2
19,148884.92,2401.44,491.32,1910.12,146974.8,mortgage,19,2
20,146974.8,2401.44,485.02,1916.42,145058.38,mortgage,19,2
21,145058.38,2401.44,478.69,1922.75,143135.63,mortgage,19,2
22,143135.63,2401.44,472.35,1929.09,141206.54,mortgage,19,2
23,141206.54,2401.44,465.98,1935.46,139271.08,mortgage,19,2
24,139271.08,2401.44,459.59,1941.85,137329.23,mortgage,19,2
25,137329.23,2401.44,453.19,1948.25,135380.98,mortgage,19,2
26,135380.98,2401.44,446.76,1954.68,133426.3,mortgage,19,2
27,133426.3,2401.44,440.31,1961.13,131465.17,mortgage,19,2
28,131465.17,2401.44,433.84,1967.6,129497.57,mortgage,19,2
29,129497.57,2401.44,427.34,1974.1,127523.47,mortgage,19,2
30,127523.47,2401.44,420.83,1980.61,125542.86,mortgage,19,2
31,125542.86,2401.44,414.29,1987.15,123555.71,mortgage,19,2
32,123555.71,2401.44,407.73,1993.71,121562.0,mortgage,19,2
33,121562.0,2401.44,401.15,2000.29,119561.71,mortgage,19,2
34,119561.71,2401.44,394.55,2006.89,117554.82,mortgage,19,2
35,117554.82,2401.44,387.93,2013.51,115541.31,mortgage,19,2
36,115541.31,2401.44,381.29,2020.15,113521.16,mortgage,19,2
37,113521.16,2401.44,374.62,2026.82,111494.34,mortgage,19,2
38,111494.34,2401.44,367.93,2033.51,109460.83,mortgage,19,2
39,109460.83,2401.44,361.22,2040.22,107420.61,mortgage,19,2
40,107420.61,2401.44,354.49,2046.95,105373.66,mortgage,19,2
41,105373.66,2401.44,347.73,2053.71,103319.95,mortgage,19,2
42,103319.95,2401.44,340.96,2060.48,101259.47,mortgage,19,2
43,101259.47,2401.44,334.16,2067.28,99192.19,mortgage,19,2
44,99192.19,2401.44,327.33,2074.11,97118.08,mortgage,19,2
45,97118.08,2401.44,320.49,2080.95,95037.13,mortgage,19,2
46,95037.13,2401.44,313.62,2087.82,92949.31,mortgage,19,2
47,92949.31,2401.44,306.73,2094.71,90854.6,mortgage,19,2
48,90854.6,2401.44,299.82,2101.62,88752.98,mortgage,19,2
49,88752.98,2401.44,292.88,2108.56,86644.42,mortgage,19,2
50,86644.42,2401.44,285.93,2115.51,84528.91,mortgage,19,2
51,84528.91,2401.44,278.95,2122.49,82406.42,mortgage,19,2
52,82406.42,2401.44,271.94,2129.5,80276.92,mortgage,19,2
53,80276.92,2401.44,264.91,2136.53,78140.39,mortgage,19,2
54,78140.39,2401.44,257.86,2143.58,75996.81,mortgage,19,2
55,75996.81,2401.44,250.79,2150.65,73846.16,mortgage,19,2
56,73846.16,2401.44,243.69,2157.75,71688.41,mortgage,19,2
57,71688.41,2401.44,236.57,2164.87,69523.54,mortgage,19,2
58,69523.54,2401.44,229.43,2172.01,67351.53,mortgage,19,2
59,67351.53,2401.44,222.26,2179.18,65172.35,mortgage,19,2
60,65172.35,2401.44,215.07,2186.37,62985.98,mortgage,19,2
61,62985.98,2401.44,207.85,2193.59,60792.39,mortgage,19,2
62,60792.39,2401.44,200.61,2200.83,58591.56,mortgage,19,2
63,58591.56,2401.44,193.35,2208.09,56383.47,mortgage,19,2
64,56383.47,2401.44,186.07,2215.37,54168.1,mortgage,19,2
65,54168.1,2401.44,178.75,2222.69,51945.41,mortgage,19,2
66,51945.41,2401.44,171.42,2230.02,49715.39,mortgage,19,2
67,49715.39,2401.44,164.06,2237.38,47478.01,mortgage,19,2
68,47478.01,2401.44,156.68,2244.76,45233.25,mortgage,19,2
69,45233.25,2401.44,149.27,2252.17,42981.08,mortgage,19,2
70,42981.08,2401.44,141.84,2259.6,40721.48,mortgage,19,2
71,40721.48,2401.44,134.38,2267.06,38454.42,mortgage,19,2
72,38454.42,2401.44,126.9,2274.54,36179.88,mortgage,19,2
73,36179.88,2401.44,119.39,2282.05,33897.83,mortgage,19,2
74,33897.83,2401.44,111.86,2289.58,31608.25,mortgage,19,2
75,31608.25,2401.44,104.31,2297.13,29311.12,mortgage,19,2
76,29311.12,2401.44,96.73,2304.71,27006.41,mortgage,19,2
77,27006.41,2401.44,89.12,2312.32,24694.09,mortgage,19,2
78,24694.09,2401.44,81.49,2319.95,22374.14,mortgage,19,2
79,22374.14,2401.44,73.83,2327.61,20046.53,mortgage,19,2
80,20046.53,2401.44,66.15,2335.29,17711.24,mortgage,19,2
81,17711.24,2401.44,58.45,2342.99,15368.25,mortgage,19,2
82,15368.25,2401.44,50.72,2350.72,13017.53,mortgage,19,2
83,13017.53,2401.44,42.96,2358.48,10659.05,mortgage,19,2
84,10659.05,2401.44,35.17,2366.27,8292.78,mortgage,19,2
85,8292.78,2401.44,27.37,2374.07,5918.71,mortgage,19,2
86,5918.71,2401.44,19.53,2381.91,3536.8,mortgage,19,2
87,3536.8,2401.44,11.67,2389.77,1147.03,mortgage,19,2
88,1147.03,2401.44,3.79,2397.65,-1250.62,mortgage,19,2
0,5000.0,333.0,36.0,297.0,4703.0,Car,19,3
1,4703.0,333.0,33.86,299.14,4403.86,Car,19,3
2,4403.86,333.0,31.71,301.29,4102.57,Car,19,3
3,4102.57,333.0,29.54,303.46,3799.11,Car,19,3
4,3799.11,333.0,27.35,305.65,3493.46,Car,19,3
5,3493.46,333.0,25.15,307.85,3185.61,Car,19,3
6,3185.61,333.0,22.94,310.06,2875.55,Car,19,3
7,2875.55,333.0,20.7,312.3,2563.25,Car,19,3
8,2563.25,333.0,18.46,314.54,2248.71,Car,19,3
9,2248.71,333.0,16.19,316.81,1931.9,Car,19,3
10,1931.9,333.0,13.91,319.09,1612.81,Car,19,3
11,1612.81,333.0,11.61,321.39,1291.42,Car,19,3
12,1291.42,333.0,9.3,323.7,967.72,Car,19,3
13,967.72,333.0,6.97,326.03,641.69,Car,19,3
14,641.69,333.0,4.62,328.38,313.31,Car,19,3
15,313.31,333.0,2.26,330.74,-17.43,Car,19,3
0,8250.57,84.62,53.63,30.99,8219.58,WellsFargo1,19,4
1,8219.58,84.62,53.43,31.19,8188.39,WellsFargo1,19,4
2,8188.39,84.62,53.22,31.4,8156.99,WellsFargo1,19,4
3,8156.99,84.62,53.02,31.6,8125.39,WellsFargo1,19,4
4,8125.39,84.62,52.82,31.8,8093.59,WellsFargo1,19,4
5,8093.59,84.62,52.61,32.01,8061.58,WellsFargo1,19,4
6,8061.58,84.62,52.4,32.22,8029.36,WellsFargo1,19,4
7,8029.36,84.62,52.19,32.43,7996.93,WellsFargo1,19,4
8,7996.93,84.62,51.98,32.64,7964.29,WellsFargo1,19,4
9,7964.29,84.62,51.77,32.85,7931.44,WellsFargo1,19,4
10,7931.44,84.62,51.55,33.07,7898.37,WellsFargo1,19,4
11,7898.37,84.62,51.34,33.28,7865.09,WellsFargo1,19,4
12,7865.09,84.62,51.12,33.5,7831.59,WellsFargo1,19,4
13,7831.59,84.62,50.91,33.71,7797.88,WellsFargo1,19,4
14,7797.88,84.62,50.69,33.93,7763.95,WellsFargo1,19,4
15,7763.95,102.05,50.47,51.58,7712.37,WellsFargo1,19,4
16,7712.37,2819.06,50.13,2768.93,4943.44,WellsFargo1,19,4
17,4943.44,2819.06,32.13,2786.93,2156.51,WellsFargo1,19,4
18,2156.51,2819.06,14.02,2805.04,-648.53,WellsFargo1,19,4
0,20000.0,191.04,108.0,83.04,19916.96,WellsFargo2,19,5
1,19916.96,191.04,107.55,83.49,19833.47,WellsFargo2,19,5
2,19833.47,191.04,107.1,83.94,19749.53,WellsFargo2,19,5
3,19749.53,191.04,106.65,84.39,19665.14,WellsFargo2,19,5
4,19665.14,191.04,106.19,84.85,19580.29,WellsFargo2,19,5
5,19580.29,191.04,105.73,85.31,19494.98,WellsFargo2,19,5
6,19494.98,191.04,105.27,85.77,19409.21,WellsFargo2,19,5
7,19409.21,191.04,104.81,86.23,19322.98,WellsFargo2,19,5
8,19322.98,191.04,104.34,86.7,19236.28,WellsFargo2,19,5
9,19236.28,191.04,103.88,87.16,19149.12,WellsFargo2,19,5
10,19149.12,191.04,103.41,87.63,19061.49,WellsFargo2,19,5
11,19061.49,191.04,102.93,88.11,18973.38,WellsFargo2,19,5
12,18973.38,191.04,102.46,88.58,18884.8,WellsFargo2,19,5
13,18884.8,191.04,101.98,89.06,18795.74,WellsFargo2,19,5
14,18795.74,191.04,101.5,89.54,18706.2,WellsFargo2,19,5
15,18706.2,191.04,101.01,90.03,18616.17,WellsFargo2,19,5
16,18616.17,191.04,100.53,90.51,18525.66,WellsFargo2,19,5
17,18525.66,191.04,100.04,91.0,18434.66,WellsFargo2,19,5
18,18434.66,839.57,99.55,740.02,17694.64,WellsFargo2,19,5
19,17694.64,3010.1,95.55,2914.55,14780.09,WellsFargo2,19,5
20,14780.09,3010.1,79.81,2930.29,11849.8,WellsFargo2,19,5
21,11849.8,3010.1,63.99,2946.11,8903.69,WellsFargo2,19,5
22,8903.69,3010.1,48.08,2962.02,5941.67,WellsFargo2,19,5
23,5941.67,3010.1,32.09,2978.01,2963.66,WellsFargo2,19,5
24,2963.66,3010.1,16.0,2994.1,-30.44,WellsFargo2,19,5
0,4000.0,1070.0,16.0,1054.0,2946.0,testing,20,1
1,2946.0,1070.0,11.78,1058.22,1887.78,testing,20,1
2,1887.78,1070.0,7.55,1062.45,825.33,testing,20,1
3,825.33,1070.0,3.3,1066.7,-241.37,testing,20,1
0,180000.0,1331.44,594.0,737.44,179262.56,mortgage,20,2
1,179262.56,1331.44,591.57,739.87,178522.69,mortgage,20,2
2,178522.69,1331.44,589.12,742.32,177780.37,mortgage,20,2
3,177780.37,1572.81,586.68,986.13,176794.24,mortgage,20,2
4,176794.24,2401.44,583.42,1818.02,174976.22,mortgage,20,2
5,174976.22,2401.44,577.42,1824.02,173152.2,mortgage,20,2
6,173152.2,2401.44,571.4,1830.04,171322.16,mortgage,20,2
7,171322.16,2401.44,565.36,1836.08,169486.08,mortgage,20,2
8,169486.08,2401.44,559.3,1842.14,167643.94,mortgage,20,2
9,167643.94,2401.44,553.23,1848.21,165795.73,mortgage,20,2
10,165795.73,2401.44,547.13,1854.31,163941.42,mortgage,20,2
11,163941.42,2401.44,541.01,1860.43,162080.99,mortgage,20,2
12,162080.99,2401.44,534.87,1866.57,160214.42,mortgage,20,2
13,160214.42,2401.44,528.71,1872.73,158341.69,mortgage,20,2
14,158341.69,2401.44,522.53,1878.91,156462.78,mortgage,20,2
15,156462.78,2401.44,516.33,1885.11,154577.67,mortgage,20,2
16,154577.67,2401.44,510.11,1891.33,152686.34,mortgage,20,2
17,152686.34,2401.44,503.86,1897.58,150788.76,mortgage,20,2
18,150788.76,2401.44,497.6,1903.84,148884.92,mortgage,20,2
19,148884.92,2401.44,491.32,1910.12,146974.8,mortgage,20,2
20,146974.8,2401.44,485.02,1916.42,145058.38,mortgage,20,2
21,145058.38,2401.44,478.69,1922.75,143135.63,mortgage,20,2
22,143135.63,2401.44,472.35,1929.09,141206.54,mortgage,20,2
23,141206.54,2401.44,465.98,1935.46,139271.08,mortgage,20,2
24,139271.08,2401.44,459.59,1941.85,137329.23,mortgage,20,2
25,137329.23,2401.44,453.19,1948.25,135380.98,mortgage,20,2
26,135380.98,2401.44,446.76,1954.68,133426.3,mortgage,20,2
27,133426.3,2401.44,440.31,1961.13,131465.17,mortgage,20,2
28,131465.17,2401.44,433.84,1967.6,129497.57,mortgage,20,2
29,129497.57,2401.44,427.34,1974.1,127523.47,mortgage,20,2
30,127523.47,2401.44,420.83,1980.61,125542.86,mortgage,20,2
31,125542.86,2401.44,414.29,1987.15,123555.71,mortgage,20,2
32,123555.71,2401.44,407.73,1993.71,121562.0,mortgage,20,2
33,121562.0,2401.44,401.15,2000.29,119561.71,mortgage,20,2
34,119561.71,2401.44,394.55,2006.89,117554.82,mortgage,20,2
35,117554.82,2401.44,387.93,2013.51,115541.31,mortgage,20,2
36,115541.31,2401.44,381.29,2020.15,113521.16,mortgage,20,2
37,113521.16,2401.44,374.62,2026.82,111494.34,mortgage,20,2
38,111494.34,2401.44,367.93,2033.51,109460.83,mortgage,20,2
39,109460.83,2401.44,361.22,2040.22,107420.61,mortgage,20,2
40,107420.61,2401.44,354.49,2046.95,105373.66,mortgage,20,2
41,105373.66,2401.44,347.73,2053.71,103319.95,mortgage,20,2
42,103319.95,2401.44,340.96,2060.48,101259.47,mortgage,20,2
43,101259.47,2401.44,334.16,2067.28,99192.19,mortgage,20,2
44,99192.19,2401.44,327.33,2074.11,97118.08,mortgage,20,2
45,97118.08,2401.44,320.49,2080.95,95037.13,mortgage,20,2
46,95037.13,2401.44,313.62,2087.82,92949.31,mortgage,20,2
47,92949.31,2401.44,306.73,2094.71,90854.6,mortgage,20,2
48,90854.6,2401.44,299.82,2101.62,88752.98,mortgage,20,2
49,88752.98,2401.44,292.88,2108.56,86644.42,mortgage,20,2
50,86644.42,2401.44,285.93,2115.51,84528.91,mortgage,20,2
51,84528.91,2401.44,278.95,2122.49,82406.42,mortgage,20,2
52,82406.42,2401.44,271.94,2129.5,80276.92,mortgage,20,2
53,80276.92,2401.44,264.91,2136.53,78140.39,mortgage,20,2
54,78140.39,2401.44,257.86,2143.58,75996.81,mortgage,20,2
55,75996.81,2401.44,250.79,2150.65,73846.16,mortgage,20,2
56,73846.16,2401.44,243.69,2157.75,71688.41,mortgage,20,2
57,71688.41,2401.44,236.57,2164.87,69523.54,mortgage,20,2
58,69523.54,2401.44,229.43,2172.01,67351.53,mortgage,20,2
59,67351.53,2401.44,222.26,2179.18,65172.35,mortgage,20,2
60,65172.35,2401.44,215.07,2186.37,62985.98,mortgage,20,2
61,62985.98,2401.44,207.85,2193.59,60792.39,mortgage,20,2
62,60792.39,2401.44,200.61,2200.83,58591.56,mortgage,20,2
63,58591.56,2401.44,193.35,2208.09,56383.47,mortgage,20,2
64,56383.47,2401.44,186.07,2215.37,54168.1,mortgage,20,2
65,54168.1,2401.44,178.75,2222.69,51945.41,mortgage,20,2
66,51945.41,2401.44,171.42,2230.02,49715.39,mortgage,20,2
67,49715.39,2401.44,164.06,2237.38,47478.01,mortgage,20,2
68,47478.01,2401.44,156.68,2244.76,45233.25,mortgage,20,2
69,45233.25,2401.44,149.27,2252.17,42981.08,mortgage,20,2
70,42981.08,2401.44,141.84,2259.6,40721.48,mortgage,20,2
71,40721.48,2401.44,134.38,2267.06,38454.42,mortgage,20,2
72,38454.42,2401.44,126.9,2274.54,36179.88,mortgage,20,2
73,36179.88,2401.44,119.39,2282.05,33897.83,mortgage,20,2
74,33897.83,2401.44,111.86,2289.58,31608.25,mortgage,20,2
75,31608.25,2401.44,104.31,2297.13,29311.12,mortgage,20,2
76,29311.12,2401.44,96.73,2304.71,27006.41,mortgage,20,2
77,27006.41,2401.44,89.12,2312.32,24694.09,mortgage,20,2
78,24694.09,2401.44,81.49,2319.95,22374.14,mortgage,20,2
79,22374.14,2401.44,73.83,2327.61,20046.53,mortgage,20,2
80,20046.53,2401.44,66.15,2335.29,17711.24,mortgage,20,2
81,17711.24,2401.44,58.45,2342.99,15368.25,mortgage,20,2
82,15368.25,2401.44,50.72,2350.72,13017.53,mortgage,20,2
83,13017.53,2401.44,42.96,2358.48,10659.05,mortgage,20,2
84,10659.05,2401.44,35.17,2366.27,8292.78,mortgage,20,2
85,8292.78,2401.44,27.37,2374.07,5918.71,mortgage,20,2
86,5918.71,2401.44,19.53,2381.91,3536.8,mortgage,20,2
87,3536.8,2401.44,11.67,2389.77,1147.03,mortgage,20,2
88,1147.03,2401.44,3.79,2397.65,-1250.62,mortgage,20,2
0,5000.0,333.0,36.0,297.0,4703.0,Car,20,3
1,4703.0,333.0,33.86,299.14,4403.86,Car,20,3
2,4403.86,333.0,31.71,301.29,4102.57,Car,20,3
3,4102.57,333.0,29.54,303.46,3799.11,Car,20,3
4,3799.11,333.0,27.35,305.65,3493.46,Car,20,3
5,3493.46,333.0,25.15,307.85,3185.61,Car,20,3
6,3185.61,333.0,22.94,310.06,2875.55,Car,20,3
7,2875.55,333.0,20.7,312.3,2563.25,Car,20,3
8,2563.25,333.0,18.46,314.54,2248.71,Car,20,3
9,2248.71,333.0,16.19,316.81,1931.9,Car,20,3
10,1931.9,333.0,13.91,319.09,1612.81,Car,20,3
11,1612.81,333.0,11.61,321.39,1291.42,Car,20,3
12,1291.42,333.0,9.3,323.7,967.72,Car,20,3
13,967.72,333.0,6.97,326.03,641.69,Car,20,3
14,641.69,333.0,4.62,328.38,313.31,Car,20,3
15,313.31,333.0,2.26,330.74,-17.43,Car,20,3
0,20000.0,191.04,108.0,83.04,19916.96,WellsFargo2,20,4
1,19916.96,191.04,107.55,83.49,19833.47,WellsFargo2,20,4
2,19833.47,191.04,107.1,83.94,19749.53,WellsFargo2,20,4
3,19749.53,191.04,106.65,84.39,19665.14,WellsFargo2,20,4
4,19665.14,191.04,106.19,84.85,19580.29,WellsFargo2,20,4
5,19580.29,191.04,105.73,85.31,19494.98,WellsFargo2,20,4
6,19494.98,191.04,105.27,85.77,19409.21,WellsFargo2,20,4
7,19409.21,191.04,104.81,86.23,19322.98,WellsFargo2,20,4
8,19322.98,191.04,104.34,86.7,19236.28,WellsFargo2,20,4
9,19236.28,191.04,103.88,87.16,19149.12,WellsFargo2,20,4
10,19149.12,191.04,103.41,87.63,19061.49,WellsFargo2,20,4
11,19061.49,191.04,102.93,88.11,18973.38,WellsFargo2,20,4
12,18973.38,191.04,102.46,88.58,18884.8,WellsFargo2,20,4
13,18884.8,191.04,101.98,89.06,18795.74,WellsFargo2,20,4
14,18795.74,191.04,101.5,89.54,18706.2,WellsFargo2,20,4
15,18706.2,208.47,101.01,107.46,18598.74,WellsFargo2,20,4
16,18598.74,2925.48,100.43,2825.05,15773.69,WellsFargo2,20,4
17,15773.69,2925.48,85.18,2840.3,12933.39,WellsFargo2,20,4
18,12933.39,2925.48,69.84,2855.64,10077.75,WellsFargo2,20,4
19,10077.75,2925.48,54.42,2871.06,7206.69,WellsFargo2,20,4
20,7206.69,2925.48,38.92,2886.56,4320.13,WellsFargo2,20,4
21,4320.13,2925.48,23.33,2902.15,1417.98,WellsFargo2,20,4
22,1417.98,2925.48,7.66,2917.82,-1499.84,WellsFargo2,20,4
0,8250.57,84.62,53.63,30.99,8219.58,WellsFargo1,20,5
1,8219.58,84.62,53.43,31.19,8188.39,WellsFargo1,20,5
2,8188.39,84.62,53.22,31.4,8156.99,WellsFargo1,20,5
3,8156.99,84.62,53.02,31.6,8125.39,WellsFargo1,20,5
4,8125.39,84.62,52.82,31.8,8093.59,WellsFargo1,20,5
5,8093.59,84.62,52.61,32.01,8061.58,WellsFargo1,20,5
6,8061.58,84.62,52.4,32.22,8029.36,WellsFargo1,20,5
7,8029.36,84.62,52.19,32.43,7996.93,WellsFargo1,20,5
8,7996.93,84.62,51.98,32.64,7964.29,WellsFargo1,20,5
9,7964.29,84.62,51.77,32.85,7931.44,WellsFargo1,20,5
10,7931.44,84.62,51.55,33.07,7898.37,WellsFargo1,20,5
11,7898.37,84.62,51.34,33.28,7865.09,WellsFargo1,20,5
12,7865.09,84.62,51.12,33.5,7831.59,WellsFargo1,20,5
13,7831.59,84.62,50.91,33.71,7797.88,WellsFargo1,20,5
14,7797.88,84.62,50.69,33.93,7763.95,WellsFargo1,20,5
15,7763.95,84.62,50.47,34.15,7729.8,WellsFargo1,20,5
16,7729.8,84.62,50.24,34.38,7695.42,WellsFargo1,20,5
17,7695.42,84.62,50.02,34.6,7660.82,WellsFargo1,20,5
18,7660.82,84.62,49.8,34.82,7626.0,WellsFargo1,20,5
19,7626.0,84.62,49.57,35.05,7590.95,WellsFargo1,20,5
20,7590.95,84.62,49.34,35.28,7555.67,WellsFargo1,20,5
21,7555.67,84.62,49.11,35.51,7520.16,WellsFargo1,20,5
22,7520.16,1584.46,48.88,1535.58,5984.58,WellsFargo1,20,5
23,5984.58,3010.1,38.9,2971.2,3013.38,WellsFargo1,20,5
24,3013.38,3010.1,19.59,2990.51,22.87,WellsFargo1,20,5
25,22.87,3010.1,0.15,3009.95,-2987.08,WellsFargo1,20,5
0,4000.0,1070.0,16.0,1054.0,2946.0,testing,21,1
1,2946.0,1070.0,11.78,1058.22,1887.78,testing,21,1
2,1887.78,1070.0,7.55,1062.45,825.33,testing,21,1
3,825.33,1070.0,3.3,1066.7,-241.37,testing,21,1
0,180000.0,1331.44,594.0,737.44,179262.56,mortgage,21,2
1,179262.56,1331.44,591.57,739.87,178522.69,mortgage,21,2
2,178522.69,1331.44,589.12,742.32,177780.37,mortgage,21,2
3,177780.37,1572.81,586.68,986.13,176794.24,mortgage,21,2
4,176794.24,2401.44,583.42,1818.02,174976.22,mortgage,21,2
5,174976.22,2401.44,577.42,1824.02,173152.2,mortgage,21,2
6,173152.2,2401.44,571.4,1830.04,171322.16,mortgage,21,2
7,171322.16,2401.44,565.36,1836.08,169486.08,mortgage,21,2
8,169486.08,2401.44,559.3,1842.14,167643.94,mortgage,21,2
9,167643.94,2401.44,553.23,1848.21,165795.73,mortgage,21,2
10,165795.73,2401.44,547.13,1854.31,163941.42,mortgage,21,2
11,163941.42,2401.44,541.01,1860.43,162080.99,mortgage,21,2
12,162080.99,2401.44,534.87,1866.57,160214.42,mortgage,21,2
13,160214.42,2401.44,528.71,1872.73,158341.69,mortgage,21,2
14,158341.69,2401.44,522.53,1878.91,156462.78,mortgage,21,2
15,156462.78,2401.44,516.33,1885.11,154577.67,mortgage,21,2
16,154577.67,2401.44,510.11,1891.33,152686.34,mortgage,21,2
17,152686.34,2401.44,503.86,1897.58,150788.76,mortgage,21,2
18,150788.76,2401.44,497.6,1903.84,148884.92,mortgage,21,2
19,148884.92,2401.44,491.32,1910.12,146974.8,mortgage,21,2
20,146974.8,2401.44,485.02,1916.42,145058.38,mortgage,21,2
21,145058.38,2401.44,478.69,1922.75,143135.63,mortgage,21,2
22,143135.63,2401.44,472.35,1929.09,141206.54,mortgage,21,2
23,141206.54,2401.44,465.98,1935.46,139271.08,mortgage,21,2
24,139271.08,2401.44,459.59,1941.85,137329.23,mortgage,21,2
25,137329.23,2401.44,453.19,1948.25,135380.98,mortgage,21,2
26,135380.98,2401.44,446.76,1954.68,133426.3,mortgage,21,2
27,133426.3,2401.44,440.31,1961.13,131465.17,mortgage,21,2
28,131465.17,2401.44,433.84,1967.6,129497.57,mortgage,21,2
29,129497.57,2401.44,427.34,1974.1,127523.47,mortgage,21,2
30,127523.47,2401.44,420.83,1980.61,125542.86,mortgage,21,2
31,125542.86,2401.44,414.29,1987.15,123555.71,mortgage,21,2
32,123555.71,2401.44,407.73,1993.71,121562.0,mortgage,21,2
33,121562.0,2401.44,401.15,2000.29,119561.71,mortgage,21,2
34,119561.71,2401.44,394.55,2006.89,117554.82,mortgage,21,2
35,117554.82,2401.44,387.93,2013.51,115541.31,mortgage,21,2
36,115541.31,2401.44,381.29,2020.15,113521.16,mortgage,21,2
37,113521.16,2401.44,374.62,2026.82,111494.34,mortgage,21,2
38,111494.34,2401.44,367.93,2033.51,109460.83,mortgage,21,2
39,109460.83,2401.44,361.22,2040.22,107420.61,mortgage,21,2
40,107420.61,2401.44,354.49,2046.95,105373.66,mortgage,21,2
41,105373.66,2401.44,347.73,2053.71,103319.95,mortgage,21,2
42,103319.95,2401.44,340.96,2060.48,101259.47,mortgage,21,2
43,101259.47,2401.44,334.16,2067.28,99192.19,mortgage,21,2
44,99192.19,2401.44,327.33,2074.11,97118.08,mortgage,21,2
45,97118.08,2401.44,320.49,2080.95,95037.13,mortgage,21,2
46,95037.13,2401.44,313.62,2087.82,92949.31,mortgage,21,2
47,92949.31,2401.44,306.73,2094.71,90854.6,mortgage,21,2
48,90854.6,2401.44,299.82,2101.62,88752.98,mortgage,21,2
49,88752.98,2401.44,292.88,2108.56,86644.42,mortgage,21,2
50,86644.42,2401.44,285.93,2115.51,84528.91,mortgage,21,2
51,84528.91,2401.44,278.95,2122.49,82406.42,mortgage,21,2
52,82406.42,2401.44,271.94,2129.5,80276.92,mortgage,21,2
53,80276.92,2401.44,264.91,2136.53,78140.39,mortgage,21,2
54,78140.39,2401.44,257.86,2143.58,75996.81,mortgage,21,2
55,75996.81,2401.44,250.79,2150.65,73846.16,mortgage,21,2
56,73846.16,2401.44,243.69,2157.75,71688.41,mortgage,21,2
57,71688.41,2401.44,236.57,2164.87,69523.54,mortgage,21,2
58,69523.54,2401.44,229.43,2172.01,67351.53,mortgage,21,2
59,67351.53,2401.44,222.26,2179.18,65172.35,mortgage,21,2
60,65172.35,2401.44,215.07,2186.37,62985.98,mortgage,21,2
61,62985.98,2401.44,207.85,2193.59,60792.39,mortgage,21,2
62,60792.39,2401.44,200.61,2200.83,58591.56,mortgage,21,2
63,58591.56,2401.44,193.35,2208.09,56383.47,mortgage,21,2
64,56383.47,2401.44,186.07,2215.37,54168.1,mortgage,21,2
65,54168.1,2401.44,178.75,2222.69,51945.41,mortgage,21,2
66,51945.41,2401.44,171.42,2230.02,49715.39,mortgage,21,2
67,49715.39,2401.44,164.06,2237.38,47478.01,mortgage,21,2
68,47478.01,2401.44,156.68,2244.76,45233.25,mortgage,21,2
69,45233.25,2401.44,149.27,2252.17,42981.08,mortgage,21,2
70,42981.08,2401.44,141.84,2259.6,40721.48,mortgage,21,2
71,40721.48,2401.44,134.38,2267.06,38454.42,mortgage,21,2
72,38454.42,2401.44,126.9,2274.54,36179.88,mortgage,21,2
73,36179.88,2401.44,119.39,2282.05,33897.83,mortgage,21,2
74,33897.83,2401.44,111.86,2289.58,31608.25,mortgage,21,2
75,31608.25,2401.44,104.31,2297.13,29311.12,mortgage,21,2
76,29311.12,2401.44,96.73,2304.71,27006.41,mortgage,21,2
77,27006.41,2401.44,89.12,2312.32,24694.09,mortgage,21,2
78,24694.09,2401.44,81.49,2319.95,22374.14,mortgage,21,2
79,22374.14,2401.44,73.83,2327.61,20046.53,mortgage,21,2
80,20046.53,2401.44,66.15,2335.29,17711.24,mortgage,21,2
81,17711.24,2401.44,58.45,2342.99,15368.25,mortgage,21,2
82,15368.25,2401.44,50.72,2350.72,13017.53,mortgage,21,2
83,13017.53,2401.44,42.96,2358.48,10659.05,mortgage,21,2
84,10659.05,2401.44,35.17,2366.27,8292.78,mortgage,21,2
85,8292.78,2401.44,27.37,2374.07,5918.71,mortgage,21,2
86,5918.71,2401.44,19.53,2381.91,3536.8,mortgage,21,2
87,3536.8,2401.44,11.67,2389.77,1147.03,mortgage,21,2
88,1147.03,2401.44,3.79,2397.65,-1250.62,mortgage,21,2
0,8250.57,84.62,53.63,30.99,8219.58,WellsFargo1,21,3
1,8219.58,84.62,53.43,31.19,8188.39,WellsFargo1,21,3
2,8188.39,84.62,53.22,31.4,8156.99,WellsFargo1,21,3
3,8156.99,84.62,53.02,31.6,8125.39,WellsFargo1,21,3
4,8125.39,84.62,52.82,31.8,8093.59,WellsFargo1,21,3
5,8093.59,84.62,52.61,32.01,8061.58,WellsFargo1,21,3
6,8061.58,84.62,52.4,32.22,8029.36,WellsFargo1,21,3
7,8029.36,84.62,52.19,32.43,7996.93,WellsFargo1,21,3
8,7996.93,84.62,51.98,32.64,7964.29,WellsFargo1,21,3
9,7964.29,84.62,51.77,32.85,7931.44,WellsFargo1,21,3
10,7931.44,84.62,51.55,33.07,7898.37,WellsFargo1,21,3
11,7898.37,84.62,51.34,33.28,7865.09,WellsFargo1,21,3
12,7865.09,84.62,51.12,33.5,7831.59,WellsFargo1,21,3
13,7831.59,84.62,50.91,33.71,7797.88,WellsFargo1,21,3
14,7797.88,84.62,50.69,33.93,7763.95,WellsFargo1,21,3
15,7763.95,84.62,50.47,34.15,7729.8,WellsFargo1,21,3
16,7729.8,84.62,50.24,34.38,7695.42,WellsFargo1,21,3
17,7695.42,84.62,50.02,34.6,7660.82,WellsFargo1,21,3
18,7660.82,84.62,49.8,34.82,7626.0,WellsFargo1,21,3
19,7626.0,84.62,49.57,35.05,7590.95,WellsFargo1,21,3
20,7590.95,84.62,49.34,35.28,7555.67,WellsFargo1,21,3
21,7555.67,84.62,49.11,35.51,7520.16,WellsFargo1,21,3
22,7520.16,84.62,48.88,35.74,7484.42,WellsFargo1,21,3
23,7484.42,84.62,48.65,35.97,7448.45,WellsFargo1,21,3
24,7448.45,84.62,48.41,36.21,7412.24,WellsFargo1,21,3
25,7412.24,84.62,48.18,36.44,7375.8,WellsFargo1,21,3
26,7375.8,84.62,47.94,36.68,7339.12,WellsFargo1,21,3
27,7339.12,84.62,47.7,36.92,7302.2,WellsFargo1,21,3
28,7302.2,84.62,47.46,37.16,7265.04,WellsFargo1,21,3
29,7265.04,84.62,47.22,37.4,7227.64,WellsFargo1,21,3
30,7227.64,84.62,46.98,37.64,7190.0,WellsFargo1,21,3
31,7190.0,84.62,46.73,37.89,7152.11,WellsFargo1,21,3
32,7152.11,84.62,46.49,38.13,7113.98,WellsFargo1,21,3
33,7113.98,84.62,46.24,38.38,7075.6,WellsFargo1,21,3
34,7075.6,84.62,45.99,38.63,7036.97,WellsFargo1,21,3
35,7036.97,84.62,45.74,38.88,6998.09,WellsFargo1,21,3
36,6998.09,84.62,45.49,39.13,6958.96,WellsFargo1,21,3
37,6958.96,84.62,45.23,39.39,6919.57,WellsFargo1,21,3
38,6919.57,84.62,44.98,39.64,6879.93,WellsFargo1,21,3
39,6879.93,84.62,44.72,39.9,6840.03,WellsFargo1,21,3
40,6840.03,84.62,44.46,40.16,6799.87,WellsFargo1,21,3
41,6799.87,84.62,44.2,40.42,6759.45,WellsFargo1,21,3
42,6759.45,84.62,43.94,40.68,6718.77,WellsFargo1,21,3
43,6718.77,84.62,43.67,40.95,6677.82,WellsFargo1,21,3
44,6677.82,84.62,43.41,41.21,6636.61,WellsFargo1,21,3
45,6636.61,84.62,43.14,41.48,6595.13,WellsFargo1,21,3
46,6595.13,84.62,42.87,41.75,6553.38,WellsFargo1,21,3
47,6553.38,84.62,42.6,42.02,6511.36,WellsFargo1,21,3
48,6511.36,84.62,42.32,42.3,6469.06,WellsFargo1,21,3
49,6469.06,84.62,42.05,42.57,6426.49,WellsFargo1,21,3
50,6426.49,84.62,41.77,42.85,6383.64,WellsFargo1,21,3
51,6383.64,84.62,41.49,43.13,6340.51,WellsFargo1,21,3
52,6340.51,84.62,41.21,43.41,6297.1,WellsFargo1,21,3
53,6297.1,84.62,40.93,43.69,6253.41,WellsFargo1,21,3
54,6253.41,84.62,40.65,43.97,6209.44,WellsFargo1,21,3
55,6209.44,84.62,40.36,44.26,6165.18,WellsFargo1,21,3
56,6165.18,84.62,40.07,44.55,6120.63,WellsFargo1,21,3
57,6120.63,84.62,39.78,44.84,6075.79,WellsFargo1,21,3
58,6075.79,84.62,39.49,45.13,6030.66,WellsFargo1,21,3
59,6030.66,84.62,39.2,45.42,5985.24,WellsFargo1,21,3
60,5985.24,84.62,38.9,45.72,5939.52,WellsFargo1,21,3
61,5939.52,84.62,38.61,46.01,5893.51,WellsFargo1,21,3
62,5893.51,84.62,38.31,46.31,5847.2,WellsFargo1,21,3
63,5847.2,84.62,38.01,46.61,5800.59,WellsFargo1,21,3
64,5800.59,84.62,37.7,46.92,5753.67,WellsFargo1,21,3
65,5753.67,84.62,37.4,47.22,5706.45,WellsFargo1,21,3
66,5706.45,84.62,37.09,47.53,5658.92,WellsFargo1,21,3
67,5658.92,84.62,36.78,47.84,5611.08,WellsFargo1,21,3
68,5611.08,84.62,36.47,48.15,5562.93,WellsFargo1,21,3
69,5562.93,84.62,36.16,48.46,5514.47,WellsFargo1,21,3
70,5514.47,84.62,35.84,48.78,5465.69,WellsFargo1,21,3
71,5465.69,84.62,35.53,49.09,5416.6,WellsFargo1,21,3
72,5416.6,84.62,35.21,49.41,5367.19,WellsFargo1,21,3
73,5367.19,84.62,34.89,49.73,5317.46,WellsFargo1,21,3
74,5317.46,84.62,34.56,50.06,5267.4,WellsFargo1,21,3
75,5267.4,84.62,34.24,50.38,5217.02,WellsFargo1,21,3
76,5217.02,84.62,33.91,50.71,5166.31,WellsFargo1,21,3
77,5166.31,84.62,33.58,51.04,5115.27,WellsFargo1,21,3
78,5115.27,84.62,33.25,51.37,5063.9,WellsFargo1,21,3
79,5063.9,84.62,32.92,51.7,5012.2,WellsFargo1,21,3
80,5012.2,84.62,32.58,52.04,4960.16,WellsFargo1,21,3
81,4960.16,84.62,32.24,52.38,4907.78,WellsFargo1,21,3
82,4907.78,84.62,31.9,52.72,4855.06,WellsFargo1,21,3
83,4855.06,84.62,31.56,53.06,4802.0,WellsFargo1,21,3
84,4802.0,84.62,31.21,53.41,4748.59,WellsFargo1,21,3
85,4748.59,84.62,30.87,53.75,4694.84,WellsFargo1,21,3
86,4694.84,84.62,30.52,54.1,4640.74,WellsFargo1,21,3
87,4640.74,84.62,30.16,54.46,4586.28,WellsFargo1,21,3
88,4586.28,1335.24,29.81,1305.43,3280.85,WellsFargo1,21,3
89,3280.85,2486.06,21.33,2464.73,816.12,WellsFargo1,21,3
90,816.12,2486.06,5.3,2480.76,-1664.64,WellsFargo1,21,3
0,5000.0,333.0,36.0,297.0,4703.0,Car,21,4
1,4703.0,333.0,33.86,299.14,4403.86,Car,21,4
2,4403.86,333.0,31.71,301.29,4102.57,Car,21,4
3,4102.57,333.0,29.54,303.46,3799.11,Car,21,4
4,3799.11,333.0,27.35,305.65,3493.46,Car,21,4
5,3493.46,333.0,25.15,307.85,3185.61,Car,21,4
6,3185.61,333.0,22.94,310.06,2875.55,Car,21,4
7,2875.55,333.0,20.7,312.3,2563.25,Car,21,4
8,2563.25,333.0,18.46,314.54,2248.71,Car,21,4
9,2248.71,333.0,16.19,316.81,1931.9,Car,21,4
10,1931.9,333.0,13.91,319.09,1612.81,Car,21,4
11,1612.81,333.0,11.61,321.39,1291.42,Car,21,4
12,1291.42,333.0,9.3,323.7,967.72,Car,21,4
13,967.72,333.0,6.97,326.03,641.69,Car,21,4
14,641.69,333.0,4.62,328.38,313.31,Car,21,4
15,313.31,333.0,2.26,330.74,-17.43,Car,21,4
0,20000.0,191.04,108.0,83.04,19916.96,WellsFargo2,21,5
1,19916.96,191.04,107.55,83.49,19833.47,WellsFargo2,21,5
2,19833.47,191.04,107.1,83.94,19749.53,WellsFargo2,21,5
3,19749.53,191.04,106.65,84.39,19665.14,WellsFargo2,21,5
4,19665.14,191.04,106.19,84.85,19580.29,WellsFargo2,21,5
5,19580.29,191.04,105.73,85.31,19494.98,WellsFargo2,21,5
6,19494.98,191.04,105.27,85.77,19409.21,WellsFargo2,21,5
7,19409.21,191.04,104.81,86.23,19322.98,WellsFargo2,21,5
8,19322.98,191.04,104.34,86.7,19236.28,WellsFargo2,21,5
9,19236.28,191.04,103.88,87.16,19149.12,WellsFargo2,21,5
10,19149.12,191.04,103.41,87.63,19061.49,WellsFargo2,21,5
11,19061.49,191.04,102.93,88.11,18973.38,WellsFargo2,21,5
12,18973.38,191.04,102.46,88.58,18884.8,WellsFargo2,21,5
13,18884.8,191.04,101.98,89.06,18795.74,WellsFargo2,21,5
14,18795.74,191.04,101.5,89.54,18706.2,WellsFargo2,21,5
15,18706.2,208.47,101.01,107.46,18598.74,WellsFargo2,21,5
16,18598.74,3010.1,100.43,2909.67,15689.07,WellsFargo2,21,5
17,15689.07,3010.1,84.72,2925.38,12763.69,WellsFargo2,21,5
18,12763.69,3010.1,68.92,2941.18,9822.51,WellsFargo2,21,5
19,9822.51,3010.1,53.04,2957.06,6865.45,WellsFargo2,21,5
20,6865.45,3010.1,37.07,2973.03,3892.42,WellsFargo2,21,5
21,3892.42,3010.1,21.02,2989.08,903.34,WellsFargo2,21,5
22,903.34,3010.1,4.88,3005.22,-2101.88,WellsFargo2,21,5
0,4000.0,1070.0,16.0,1054.0,2946.0,testing,22,1
1,2946.0,1070.0,11.78,1058.22,1887.78,testing,22,1
2,1887.78,1070.0,7.55,1062.45,825.33,testing,22,1
3,825.33,1070.0,3.3,1066.7,-241.37,testing,22,1
0,180000.0,1331.44,594.0,737.44,179262.56,mortgage,22,2
1,179262.56,1331.44,591.57,739.87,178522.69,mortgage,22,2
2,178522.69,1331.44,589.12,742.32,177780.37,mortgage,22,2
3,177780.37,1572.81,586.68,986.13,176794.24,mortgage,22,2
4,176794.24,2401.44,583.42,1818.02,174976.22,mortgage,22,2
5,174976.22,2401.44,577.42,1824.02,173152.2,mortgage,22,2
6,173152.2,2401.44,571.4,1830.04,171322.16,mortgage,22,2
7,171322.16,2401.44,565.36,1836.08,169486.08,mortgage,22,2
8,169486.08,2401.44,559.3,1842.14,167643.94,mortgage,22,2
9,167643.94,2401.44,553.23,1848.21,165795.73,mortgage,22,2
10,165795.73,2401.44,547.13,1854.31,163941.42,mortgage,22,2
11,163941.42,2401.44,541.01,1860.43,162080.99,mortgage,22,2
12,162080.99,2401.44,534.87,1866.57,160214.42,mortgage,22,2
13,160214.42,2401.44,528.71,1872.73,158341.69,mortgage,22,2
14,158341.69,2401.44,522.53,1878.91,156462.78,mortgage,22,2
15,156462.78,2401.44,516.33,1885.11,154577.67,mortgage,22,2
16,154577.67,2401.44,510.11,1891.33,152686.34,mortgage,22,2
17,152686.34,2401.44,503.86,1897.58,150788.76,mortgage,22,2
18,150788.76,2401.44,497.6,1903.84,148884.92,mortgage,22,2
19,148884.92,2401.44,491.32,1910.12,146974.8,mortgage,22,2
20,146974.8,2401.44,485.02,1916.42,145058.38,mortgage,22,2
21,145058.38,2401.44,478.69,1922.75,143135.63,mortgage,22,2
22,143135.63,2401.44,472.35,1929.09,141206.54,mortgage,22,2
23,141206.54,2401.44,465.98,1935.46,139271.08,mortgage,22,2
24,139271.08,2401.44,459.59,1941.85,137329.23,mortgage,22,2
25,137329.23,2401.44,453.19,1948.25,135380.98,mortgage,22,2
26,135380.98,2401.44,446.76,1954.68,133426.3,mortgage,22,2
27,133426.3,2401.44,440.31,1961.13,131465.17,mortgage,22,2
28,131465.17,2401.44,433.84,1967.6,129497.57,mortgage,22,2
29,129497.57,2401.44,427.34,1974.1,127523.47,mortgage,22,2
30,127523.47,2401.44,420.83,1980.61,125542.86,mortgage,22,2
31,125542.86,2401.44,414.29,1987.15,123555.71,mortgage,22,2
32,123555.71,2401.44,407.73,1993.71,121562.0,mortgage,22,2
33,121562.0,2401.44,401.15,2000.29,119561.71,mortgage,22,2
34,119561.71,2401.44,394.55,2006.89,117554.82,mortgage,22,2
35,117554.82,2401.44,387.93,2013.51,115541.31,mortgage,22,2
36,115541.31,2401.44,381.29,2020.15,113521.16,mortgage,22,2
37,113521.16,2401.44,374.62,2026.82,111494.34,mortgage,22,2
38,111494.34,2401.44,367.93,2033.51,109460.83,mortgage,22,2
39,109460.83,2401.44,361.22,2040.22,107420.61,mortgage,22,2
40,107420.61,2401.44,354.49,2046.95,105373.66,mortgage,22,2
41,105373.66,2401.44,347.73,2053.71,103319.95,mortgage,22,2
42,103319.95,2401.44,340.96,2060.48,101259.47,mortgage,22,2
43,101259.47,2401.44,334.16,2067.28,99192.19,mortgage,22,2
44,99192.19,2401.44,327.33,2074.11,97118.08,mortgage,22,2
45,97118.08,2401.44,320.49,2080.95,95037.13,mortgage,22,2
46,95037.13,2401.44,313.62,2087.82,92949.31,mortgage,22,2
47,92949.31,2401.44,306.73,2094.71,90854.6,mortgage,22,2
48,90854.6,2401.44,299.82,2101.62,88752.98,mortgage,22,2
49,88752.98,2401.44,292.88,2108.56,86644.42,mortgage,22,2
50,86644.42,2401.44,285.93,2115.51,84528.91,mortgage,22,2
51,84528.91,2401.44,278.95,2122.49,82406.42,mortgage,22,2
52,82406.42,2401.44,271.94,2129.5,80276.92,mortgage,22,2
53,80276.92,2401.44,264.91,2136.53,78140.39,mortgage,22,2
54,78140.39,2401.44,257.86,2143.58,75996.81,mortgage,22,2
55,75996.81,2401.44,250.79,2150.65,73846.16,mortgage,22,2
56,73846.16,2401.44,243.69,2157.75,71688.41,mortgage,22,2
57,71688.41,2401.44,236.57,2164.87,69523.54,mortgage,22,2
58,69523.54,2401.44,229.43,2172.01,67351.53,mortgage,22,2
59,67351.53,2401.44,222.26,2179.18,65172.35,mortgage,22,2
60,65172.35,2401.44,215.07,2186.37,62985.98,mortgage,22,2
61,62985.98,2401.44,207.85,2193.59,60792.39,mortgage,22,2
62,60792.39,2401.44,200.61,2200.83,58591.56,mortgage,22,2
63,58591.56,2401.44,193.35,2208.09,56383.47,mortgage,22,2
64,56383.47,2401.44,186.07,2215.37,54168.1,mortgage,22,2
65,54168.1,2401.44,178.75,2222.69,51945.41,mortgage,22,2
66,51945.41,2401.44,171.42,2230.02,49715.39,mortgage,22,2
67,49715.39,2401.44,164.06,2237.38,47478.01,mortgage,22,2
68,47478.01,2401.44,156.68,2244.76,45233.25,mortgage,22,2
69,45233.25,2401.44,149.27,2252.17,42981.08,mortgage,22,2
70,42981.08,2401.44,141.84,2259.6,40721.48,mortgage,22,2
71,40721.48,2401.44,134.38,2267.06,38454.42,mortgage,22,2
72,38454.42,2401.44,126.9,2274.54,36179.88,mortgage,22,2
73,36179.88,2401.44,119.39,2282.05,33897.83,mortgage,22,2
74,33897.83,2401.44,111.86,2289.58,31608.25,mortgage,22,2
75,31608.25,2401.44,104.31,2297.13,29311.12,mortgage,22,2
76,29311.12,2401.44,96.73,2304.71,27006.41,mortgage,22,2
77,27006.41,2401.44,89.12,2312.32,24694.09,mortgage,22,2
78,24694.09,2401.44,81.49,2319.95,22374.14,mortgage,22,2
79,22374.14,2401.44,73.83,2327.61,20046.53,mortgage,22,2
80,20046.53,2401.44,66.15,2335.29,17711.24,mortgage,22,2
81,17711.24,2401.44,58.45,2342.99,15368.25,mortgage,22,2
82,15368.25,2401.44,50.72,2350.72,13017.53,mortgage,22,2
83,13017.53,2401.44,42.96,2358.48,10659.05,mortgage,22,2
84,10659.05,2401.44,35.17,2366.27,8292.78,mortgage,22,2
85,8292.78,2401.44,27.37,2374.07,5918.71,mortgage,22,2
86,5918.71,2401.44,19.53,2381.91,3536.8,mortgage,22,2
87,3536.8,2401.44,11.67,2389.77,1147.03,mortgage,22,2
88,1147.03,2401.44,3.79,2397.65,-1250.62,mortgage,22,2
0,8250.57,84.62,53.63,30.99,8219.58,WellsFargo1,22,3
1,8219.58,84.62,53.43,31.19,8188.39,WellsFargo1,22,3
2,8188.39,84.62,53.22,31.4,8156.99,WellsFargo1,22,3
3,8156.99,84.62,53.02,31.6,8125.39,WellsFargo1,22,3
4,8125.39,84.62,52.82,31.8,8093.59,WellsFargo1,22,3
5,8093.59,84.62,52.61,32.01,8061.58,WellsFargo1,22,3
6,8061.58,84.62,52.4,32.22,8029.36,WellsFargo1,22,3
7,8029.36,84.62,52.19,32.43,7996.93,WellsFargo1,22,3
8,7996.93,84.62,51.98,32.64,7964.29,WellsFargo1,22,3
9,7964.29,84.62,51.77,32.85,7931.44,WellsFargo1,22,3
10,7931.44,84.62,51.55,33.07,7898.37,WellsFargo1,22,3
11,7898.37,84.62,51.34,33.28,7865.09,WellsFargo1,22,3
12,7865.09,84.62,51.12,33.5,7831.59,WellsFargo1,22,3
13,7831.59,84.62,50.91,33.71,7797.88,WellsFargo1,22,3
14,7797.88,84.62,50.69,33.93,7763.95,WellsFargo1,22,3
15,7763.95,84.62,50.47,34.15,7729.8,WellsFargo1,22,3
16,7729.8,84.62,50.24,34.38,7695.42,WellsFargo1,22,3
17,7695.42,84.62,50.02,34.6,7660.82,WellsFargo1,22,3
18,7660.82,84.62,49.8,34.82,7626.0,WellsFargo1,22,3
19,7626.0,84.62,49.57,35.05,7590.95,WellsFargo1,22,3
20,7590.95,84.62,49.34,35.28,7555.67,WellsFargo1,22,3
21,7555.67,84.62,49.11,35.51,7520.16,WellsFargo1,22,3
22,7520.16,84.62,48.88,35.74,7484.42,WellsFargo1,22,3
23,7484.42,84.62,48.65,35.97,7448.45,WellsFargo1,22,3
24,7448.45,84.62,48.41,36.21,7412.24,WellsFargo1,22,3
25,7412.24,84.62,48.18,36.44,7375.8,WellsFargo1,22,3
26,7375.8,84.62,47.94,36.68,7339.12,WellsFargo1,22,3
27,7339.12,84.62,47.7,36.92,7302.2,WellsFargo1,22,3
28,7302.2,84.62,47.46,37.16,7265.04,WellsFargo1,22,3
29,7265.04,84.62,47.22,37.4,7227.64,WellsFargo1,22,3
30,7227.64,84.62,46.98,37.64,7190.0,WellsFargo1,22,3
31,7190.0,84.62,46.73,37.89,7152.11,WellsFargo1,22,3
32,7152.11,84.62,46.49,38.13,7113.98,WellsFargo1,22,3
33,7113.98,84.62,46.24,38.38,7075.6,WellsFargo1,22,3
34,7075.6,84.62,45.99,38.63,7036.97,WellsFargo1,22,3
35,7036.97,84.62,45.74,38.88,6998.09,WellsFargo1,22,3
36,6998.09,84.62,45.49,39.13,6958.96,WellsFargo1,22,3
37,6958.96,84.62,45.23,39.39,6919.57,WellsFargo1,22,3
38,6919.57,84.62,44.98,39.64,6879.93,WellsFargo1,22,3
39,6879.93,84.62,44.72,39.9,6840.03,WellsFargo1,22,3
40,6840.03,84.62,44.46,40.16,6799.87,WellsFargo1,22,3
41,6799.87,84.62,44.2,40.42,6759.45,WellsFargo1,22,3
42,6759.45,84.62,43.94,40.68,6718.77,WellsFargo1,22,3
43,6718.77,84.62,43.67,40.95,6677.82,WellsFargo1,22,3
44,6677.82,84.62,43.41,41.21,6636.61,WellsFargo1,22,3
45,6636.61,84.62,43.14,41.48,6595.13,WellsFargo1,22,3
46,6595.13,84.62,42.87,41.75,6553.38,WellsFargo1,22,3
47,6553.38,84.62,42.6,42.02,6511.36,WellsFargo1,22,3
48,6511.36,84.62,42.32,42.3,6469.06,WellsFargo1,22,3
49,6469.06,84.62,42.05,42.57,6426.49,WellsFargo1,22,3
50,6426.49,84.62,41.77,42.85,6383.64,WellsFargo1,22,3
51,6383.64,84.62,41.49,43.13,6340.51,WellsFargo1,22,3
52,6340.51,84.62,41.21,43.41,6297.1,WellsFargo1,22,3
53,6297.1,84.62,40.93,43.69,6253.41,WellsFargo1,22,3
54,6253.41,84.62,40.65,43.97,6209.44,WellsFargo1,22,3
55,6209.44,84.62,40.36,44.26,6165.18,WellsFargo1,22,3
56,6165.18,84.62,40.07,44.55,6120.63,WellsFargo1,22,3
57,6120.63,84.62,39.78,44.84,6075.79,WellsFargo1,22,3
58,6075.79,84.62,39.49,45.13,6030.66,WellsFargo1,22,3
59,6030.66,84.62,39.2,45.42,5985.24,WellsFargo1,22,3
60,5985.24,84.62,38.9,45.72,5939.52,WellsFargo1,22,3
61,5939.52,84.62,38.61,46.01,5893.51,WellsFargo1,22,3
62,5893.51,84.62,38.31,46.31,5847.2,WellsFargo1,22,3
63,5847.2,84.62,38.01,46.61,5800.59,WellsFargo1,22,3
64,5800.59,84.62,37.7,46.92,5753.67,WellsFargo1,22,3
65,5753.67,84.62,37.4,47.22,5706.45,WellsFargo1,22,3
66,5706.45,84.62,37.09,47.53,5658.92,WellsFargo1,22,3
67,5658.92,84.62,36.78,47.84,5611.08,WellsFargo1,22,3
68,5611.08,84.62,36.47,48.15,5562.93,WellsFargo1,22,3
69,5562.93,84.62,36.16,48.46,5514.47,WellsFargo1,22,3
70,5514.47,84.62,35.84,48.78,5465.69,WellsFargo1,22,3
71,5465.69,84.62,35.53,49.09,5416.6,WellsFargo1,22,3
72,5416.6,84.62,35.21,49.41,5367.19,WellsFargo1,22,3
73,5367.19,84.62,34.89,49.73,5317.46,WellsFargo1,22,3
74,5317.46,84.62,34.56,50.06,5267.4,WellsFargo1,22,3
75,5267.4,84.62,34.24,50.38,5217.02,WellsFargo1,22,3
76,5217.02,84.62,33.91,50.71,5166.31,WellsFargo1,22,3
77,5166.31,84.62,33.58,51.04,5115.27,WellsFargo1,22,3
78,5115.27,84.62,33.25,51.37,5063.9,WellsFargo1,22,3
79,5063.9,84.62,32.92,51.7,5012.2,WellsFargo1,22,3
80,5012.2,84.62,32.58,52.04,4960.16,WellsFargo1,22,3
81,4960.16,84.62,32.24,52.38,4907.78,WellsFargo1,22,3
82,4907.78,84.62,31.9,52.72,4855.06,WellsFargo1,22,3
83,4855.06,84.62,31.56,53.06,4802.0,WellsFargo1,22,3
84,4802.0,84.62,31.21,53.41,4748.59,WellsFargo1,22,3
85,4748.59,84.62,30.87,53.75,4694.84,WellsFargo1,22,3
86,4694.84,84.62,30.52,54.1,4640.74,WellsFargo1,22,3
87,4640.74,84.62,30.16,54.46,4586.28,WellsFargo1,22,3
88,4586.28,1335.24,29.81,1305.43,3280.85,WellsFargo1,22,3
89,3280.85,2486.06,21.33,2464.73,816.12,WellsFargo1,22,3
90,816.12,2486.06,5.3,2480.76,-1664.64,WellsFargo1,22,3
0,20000.0,191.04,108.0,83.04,19916.96,WellsFargo2,22,4
1,19916.96,191.04,107.55,83.49,19833.47,WellsFargo2,22,4
2,19833.47,191.04,107.1,83.94,19749.53,WellsFargo2,22,4
3,19749.53,191.04,106.65,84.39,19665.14,WellsFargo2,22,4
4,19665.14,191.04,106.19,84.85,19580.29,WellsFargo2,22,4
5,19580.29,191.04,105.73,85.31,19494.98,WellsFargo2,22,4
6,19494.98,191.04,105.27,85.77,19409.21,WellsFargo2,22,4
7,19409.21,191.04,104.81,86.23,19322.98,WellsFargo2,22,4
8,19322.98,191.04,104.34,86.7,19236.28,WellsFargo2,22,4
9,19236.28,191.04,103.88,87.16,19149.12,WellsFargo2,22,4
10,19149.12,191.04,103.41,87.63,19061.49,WellsFargo2,22,4
11,19061.49,191.04,102.93,88.11,18973.38,WellsFargo2,22,4
12,18973.38,191.04,102.46,88.58,18884.8,WellsFargo2,22,4
13,18884.8,191.04,101.98,89.06,18795.74,WellsFargo2,22,4
14,18795.74,191.04,101.5,89.54,18706.2,WellsFargo2,22,4
15,18706.2,191.04,101.01,90.03,18616.17,WellsFargo2,22,4
16,18616.17,191.04,100.53,90.51,18525.66,WellsFargo2,22,4
17,18525.66,191.04,100.04,91.0,18434.66,WellsFargo2,22,4
18,18434.66,191.04,99.55,91.49,18343.17,WellsFargo2,22,4
19,18343.17,191.04,99.05,91.99,18251.18,WellsFargo2,22,4
20,18251.18,191.04,98.56,92.48,18158.7,WellsFargo2,22,4
21,18158.7,191.04,98.06,92.98,18065.72,WellsFargo2,22,4
22,18065.72,191.04,97.55,93.49,17972.23,WellsFargo2,22,4
23,17972.23,191.04,97.05,93.99,17878.24,WellsFargo2,22,4
24,17878.24,191.04,96.54,94.5,17783.74,WellsFargo2,22,4
25,17783.74,191.04,96.03,95.01,17688.73,WellsFargo2,22,4
26,17688.73,191.04,95.52,95.52,17593.21,WellsFargo2,22,4
27,17593.21,191.04,95.0,96.04,17497.17,WellsFargo2,22,4
28,17497.17,191.04,94.48,96.56,17400.61,WellsFargo2,22,4
29,17400.61,191.04,93.96,97.08,17303.53,WellsFargo2,22,4
30,17303.53,191.04,93.44,97.6,17205.93,WellsFargo2,22,4
31,17205.93,191.04,92.91,98.13,17107.8,WellsFargo2,22,4
32,17107.8,191.04,92.38,98.66,17009.14,WellsFargo2,22,4
33,17009.14,191.04,91.85,99.19,16909.95,WellsFargo2,22,4
34,16909.95,191.04,91.31,99.73,16810.22,WellsFargo2,22,4
35,16810.22,191.04,90.78,100.26,16709.96,WellsFargo2,22,4
36,16709.96,191.04,90.23,100.81,16609.15,WellsFargo2,22,4
37,16609.15,191.04,89.69,101.35,16507.8,WellsFargo2,22,4
38,16507.8,191.04,89.14,101.9,16405.9,WellsFargo2,22,4
39,16405.9,191.04,88.59,102.45,16303.45,WellsFargo2,22,4
40,16303.45,191.04,88.04,103.0,16200.45,WellsFargo2,22,4
41,16200.45,191.04,87.48,103.56,16096.89,WellsFargo2,22,4
42,16096.89,191.04,86.92,104.12,15992.77,WellsFargo2,22,4
43,15992.77,191.04,86.36,104.68,15888.09,WellsFargo2,22,4
44,15888.09,191.04,85.8,105.24,15782.85,WellsFargo2,22,4
45,15782.85,191.04,85.23,105.81,15677.04,WellsFargo2,22,4
46,15677.04,191.04,84.66,106.38,15570.66,WellsFargo2,22,4
47,15570.66,191.04,84.08,106.96,15463.7,WellsFargo2,22,4
48,15463.7,191.04,83.5,107.54,15356.16,WellsFargo2,22,4
49,15356.16,191.04,82.92,108.12,15248.04,WellsFargo2,22,4
50,15248.04,191.04,82.34,108.7,15139.34,WellsFargo2,22,4
51,15139.34,191.04,81.75,109.29,15030.05,WellsFargo2,22,4
52,15030.05,191.04,81.16,109.88,14920.17,WellsFargo2,22,4
53,14920.17,191.04,80.57,110.47,14809.7,WellsFargo2,22,4
54,14809.7,191.04,79.97,111.07,14698.63,WellsFargo2,22,4
55,14698.63,191.04,79.37,111.67,14586.96,WellsFargo2,22,4
56,14586.96,191.04,78.77,112.27,14474.69,WellsFargo2,22,4
57,14474.69,191.04,78.16,112.88,14361.81,WellsFargo2,22,4
58,14361.81,191.04,77.55,113.49,14248.32,WellsFargo2,22,4
59,14248.32,191.04,76.94,114.1,14134.22,WellsFargo2,22,4
60,14134.22,191.04,76.32,114.72,14019.5,WellsFargo2,22,4
61,14019.5,191.04,75.71,115.33,13904.17,WellsFargo2,22,4
62,13904.17,191.04,75.08,115.96,13788.21,WellsFargo2,22,4
63,13788.21,191.04,74.46,116.58,13671.63,WellsFargo2,22,4
64,13671.63,191.04,73.83,117.21,13554.42,WellsFargo2,22,4
65,13554.42,191.04,73.19,117.85,13436.57,WellsFargo2,22,4
66,13436.57,191.04,72.56,118.48,13318.09,WellsFargo2,22,4
67,13318.09,191.04,71.92,119.12,13198.97,WellsFargo2,22,4
68,13198.97,191.04,71.27,119.77,13079.2,WellsFargo2,22,4
69,13079.2,191.04,70.63,120.41,12958.79,WellsFargo2,22,4
70,12958.79,191.04,69.98,121.06,12837.73,WellsFargo2,22,4
71,12837.73,191.04,69.32,121.72,12716.01,WellsFargo2,22,4
72,12716.01,191.04,68.67,122.37,12593.64,WellsFargo2,22,4
73,12593.64,191.04,68.01,123.03,12470.61,WellsFargo2,22,4
74,12470.61,191.04,67.34,123.7,12346.91,WellsFargo2,22,4
75,12346.91,191.04,66.67,124.37,12222.54,WellsFargo2,22,4
76,12222.54,191.04,66.0,125.04,12097.5,WellsFargo2,22,4
77,12097.5,191.04,65.33,125.71,11971.79,WellsFargo2,22,4
78,11971.79,191.04,64.65,126.39,11845.4,WellsFargo2,22,4
79,11845.4,191.04,63.97,127.07,11718.33,WellsFargo2,22,4
80,11718.33,191.04,63.28,127.76,11590.57,WellsFargo2,22,4
81,11590.57,191.04,62.59,128.45,11462.12,WellsFargo2,22,4
82,11462.12,191.04,61.9,129.14,11332.98,WellsFargo2,22,4
83,11332.98,191.04,61.2,129.84,11203.14,WellsFargo2,22,4
84,11203.14,191.04,60.5,130.54,11072.6,WellsFargo2,22,4
85,11072.6,191.04,59.79,131.25,10941.35,WellsFargo2,22,4
86,10941.35,191.04,59.08,131.96,10809.39,WellsFargo2,22,4
87,10809.39,191.04,58.37,132.67,10676.72,WellsFargo2,22,4
88,10676.72,191.04,57.65,133.39,10543.33,WellsFargo2,22,4
89,10543.33,191.04,56.93,134.11,10409.22,WellsFargo2,22,4
90,10409.22,1855.68,56.21,1799.47,8609.75,WellsFargo2,22,4
91,8609.75,2677.1,46.49,2630.61,5979.14,WellsFargo2,22,4
92,5979.14,2677.1,32.29,2644.81,3334.33,WellsFargo2,22,4
93,3334.33,2677.1,18.01,2659.09,675.24,WellsFargo2,22,4
94,675.24,2677.1,3.65,2673.45,-1998.21,WellsFargo2,22,4
0,5000.0,333.0,36.0,297.0,4703.0,Car,22,5
1,4703.0,333.0,33.86,299.14,4403.86,Car,22,5
2,4403.86,333.0,31.71,301.29,4102.57,Car,22,5
3,4102.57,333.0,29.54,303.46,3799.11,Car,22,5
4,3799.11,333.0,27.35,305.65,3493.46,Car,22,5
5,3493.46,333.0,25.15,307.85,3185.61,Car,22,5
6,3185.61,333.0,22.94,310.06,2875.55,Car,22,5
7,2875.55,333.0,20.7,312.3,2563.25,Car,22,5
8,2563.25,333.0,18.46,314.54,2248.71,Car,22,5
9,2248.71,333.0,16.19,316.81,1931.9,Car,22,5
10,1931.9,333.0,13.91,319.09,1612.81,Car,22,5
11,1612.81,333.0,11.61,321.39,1291.42,Car,22,5
12,1291.42,333.0,9.3,323.7,967.72,Car,22,5
13,967.72,333.0,6.97,326.03,641.69,Car,22,5
14,641.69,333.0,4.62,328.38,313.31,Car,22,5
15,313.31,333.0,2.26,330.74,-17.43,Car,22,5
0,4000.0,1070.0,16.0,1054.0,2946.0,testing,23,1
1,2946.0,1070.0,11.78,1058.22,1887.78,testing,23,1
2,1887.78,1070.0,7.55,1062.45,825.33,testing,23,1
3,825.33,1070.0,3.3,1066.7,-241.37,testing,23,1
0,180000.0,1331.44,594.0,737.44,179262.56,mortgage,23,2
1,179262.56,1331.44,591.57,739.87,178522.69,mortgage,23,2
2,178522.69,1331.44,589.12,742.32,177780.37,mortgage,23,2
3,177780.37,1572.81,586.68,986.13,176794.24,mortgage,23,2
4,176794.24,2401.44,583.42,1818.02,174976.22,mortgage,23,2
5,174976.22,2401.44,577.42,1824.02,173152.2,mortgage,23,2
6,173152.2,2401.44,571.4,1830.04,171322.16,mortgage,23,2
7,171322.16,2401.44,565.36,1836.08,169486.08,mortgage,23,2
8,169486.08,2401.44,559.3,1842.14,167643.94,mortgage,23,2
9,167643.94,2401.44,553.23,1848.21,165795.73,mortgage,23,2
10,165795.73,2401.44,547.13,1854.31,163941.42,mortgage,23,2
11,163941.42,2401.44,541.01,1860.43,162080.99,mortgage,23,2
12,162080.99,2401.44,534.87,1866.57,160214.42,mortgage,23,2
13,160214.42,2401.44,528.71,1872.73,158341.69,mortgage,23,2
14,158341.69,2401.44,522.53,1878.91,156462.78,mortgage,23,2
15,156462.78,2401.44,516.33,1885.11,154577.67,mortgage,23,2
16,154577.67,2401.44,510.11,1891.33,152686.34,mortgage,23,2
17,152686.34,2401.44,503.86,1897.58,150788.76,mortgage,23,2
18,150788.76,2401.44,497.6,1903.84,148884.92,mortgage,23,2
19,148884.92,2401.44,491.32,1910.12,146974.8,mortgage,23,2
20,146974.8,2401.44,485.02,1916.42,145058.38,mortgage,23,2
21,145058.38,2401.44,478.69,1922.75,143135.63,mortgage,23,2
22,143135.63,2401.44,472.35,1929.09,141206.54,mortgage,23,2
23,141206.54,2401.44,465.98,1935.46,139271.08,mortgage,23,2
24,139271.08,2401.44,459.59,1941.85,137329.23,mortgage,23,2
25,137329.23,2401.44,453.19,1948.25,135380.98,mortgage,23,2
26,135380.98,2401.44,446.76,1954.68,133426.3,mortgage,23,2
27,133426.3,2401.44,440.31,1961.13,131465.17,mortgage,23,2
28,131465.17,2401.44,433.84,1967.6,129497.57,mortgage,23,2
29,129497.57,2401.44,427.34,1974.1,127523.47,mortgage,23,2
30,127523.47,2401.44,420.83,1980.61,125542.86,mortgage,23,2
31,125542.86,2401.44,414.29,1987.15,123555.71,mortgage,23,2
32,123555.71,2401.44,407.73,1993.71,121562.0,mortgage,23,2
33,121562.0,2401.44,401.15,2000.29,119561.71,mortgage,23,2
34,119561.71,2401.44,394.55,2006.89,117554.82,mortgage,23,2
35,117554.82,2401.44,387.93,2013.51,115541.31,mortgage,23,2
36,115541.31,2401.44,381.29,2020.15,113521.16,mortgage,23,2
37,113521.16,2401.44,374.62,2026.82,111494.34,mortgage,23,2
38,111494.34,2401.44,367.93,2033.51,109460.83,mortgage,23,2
39,109460.83,2401.44,361.22,2040.22,107420.61,mortgage,23,2
40,107420.61,2401.44,354.49,2046.95,105373.66,mortgage,23,2
41,105373.66,2401.44,347.73,2053.71,103319.95,mortgage,23,2
42,103319.95,2401.44,340.96,2060.48,101259.47,mortgage,23,2
43,101259.47,2401.44,334.16,2067.28,99192.19,mortgage,23,2
44,99192.19,2401.44,327.33,2074.11,97118.08,mortgage,23,2
45,97118.08,2401.44,320.49,2080.95,95037.13,mortgage,23,2
46,95037.13,2401.44,313.62,2087.82,92949.31,mortgage,23,2
47,92949.31,2401.44,306.73,2094.71,90854.6,mortgage,23,2
48,90854.6,2401.44,299.82,2101.62,88752.98,mortgage,23,2
49,88752.98,2401.44,292.88,2108.56,86644.42,mortgage,23,2
50,86644.42,2401.44,285.93,2115.51,84528.91,mortgage,23,2
51,84528.91,2401.44,278.95,2122.49,82406.42,mortgage,23,2
52,82406.42,2401.44,271.94,2129.5,80276.92,mortgage,23,2
53,80276.92,2401.44,264.91,2136.53,78140.39,mortgage,23,2
54,78140.39,2401.44,257.86,2143.58,75996.81,mortgage,23,2
55,75996.81,2401.44,250.79,2150.65,73846.16,mortgage,23,2
56,73846.16,2401.44,243.69,2157.75,71688.41,mortgage,23,2
57,71688.41,2401.44,236.57,2164.87,69523.54,mortgage,23,2
58,69523.54,2401.44,229.43,2172.01,67351.53,mortgage,23,2
59,67351.53,2401.44,222.26,2179.18,65172.35,mortgage,23,2
60,65172.35,2401.44,215.07,2186.37,62985.98,mortgage,23,2
61,62985.98,2401.44,207.85,2193.59,60792.39,mortgage,23,2
62,60792.39,2401.44,200.61,2200.83,58591.56,mortgage,23,2
63,58591.56,2401.44,193.35,2208.09,56383.47,mortgage,23,2
64,56383.47,2401.44,186.07,2215.37,54168.1,mortgage,23,2
65,54168.1,2401.44,178.75,2222.69,51945.41,mortgage,23,2
66,51945.41,2401.44,171.42,2230.02,49715.39,mortgage,23,2
67,49715.39,2401.44,164.06,2237.38,47478.01,mortgage,23,2
68,47478.01,2401.44,156.68,2244.76,45233.25,mortgage,23,2
69,45233.25,2401.44,149.27,2252.17,42981.08,mortgage,23,2
70,42981.08,2401.44,141.84,2259.6,40721.48,mortgage,23,2
71,40721.48,2401.44,134.38,2267.06,38454.42,mortgage,23,2
72,38454.42,2401.44,126.9,2274.54,36179.88,mortgage,23,2
73,36179.88,2401.44,119.39,2282.05,33897.83,mortgage,23,2
74,33897.83,2401.44,111.86,2289.58,31608.25,mortgage,23,2
75,31608.25,2401.44,104.31,2297.13,29311.12,mortgage,23,2
76,29311.12,2401.44,96.73,2304.71,27006.41,mortgage,23,2
77,27006.41,2401.44,89.12,2312.32,24694.09,mortgage,23,2
78,24694.09,2401.44,81.49,2319.95,22374.14,mortgage,23,2
79,22374.14,2401.44,73.83,2327.61,20046.53,mortgage,23,2
80,20046.53,2401.44,66.15,2335.29,17711.24,mortgage,23,2
81,17711.24,2401.44,58.45,2342.99,15368.25,mortgage,23,2
82,15368.25,2401.44,50.72,2350.72,13017.53,mortgage,23,2
83,13017.53,2401.44,42.96,2358.48,10659.05,mortgage,23,2
84,10659.05,2401.44,35.17,2366.27,8292.78,mortgage,23,2
85,8292.78,2401.44,27.37,2374.07,5918.71,mortgage,23,2
86,5918.71,2401.44,19.53,2381.91,3536.8,mortgage,23,2
87,3536.8,2401.44,11.67,2389.77,1147.03,mortgage,23,2
88,1147.03,2401.44,3.79,2397.65,-1250.62,mortgage,23,2
0,20000.0,191.04,108.0,83.04,19916.96,WellsFargo2,23,3
1,19916.96,191.04,107.55,83.49,19833.47,WellsFargo2,23,3
2,19833.47,191.04,107.1,83.94,19749.53,WellsFargo2,23,3
3,19749.53,191.04,106.65,84.39,19665.14,WellsFargo2,23,3
4,19665.14,191.04,106.19,84.85,19580.29,WellsFargo2,23,3
5,19580.29,191.04,105.73,85.31,19494.98,WellsFargo2,23,3
6,19494.98,191.04,105.27,85.77,19409.21,WellsFargo2,23,3
7,19409.21,191.04,104.81,86.23,19322.98,WellsFargo2,23,3
8,19322.98,191.04,104.34,86.7,19236.28,WellsFargo2,23,3
9,19236.28,191.04,103.88,87.16,19149.12,WellsFargo2,23,3
10,19149.12,191.04,103.41,87.63,19061.49,WellsFargo2,23,3
11,19061.49,191.04,102.93,88.11,18973.38,WellsFargo2,23,3
12,18973.38,191.04,102.46,88.58,18884.8,WellsFargo2,23,3
13,18884.8,191.04,101.98,89.06,18795.74,WellsFargo2,23,3
14,18795.74,191.04,101.5,89.54,18706.2,WellsFargo2,23,3
15,18706.2,191.04,101.01,90.03,18616.17,WellsFargo2,23,3
16,18616.17,191.04,100.53,90.51,18525.66,WellsFargo2,23,3
17,18525.66,191.04,100.04,91.0,18434.66,WellsFargo2,23,3
18,18434.66,191.04,99.55,91.49,18343.17,WellsFargo2,23,3
19,18343.17,191.04,99.05,91.99,18251.18,WellsFargo2,23,3
20,18251.18,191.04,98.56,92.48,18158.7,WellsFargo2,23,3
21,18158.7,191.04,98.06,92.98,18065.72,WellsFargo2,23,3
22,18065.72,191.04,97.55,93.49,17972.23,WellsFargo2,23,3
23,17972.23,191.04,97.05,93.99,17878.24,WellsFargo2,23,3
24,17878.24,191.04,96.54,94.5,17783.74,WellsFargo2,23,3
25,17783.74,191.04,96.03,95.01,17688.73,WellsFargo2,23,3
26,17688.73,191.04,95.52,95.52,17593.21,WellsFargo2,23,3
27,17593.21,191.04,95.0,96.04,17497.17,WellsFargo2,23,3
28,17497.17,191.04,94.48,96.56,17400.61,WellsFargo2,23,3
29,17400.61,191.04,93.96,97.08,17303.53,WellsFargo2,23,3
30,17303.53,191.04,93.44,97.6,17205.93,WellsFargo2,23,3
31,17205.93,191.04,92.91,98.13,17107.8,WellsFargo2,23,3
32,17107.8,191.04,92.38,98.66,17009.14,WellsFargo2,23,3
33,17009.14,191.04,91.85,99.19,16909.95,WellsFargo2,23,3
34,16909.95,191.04,91.31,99.73,16810.22,WellsFargo2,23,3
35,16810.22,191.04,90.78,100.26,16709.96,WellsFargo2,23,3
36,16709.96,191.04,90.23,100.81,16609.15,WellsFargo2,23,3
37,16609.15,191.04,89.69,101.35,16507.8,WellsFargo2,23,3
38,16507.8,191.04,89.14,101.9,16405.9,WellsFargo2,23,3
39,16405.9,191.04,88.59,102.45,16303.45,WellsFargo2,23,3
40,16303.45,191.04,88.04,103.0,16200.45,WellsFargo2,23,3
41,16200.45,191.04,87.48,103.56,16096.89,WellsFargo2,23,3
42,16096.89,191.04,86.92,104.12,15992.77,WellsFargo2,23,3
43,15992.77,191.04,86.36,104.68,15888.09,WellsFargo2,23,3
44,15888.09,191.04,85.8,105.24,15782.85,WellsFargo2,23,3
45,15782.85,191.04,85.23,105.81,15677.04,WellsFargo2,23,3
46,15677.04,191.04,84.66,106.38,15570.66,WellsFargo2,23,3
47,15570.66,191.04,84.08,106.96,15463.7,WellsFargo2,23,3
48,15463.7,191.04,83.5,107.54,15356.16,WellsFargo2,23,3
49,15356.16,191.04,82.92,108.12,15248.04,WellsFargo2,23,3
50,15248.04,191.04,82.34,108.7,15139.34,WellsFargo2,23,3
51,15139.34,191.04,81.75,109.29,15030.05,WellsFargo2,23,3
52,15030.05,191.04,81.16,109.88,14920.17,WellsFargo2,23,3
53,14920.17,191.04,80.57,110.47,14809.7,WellsFargo2,23,3
54,14809.7,191.04,79.97,111.07,14698.63,WellsFargo2,23,3
55,14698.63,191.04,79.37,111.67,14586.96,WellsFargo2,23,3
56,14586.96,191.04,78.77,112.27,14474.69,WellsFargo2,23,3
57,14474.69,191.04,78.16,112.88,14361.81,WellsFargo2,23,3
58,14361.81,191.04,77.55,113.49,14248.32,WellsFargo2,23,3
59,14248.32,191.04,76.94,114.1,14134.22,WellsFargo2,23,3
60,14134.22,191.04,76.32,114.72,14019.5,WellsFargo2,23,3
61,14019.5,191.04,75.71,115.33,13904.17,WellsFargo2,23,3
62,13904.17,191.04,75.08,115.96,13788.21,WellsFargo2,23,3
63,13788.21,191.04,74.46,116.58,13671.63,WellsFargo2,23,3
64,13671.63,191.04,73.83,117.21,13554.42,WellsFargo2,23,3
65,13554.42,191.04,73.19,117.85,13436.57,WellsFargo2,23,3
66,13436.57,191.04,72.56,118.48,13318.09,WellsFargo2,23,3
67,13318.09,191.04,71.92,119.12,13198.97,WellsFargo2,23,3
68,13198.97,191.04,71.27,119.77,13079.2,WellsFargo2,23,3
69,13079.2,191.04,70.63,120.41,12958.79,WellsFargo2,23,3
70,12958.79,191.04,69.98,121.06,12837.73,WellsFargo2,23,3
71,12837.73,191.04,69.32,121.72,12716.01,WellsFargo2,23,3
72,12716.01,191.04,68.67,122.37,12593.64,WellsFargo2,23,3
73,12593.64,191.04,68.01,123.03,12470.61,WellsFargo2,23,3
74,12470.61,191.04,67.34,123.7,12346.91,WellsFargo2,23,3
75,12346.91,191.04,66.67,124.37,12222.54,WellsFargo2,23,3
76,12222.54,191.04,66.0,125.04,12097.5,WellsFargo2,23,3
77,12097.5,191.04,65.33,125.71,11971.79,WellsFargo2,23,3
78,11971.79,191.04,64.65,126.39,11845.4,WellsFargo2,23,3
79,11845.4,191.04,63.97,127.07,11718.33,WellsFargo2,23,3
80,11718.33,191.04,63.28,127.76,11590.57,WellsFargo2,23,3
81,11590.57,191.04,62.59,128.45,11462.12,WellsFargo2,23,3
82,11462.12,191.04,61.9,129.14,11332.98,WellsFargo2,23,3
83,11332.98,191.04,61.2,129.84,11203.14,WellsFargo2,23,3
84,11203.14,191.04,60.5,130.54,11072.6,WellsFargo2,23,3
85,11072.6,191.04,59.79,131.25,10941.35,WellsFargo2,23,3
86,10941.35,191.04,59.08,131.96,10809.39,WellsFargo2,23,3
87,10809.39,191.04,58.37,132.67,10676.72,WellsFargo2,23,3
88,10676.72,1441.66,57.65,1384.01,9292.71,WellsFargo2,23,3
89,9292.71,2592.48,50.18,2542.3,6750.41,WellsFargo2,23,3
90,6750.41,2592.48,36.45,2556.03,4194.38,WellsFargo2,23,3
91,4194.38,2592.48,22.65,2569.83,1624.55,WellsFargo2,23,3
92,1624.55,2592.48,8.77,2583.71,-959.16,WellsFargo2,23,3
0,5000.0,333.0,36.0,297.0,4703.0,Car,23,4
1,4703.0,333.0,33.86,299.14,4403.86,Car,23,4
2,4403.86,333.0,31.71,301.29,4102.57,Car,23,4
3,4102.57,333.0,29.54,303.46,3799.11,Car,23,4
4,3799.11,333.0,27.35,305.65,3493.46,Car,23,4
5,3493.46,333.0,25.15,307.85,3185.61,Car,23,4
6,3185.61,333.0,22.94,310.06,2875.55,Car,23,4
7,2875.55,333.0,20.7,312.3,2563.25,Car,23,4
8,2563.25,333.0,18.46,314.54,2248.71,Car,23,4
9,2248.71,333.0,16.19,316.81,1931.9,Car,23,4
10,1931.9,333.0,13.91,319.09,1612.81,Car,23,4
11,1612.81,333.0,11.61,321.39,1291.42,Car,23,4
12,1291.42,333.0,9.3,323.7,967.72,Car,23,4
13,967.72,333.0,6.97,326.03,641.69,Car,23,4
14,641.69,333.0,4.62,328.38,313.31,Car,23,4
15,313.31,333.0,2.26,330.74,-17.43,Car,23,4
0,8250.57,84.62,53.63,30.99,8219.58,WellsFargo1,23,5
1,8219.58,84.62,53.43,31.19,8188.39,WellsFargo1,23,5
2,8188.39,84.62,53.22,31.4,8156.99,WellsFargo1,23,5
3,8156.99,84.62,53.02,31.6,8125.39,WellsFargo1,23,5
4,8125.39,84.62,52.82,31.8,8093.59,WellsFargo1,23,5
5,8093.59,84.62,52.61,32.01,8061.58,WellsFargo1,23,5
6,8061.58,84.62,52.4,32.22,8029.36,WellsFargo1,23,5
7,8029.36,84.62,52.19,32.43,7996.93,WellsFargo1,23,5
8,7996.93,84.62,51.98,32.64,7964.29,WellsFargo1,23,5
9,7964.29,84.62,51.77,32.85,7931.44,WellsFargo1,23,5
10,7931.44,84.62,51.55,33.07,7898.37,WellsFargo1,23,5
11,7898.37,84.62,51.34,33.28,7865.09,WellsFargo1,23,5
12,7865.09,84.62,51.12,33.5,7831.59,WellsFargo1,23,5
13,7831.59,84.62,50.91,33.71,7797.88,WellsFargo1,23,5
14,7797.88,84.62,50.69,33.93,7763.95,WellsFargo1,23,5
15,7763.95,102.05,50.47,51.58,7712.37,WellsFargo1,23,5
16,7712.37,3010.1,50.13,2959.97,4752.4,WellsFargo1,23,5
17,4752.4,3010.1,30.89,2979.21,1773.19,WellsFargo1,23,5
18,1773.19,3010.1,11.53,2998.57,-1225.38,WellsFargo1,23,5
0,4000.0,1070.0,16.0,1054.0,2946.0,testing,24,1
1,2946.0,1070.0,11.78,1058.22,1887.78,testing,24,1
2,1887.78,1070.0,7.55,1062.45,825.33,testing,24,1
3,825.33,1070.0,3.3,1066.7,-241.37,testing,24,1
0,180000.0,1331.44,594.0,737.44,179262.56,mortgage,24,2
1,179262.56,1331.44,591.57,739.87,178522.69,mortgage,24,2
2,178522.69,1331.44,589.12,742.32,177780.37,mortgage,24,2
3,177780.37,1572.81,586.68,986.13,176794.24,mortgage,24,2
4,176794.24,2401.44,583.42,1818.02,174976.22,mortgage,24,2
5,174976.22,2401.44,577.42,1824.02,173152.2,mortgage,24,2
6,173152.2,2401.44,571.4,1830.04,171322.16,mortgage,24,2
7,171322.16,2401.44,565.36,1836.08,169486.08,mortgage,24,2
8,169486.08,2401.44,559.3,1842.14,167643.94,mortgage,24,2
9,167643.94,2401.44,553.23,1848.21,165795.73,mortgage,24,2
10,165795.73,2401.44,547.13,1854.31,163941.42,mortgage,24,2
11,163941.42,2401.44,541.01,1860.43,162080.99,mortgage,24,2
12,162080.99,2401.44,534.87,1866.57,160214.42,mortgage,24,2
13,160214.42,2401.44,528.71,1872.73,158341.69,mortgage,24,2
14,158341.69,2401.44,522.53,1878.91,156462.78,mortgage,24,2
15,156462.78,2401.44,516.33,1885.11,154577.67,mortgage,24,2
16,154577.67,2401.44,510.11,1891.33,152686.34,mortgage,24,2
17,152686.34,2401.44,503.86,1897.58,150788.76,mortgage,24,2
18,150788.76,2401.44,497.6,1903.84,148884.92,mortgage,24,2
19,148884.92,2401.44,491.32,1910.12,146974.8,mortgage,24,2
20,146974.8,2401.44,485.02,1916.42,145058.38,mortgage,24,2
21,145058.38,2401.44,478.69,1922.75,143135.63,mortgage,24,2
22,143135.63,2401.44,472.35,1929.09,141206.54,mortgage,24,2
23,141206.54,2401.44,465.98,1935.46,139271.08,mortgage,24,2
24,139271.08,2401.44,459.59,1941.85,137329.23,mortgage,24,2
25,137329.23,2401.44,453.19,1948.25,135380.98,mortgage,24,2
26,135380.98,2401.44,446.76,1954.68,133426.3,mortgage,24,2
27,133426.3,2401.44,440.31,1961.13,131465.17,mortgage,24,2
28,131465.17,2401.44,433.84,1967.6,129497.57,mortgage,24,2
29,129497.57,2401.44,427.34,1974.1,127523.47,mortgage,24,2
30,127523.47,2401.44,420.83,1980.61,125542.86,mortgage,24,2
31,125542.86,2401.44,414.29,1987.15,123555.71,mortgage,24,2
32,123555.71,2401.44,407.73,1993.71,121562.0,mortgage,24,2
33,121562.0,2401.44,401.15,2000.29,119561.71,mortgage,24,2
34,119561.71,2401.44,394.55,2006.89,117554.82,mortgage,24,2
35,117554.82,2401.44,387.93,2013.51,115541.31,mortgage,24,2
36,115541.31,2401.44,381.29,2020.15,113521.16,mortgage,24,2
37,113521.16,2401.44,374.62,2026.82,111494.34,mortgage,24,2
38,111494.34,2401.44,367.93,2033.51,109460.83,mortgage,24,2
39,109460.83,2401.44,361.22,2040.22,107420.61,mortgage,24,2
40,107420.61,2401.44,354.49,2046.95,105373.66,mortgage,24,2
41,105373.66,2401.44,347.73,2053.71,103319.95,mortgage,24,2
42,103319.95,2401.44,340.96,2060.48,101259.47,mortgage,24,2
43,101259.47,2401.44,334.16,2067.28,99192.19,mortgage,24,2
44,99192.19,2401.44,327.33,2074.11,97118.08,mortgage,24,2
45,97118.08,2401.44,320.49,2080.95,95037.13,mortgage,24,2
46,95037.13,2401.44,313.62,2087.82,92949.31,mortgage,24,2
47,92949.31,2401.44,306.73,2094.71,90854.6,mortgage,24,2
48,90854.6,2401.44,299.82,2101.62,88752.98,mortgage,24,2
49,88752.98,2401.44,292.88,2108.56,86644.42,mortgage,24,2
50,86644.42,2401.44,285.93,2115.51,84528.91,mortgage,24,2
51,84528.91,2401.44,278.95,2122.49,82406.42,mortgage,24,2
52,82406.42,2401.44,271.94,2129.5,80276.92,mortgage,24,2
53,80276.92,2401.44,264.91,2136.53,78140.39,mortgage,24,2
54,78140.39,2401.44,257.86,2143.58,75996.81,mortgage,24,2
55,75996.81,2401.44,250.79,2150.65,73846.16,mortgage,24,2
56,73846.16,2401.44,243.69,2157.75,71688.41,mortgage,24,2
57,71688.41,2401.44,236.57,2164.87,69523.54,mortgage,24,2
58,69523.54,2401.44,229.43,2172.01,67351.53,mortgage,24,2
59,67351.53,2401.44,222.26,2179.18,65172.35,mortgage,24,2
60,65172.35,2401.44,215.07,2186.37,62985.98,mortgage,24,2
61,62985.98,2401.44,207.85,2193.59,60792.39,mortgage,24,2
62,60792.39,2401.44,200.61,2200.83,58591.56,mortgage,24,2
63,58591.56,2401.44,193.35,2208.09,56383.47,mortgage,24,2
64,56383.47,2401.44,186.07,2215.37,54168.1,mortgage,24,2
65,54168.1,2401.44,178.75,2222.69,51945.41,mortgage,24,2
66,51945.41,2401.44,171.42,2230.02,49715.39,mortgage,24,2
67,49715.39,2401.44,164.06,2237.38,47478.01,mortgage,24,2
68,47478.01,2401.44,156.68,2244.76,45233.25,mortgage,24,2
69,45233.25,2401.44,149.27,2252.17,42981.08,mortgage,24,2
70,42981.08,2401.44,141.84,2259.6,40721.48,mortgage,24,2
71,40721.48,2401.44,134.38,2267.06,38454.42,mortgage,24,2
72,38454.42,2401.44,126.9,2274.54,36179.88,mortgage,24,2
73,36179.88,2401.44,119.39,2282.05,33897.83,mortgage,24,2
74,33897.83,2401.44,111.86,2289.58,31608.25,mortgage,24,2
75,31608.25,2401.44,104.31,2297.13,29311.12,mortgage,24,2
76,29311.12,2401.44,96.73,2304.71,27006.41,mortgage,24,2
77,27006.41,2401.44,89.12,2312.32,24694.09,mortgage,24,2
78,24694.09,2401.44,81.49,2319.95,22374.14,mortgage,24,2
79,22374.14,2401.44,73.83,2327.61,20046.53,mortgage,24,2
80,20046.53,2401.44,66.15,2335.29,17711.24,mortgage,24,2
81,17711.24,2401.44,58.45,2342.99,15368.25,mortgage,24,2
82,15368.25,2401.44,50.72,2350.72,13017.53,mortgage,24,2
83,13017.53,2401.44,42.96,2358.48,10659.05,mortgage,24,2
84,10659.05,2401.44,35.17,2366.27,8292.78,mortgage,24,2
85,8292.78,2401.44,27.37,2374.07,5918.71,mortgage,24,2
86,5918.71,2401.44,19.53,2381.91,3536.8,mortgage,24,2
87,3536.8,2401.44,11.67,2389.77,1147.03,mortgage,24,2
88,1147.03,2401.44,3.79,2397.65,-1250.62,mortgage,24,2
0,20000.0,191.04,108.0,83.04,19916.96,WellsFargo2,24,3
1,19916.96,191.04,107.55,83.49,19833.47,WellsFargo2,24,3
2,19833.47,191.04,107.1,83.94,19749.53,WellsFargo2,24,3
3,19749.53,191.04,106.65,84.39,19665.14,WellsFargo2,24,3
4,19665.14,191.04,106.19,84.85,19580.29,WellsFargo2,24,3
5,19580.29,191.04,105.73,85.31,19494.98,WellsFargo2,24,3
6,19494.98,191.04,105.27,85.77,19409.21,WellsFargo2,24,3
7,19409.21,191.04,104.81,86.23,19322.98,WellsFargo2,24,3
8,19322.98,191.04,104.34,86.7,19236.28,WellsFargo2,24,3
9,19236.28,191.04,103.88,87.16,19149.12,WellsFargo2,24,3
10,19149.12,191.04,103.41,87.63,19061.49,WellsFargo2,24,3
11,19061.49,191.04,102.93,88.11,18973.38,WellsFargo2,24,3
12,18973.38,191.04,102.46,88.58,18884.8,WellsFargo2,24,3
13,18884.8,191.04,101.98,89.06,18795.74,WellsFargo2,24,3
14,18795.74,191.04,101.5,89.54,18706.2,WellsFargo2,24,3
15,18706.2,191.04,101.01,90.03,18616.17,WellsFargo2,24,3
16,18616.17,191.04,100.53,90.51,18525.66,WellsFargo2,24,3
17,18525.66,191.04,100.04,91.0,18434.66,WellsFargo2,24,3
18,18434.66,191.04,99.55,91.49,18343.17,WellsFargo2,24,3
19,18343.17,191.04,99.05,91.99,18251.18,WellsFargo2,24,3
20,18251.18,191.04,98.56,92.48,18158.7,WellsFargo2,24,3
21,18158.7,191.04,98.06,92.98,18065.72,WellsFargo2,24,3
22,18065.72,191.04,97.55,93.49,17972.23,WellsFargo2,24,3
23,17972.23,191.04,97.05,93.99,17878.24,WellsFargo2,24,3
24,17878.24,191.04,96.54,94.5,17783.74,WellsFargo2,24,3
25,17783.74,191.04,96.03,95.01,17688.73,WellsFargo2,24,3
26,17688.73,191.04,95.52,95.52,17593.21,WellsFargo2,24,3
27,17593.21,191.04,95.0,96.04,17497.17,WellsFargo2,24,3
28,17497.17,191.04,94.48,96.56,17400.61,WellsFargo2,24,3
29,17400.61,191.04,93.96,97.08,17303.53,WellsFargo2,24,3
30,17303.53,191.04,93.44,97.6,17205.93,WellsFargo2,24,3
31,17205.93,191.04,92.91,98.13,17107.8,WellsFargo2,24,3
32,17107.8,191.04,92.38,98.66,17009.14,WellsFargo2,24,3
33,17009.14,191.04,91.85,99.19,16909.95,WellsFargo2,24,3
34,16909.95,191.04,91.31,99.73,16810.22,WellsFargo2,24,3
35,16810.22,191.04,90.78,100.26,16709.96,WellsFargo2,24,3
36,16709.96,191.04,90.23,100.81,16609.15,WellsFargo2,24,3
37,16609.15,191.04,89.69,101.35,16507.8,WellsFargo2,24,3
38,16507.8,191.04,89.14,101.9,16405.9,WellsFargo2,24,3
39,16405.9,191.04,88.59,102.45,16303.45,WellsFargo2,24,3
40,16303.45,191.04,88.04,103.0,16200.45,WellsFargo2,24,3
41,16200.45,191.04,87.48,103.56,16096.89,WellsFargo2,24,3
42,16096.89,191.04,86.92,104.12,15992.77,WellsFargo2,24,3
43,15992.77,191.04,86.36,104.68,15888.09,WellsFargo2,24,3
44,15888.09,191.04,85.8,105.24,15782.85,WellsFargo2,24,3
45,15782.85,191.04,85.23,105.81,15677.04,WellsFargo2,24,3
46,15677.04,191.04,84.66,106.38,15570.66,WellsFargo2,24,3
47,15570.66,191.04,84.08,106.96,15463.7,WellsFargo2,24,3
48,15463.7,191.04,83.5,107.54,15356.16,WellsFargo2,24,3
49,15356.16,191.04,82.92,108.12,15248.04,WellsFargo2,24,3
50,15248.04,191.04,82.34,108.7,15139.34,WellsFargo2,24,3
51,15139.34,191.04,81.75,109.29,15030.05,WellsFargo2,24,3
52,15030.05,191.04,81.16,109.88,14920.17,WellsFargo2,24,3
53,14920.17,191.04,80.57,110.47,14809.7,WellsFargo2,24,3
54,14809.7,191.04,79.97,111.07,14698.63,WellsFargo2,24,3
55,14698.63,191.04,79.37,111.67,14586.96,WellsFargo2,24,3
56,14586.96,191.04,78.77,112.27,14474.69,WellsFargo2,24,3
57,14474.69,191.04,78.16,112.88,14361.81,WellsFargo2,24,3
58,14361.81,191.04,77.55,113.49,14248.32,WellsFargo2,24,3
59,14248.32,191.04,76.94,114.1,14134.22,WellsFargo2,24,3
60,14134.22,191.04,76.32,114.72,14019.5,WellsFargo2,24,3
61,14019.5,191.04,75.71,115.33,13904.17,WellsFargo2,24,3
62,13904.17,191.04,75.08,115.96,13788.21,WellsFargo2,24,3
63,13788.21,191.04,74.46,116.58,13671.63,WellsFargo2,24,3
64,13671.63,191.04,73.83,117.21,13554.42,WellsFargo2,24,3
65,13554.42,191.04,73.19,117.85,13436.57,WellsFargo2,24,3
66,13436.57,191.04,72.56,118.48,13318.09,WellsFargo2,24,3
67,13318.09,191.04,71.92,119.12,13198.97,WellsFargo2,24,3
68,13198.97,191.04,71.27,119.77,13079.2,WellsFargo2,24,3
69,13079.2,191.04,70.63,120.41,12958.79,WellsFargo2,24,3
70,12958.79,191.04,69.98,121.06,12837.73,WellsFargo2,24,3
71,12837.73,191.04,69.32,121.72,12716.01,WellsFargo2,24,3
72,12716.01,191.04,68.67,122.37,12593.64,WellsFargo2,24,3
73,12593.64,191.04,68.01,123.03,12470.61,WellsFargo2,24,3
74,12470.61,191.04,67.34,123.7,12346.91,WellsFargo2,24,3
75,12346.91,191.04,66.67,124.37,12222.54,WellsFargo2,24,3
76,12222.54,191.04,66.0,125.04,12097.5,WellsFargo2,24,3
77,12097.5,191.04,65.33,125.71,11971.79,WellsFargo2,24,3
78,11971.79,191.04,64.65,126.39,11845.4,WellsFargo2,24,3
79,11845.4,191.04,63.97,127.07,11718.33,WellsFargo2,24,3
80,11718.33,191.04,63.28,127.76,11590.57,WellsFargo2,24,3
81,11590.57,191.04,62.59,128.45,11462.12,WellsFargo2,24,3
82,11462.12,191.04,61.9,129.14,11332.98,WellsFargo2,24,3
83,11332.98,191.04,61.2,129.84,11203.14,WellsFargo2,24,3
84,11203.14,191.04,60.5,130.54,11072.6,WellsFargo2,24,3
85,11072.6,191.04,59.79,131.25,10941.35,WellsFargo2,24,3
86,10941.35,191.04,59.08,131.96,10809.39,WellsFargo2,24,3
87,10809.39,191.04,58.37,132.67,10676.72,WellsFargo2,24,3
88,10676.72,1441.66,57.65,1384.01,9292.71,WellsFargo2,24,3
89,9292.71,2592.48,50.18,2542.3,6750.41,WellsFargo2,24,3
90,6750.41,2592.48,36.45,2556.03,4194.38,WellsFargo2,24,3
91,4194.38,2592.48,22.65,2569.83,1624.55,WellsFargo2,24,3
92,1624.55,2592.48,8.77,2583.71,-959.16,WellsFargo2,24,3
0,8250.57,84.62,53.63,30.99,8219.58,WellsFargo1,24,4
1,8219.58,84.62,53.43,31.19,8188.39,WellsFargo1,24,4
2,8188.39,84.62,53.22,31.4,8156.99,WellsFargo1,24,4
3,8156.99,84.62,53.02,31.6,8125.39,WellsFargo1,24,4
4,8125.39,84.62,52.82,31.8,8093.59,WellsFargo1,24,4
5,8093.59,84.62,52.61,32.01,8061.58,WellsFargo1,24,4
6,8061.58,84.62,52.4,32.22,8029.36,WellsFargo1,24,4
7,8029.36,84.62,52.19,32.43,7996.93,WellsFargo1,24,4
8,7996.93,84.62,51.98,32.64,7964.29,WellsFargo1,24,4
9,7964.29,84.62,51.77,32.85,7931.44,WellsFargo1,24,4
10,7931.44,84.62,51.55,33.07,7898.37,WellsFargo1,24,4
11,7898.37,84.62,51.34,33.28,7865.09,WellsFargo1,24,4
12,7865.09,84.62,51.12,33.5,7831.59,WellsFargo1,24,4
13,7831.59,84.62,50.91,33.71,7797.88,WellsFargo1,24,4
14,7797.88,84.62,50.69,33.93,7763.95,WellsFargo1,24,4
15,7763.95,84.62,50.47,34.15,7729.8,WellsFargo1,24,4
16,7729.8,84.62,50.24,34.38,7695.42,WellsFargo1,24,4
17,7695.42,84.62,50.02,34.6,7660.82,WellsFargo1,24,4
18,7660.82,84.62,49.8,34.82,7626.0,WellsFargo1,24,4
19,7626.0,84.62,49.57,35.05,7590.95,WellsFargo1,24,4
20,7590.95,84.62,49.34,35.28,7555.67,WellsFargo1,24,4
21,7555.67,84.62,49.11,35.51,7520.16,WellsFargo1,24,4
22,7520.16,84.62,48.88,35.74,7484.42,WellsFargo1,24,4
23,7484.42,84.62,48.65,35.97,7448.45,WellsFargo1,24,4
24,7448.45,84.62,48.41,36.21,7412.24,WellsFargo1,24,4
25,7412.24,84.62,48.18,36.44,7375.8,WellsFargo1,24,4
26,7375.8,84.62,47.94,36.68,7339.12,WellsFargo1,24,4
27,7339.12,84.62,47.7,36.92,7302.2,WellsFargo1,24,4
28,7302.2,84.62,47.46,37.16,7265.04,WellsFargo1,24,4
29,7265.04,84.62,47.22,37.4,7227.64,WellsFargo1,24,4
30,7227.64,84.62,46.98,37.64,7190.0,WellsFargo1,24,4
31,7190.0,84.62,46.73,37.89,7152.11,WellsFargo1,24,4
32,7152.11,84.62,46.49,38.13,7113.98,WellsFargo1,24,4
33,7113.98,84.62,46.24,38.38,7075.6,WellsFargo1,24,4
34,7075.6,84.62,45.99,38.63,7036.97,WellsFargo1,24,4
35,7036.97,84.62,45.74,38.88,6998.09,WellsFargo1,24,4
36,6998.09,84.62,45.49,39.13,6958.96,WellsFargo1,24,4
37,6958.96,84.62,45.23,39.39,6919.57,WellsFargo1,24,4
38,6919.57,84.62,44.98,39.64,6879.93,WellsFargo1,24,4
39,6879.93,84.62,44.72,39.9,6840.03,WellsFargo1,24,4
40,6840.03,84.62,44.46,40.16,6799.87,WellsFargo1,24,4
41,6799.87,84.62,44.2,40.42,6759.45,WellsFargo1,24,4
42,6759.45,84.62,43.94,40.68,6718.77,WellsFargo1,24,4
43,6718.77,84.62,43.67,40.95,6677.82,WellsFargo1,24,4
44,6677.82,84.62,43.41,41.21,6636.61,WellsFargo1,24,4
45,6636.61,84.62,43.14,41.48,6595.13,WellsFargo1,24,4
46,6595.13,84.62,42.87,41.75,6553.38,WellsFargo1,24,4
47,6553.38,84.62,42.6,42.02,6511.36,WellsFargo1,24,4
48,6511.36,84.62,42.32,42.3,6469.06,WellsFargo1,24,4
49,6469.06,84.62,42.05,42.57,6426.49,WellsFargo1,24,4
50,6426.49,84.62,41.77,42.85,6383.64,WellsFargo1,24,4
51,6383.64,84.62,41.49,43.13,6340.51,WellsFargo1,24,4
52,6340.51,84.62,41.21,43.41,6297.1,WellsFargo1,24,4
53,6297.1,84.62,40.93,43.69,6253.41,WellsFargo1,24,4
54,6253.41,84.62,40.65,43.97,6209.44,WellsFargo1,24,4
55,6209.44,84.62,40.36,44.26,6165.18,WellsFargo1,24,4
56,6165.18,84.62,40.07,44.55,6120.63,WellsFargo1,24,4
57,6120.63,84.62,39.78,44.84,6075.79,WellsFargo1,24,4
58,6075.79,84.62,39.49,45.13,6030.66,WellsFargo1,24,4
59,6030.66,84.62,39.2,45.42,5985.24,WellsFargo1,24,4
60,5985.24,84.62,38.9,45.72,5939.52,WellsFargo1,24,4
61,5939.52,84.62,38.61,46.01,5893.51,WellsFargo1,24,4
62,5893.51,84.62,38.31,46.31,5847.2,WellsFargo1,24,4
63,5847.2,84.62,38.01,46.61,5800.59,WellsFargo1,24,4
64,5800.59,84.62,37.7,46.92,5753.67,WellsFargo1,24,4
65,5753.67,84.62,37.4,47.22,5706.45,WellsFargo1,24,4
66,5706.45,84.62,37.09,47.53,5658.92,WellsFargo1,24,4
67,5658.92,84.62,36.78,47.84,5611.08,WellsFargo1,24,4
68,5611.08,84.62,36.47,48.15,5562.93,WellsFargo1,24,4
69,5562.93,84.62,36.16,48.46,5514.47,WellsFargo1,24,4
70,5514.47,84.62,35.84,48.78,5465.69,WellsFargo1,24,4
71,5465.69,84.62,35.53,49.09,5416.6,WellsFargo1,24,4
72,5416.6,84.62,35.21,49.41,5367.19,WellsFargo1,24,4
73,5367.19,84.62,34.89,49.73,5317.46,WellsFargo1,24,4
74,5317.46,84.62,34.56,50.06,5267.4,WellsFargo1,24,4
75,5267.4,84.62,34.24,50.38,5217.02,WellsFargo1,24,4
76,5217.02,84.62,33.91,50.71,5166.31,WellsFargo1,24,4
77,5166.31,84.62,33.58,51.04,5115.27,WellsFargo1,24,4
78,5115.27,84.62,33.25,51.37,5063.9,WellsFargo1,24,4
79,5063.9,84.62,32.92,51.7,5012.2,WellsFargo1,24,4
80,5012.2,84.62,32.58,52.04,4960.16,WellsFargo1,24,4
81,4960.16,84.62,32.24,52.38,4907.78,WellsFargo1,24,4
82,4907.78,84.62,31.9,52.72,4855.06,WellsFargo1,24,4
83,4855.06,84.62,31.56,53.06,4802.0,WellsFargo1,24,4
84,4802.0,84.62,31.21,53.41,4748.59,WellsFargo1,24,4
85,4748.59,84.62,30.87,53.75,4694.84,WellsFargo1,24,4
86,4694.84,84.62,30.52,54.1,4640.74,WellsFargo1,24,4
87,4640.74,84.62,30.16,54.46,4586.28,WellsFargo1,24,4
88,4586.28,84.62,29.81,54.81,4531.47,WellsFargo1,24,4
89,4531.47,84.62,29.45,55.17,4476.3,WellsFargo1,24,4
90,4476.3,84.62,29.1,55.52,4420.78,WellsFargo1,24,4
91,4420.78,84.62,28.74,55.88,4364.9,WellsFargo1,24,4
92,4364.9,1043.78,28.37,1015.41,3349.49,WellsFargo1,24,4
93,3349.49,2677.1,21.77,2655.33,694.16,WellsFargo1,24,4
94,694.16,2677.1,4.51,2672.59,-1978.43,WellsFargo1,24,4
0,5000.0,333.0,36.0,297.0,4703.0,Car,24,5
1,4703.0,333.0,33.86,299.14,4403.86,Car,24,5
2,4403.86,333.0,31.71,301.29,4102.57,Car,24,5
3,4102.57,333.0,29.54,303.46,3799.11,Car,24,5
4,3799.11,333.0,27.35,305.65,3493.46,Car,24,5
5,3493.46,333.0,25.15,307.85,3185.61,Car,24,5
6,3185.61,333.0,22.94,310.06,2875.55,Car,24,5
7,2875.55,333.0,20.7,312.3,2563.25,Car,24,5
8,2563.25,333.0,18.46,314.54,2248.71,Car,24,5
9,2248.71,333.0,16.19,316.81,1931.9,Car,24,5
10,1931.9,333.0,13.91,319.09,1612.81,Car,24,5
11,1612.81,333.0,11.61,321.39,1291.42,Car,24,5
12,1291.42,333.0,9.3,323.7,967.72,Car,24,5
13,967.72,333.0,6.97,326.03,641.69,Car,24,5
14,641.69,333.0,4.62,328.38,313.31,Car,24,5
15,313.31,333.0,2.26,330.74,-17.43,Car,24,5
0,5000.0,1333.0,36.0,1297.0,3703.0,Car,25,1
1,3703.0,1333.0,26.66,1306.34,2396.66,Car,25,1
2,2396.66,1333.0,17.26,1315.74,1080.92,Car,25,1
3,1080.92,1333.0,7.78,1325.22,-244.3,Car,25,1
0,4000.0,70.0,16.0,54.0,3946.0,testing,25,2
1,3946.0,70.0,15.78,54.22,3891.78,testing,25,2
2,3891.78,70.0,15.57,54.43,3837.35,testing,25,2
3,3837.35,314.3,15.35,298.95,3538.4,testing,25,2
4,3538.4,1403.0,14.15,1388.85,2149.55,testing,25,2
5,2149.55,1403.0,8.6,1394.4,755.15,testing,25,2
6,755.15,1403.0,3.02,1399.98,-644.83,testing,25,2
0,8250.57,84.62,53.63,30.99,8219.58,WellsFargo1,25,3
1,8219.58,84.62,53.43,31.19,8188.39,WellsFargo1,25,3
2,8188.39,84.62,53.22,31.4,8156.99,WellsFargo1,25,3
3,8156.99,84.62,53.02,31.6,8125.39,WellsFargo1,25,3
4,8125.39,84.62,52.82,31.8,8093.59,WellsFargo1,25,3
5,8093.59,84.62,52.61,32.01,8061.58,WellsFargo1,25,3
6,8061.58,729.45,52.4,677.05,7384.53,WellsFargo1,25,3
7,7384.53,1487.62,48.0,1439.62,5944.91,WellsFargo1,25,3
8,5944.91,1487.62,38.64,1448.98,4495.93,WellsFargo1,25,3
9,4495.93,1487.62,29.22,1458.4,3037.53,WellsFargo1,25,3
10,3037.53,1487.62,19.74,1467.88,1569.65,WellsFargo1,25,3
11,1569.65,1487.62,10.2,1477.42,92.23,WellsFargo1,25,3
12,92.23,1487.62,0.6,1487.02,-1394.79,WellsFargo1,25,3
0,20000.0,191.04,108.0,83.04,19916.96,WellsFargo2,25,4
1,19916.96,191.04,107.55,83.49,19833.47,WellsFargo2,25,4
2,19833.47,191.04,107.1,83.94,19749.53,WellsFargo2,25,4
3,19749.53,191.04,106.65,84.39,19665.14,WellsFargo2,25,4
4,19665.14,191.04,106.19,84.85,19580.29,WellsFargo2,25,4
5,19580.29,191.04,105.73,85.31,19494.98,WellsFargo2,25,4
6,19494.98,191.04,105.27,85.77,19409.21,WellsFargo2,25,4
7,19409.21,191.04,104.81,86.23,19322.98,WellsFargo2,25,4
8,19322.98,191.04,104.34,86.7,19236.28,WellsFargo2,25,4
9,19236.28,191.04,103.88,87.16,19149.12,WellsFargo2,25,4
10,19149.12,191.04,103.41,87.63,19061.49,WellsFargo2,25,4
11,19061.49,191.04,102.93,88.11,18973.38,WellsFargo2,25,4
12,18973.38,1585.83,102.46,1483.37,17490.01,WellsFargo2,25,4
13,17490.01,1678.66,94.45,1584.21,15905.8,WellsFargo2,25,4
14,15905.8,1678.66,85.89,1592.77,14313.03,WellsFargo2,25,4
15,14313.03,1678.66,77.29,1601.37,12711.66,WellsFargo2,25,4
16,12711.66,1678.66,68.64,1610.02,11101.64,WellsFargo2,25,4
17,11101.64,1678.66,59.95,1618.71,9482.93,WellsFargo2,25,4
18,9482.93,1678.66,51.21,1627.45,7855.48,WellsFargo2,25,4
19,7855.48,1678.66,42.42,1636.24,6219.24,WellsFargo2,25,4
20,6219.24,1678.66,33.58,1645.08,4574.16,WellsFargo2,25,4
21,4574.16,1678.66,24.7,1653.96,2920.2,WellsFargo2,25,4
22,2920.2,1678.66,15.77,1662.89,1257.31,WellsFargo2,25,4
23,1257.31,1678.66,6.79,1671.87,-414.56,WellsFargo2,25,4
0,180000.0,1331.44,594.0,737.44,179262.56,mortgage,25,5
1,179262.56,1331.44,591.57,739.87,178522.69,mortgage,25,5
2,178522.69,1331.44,589.12,742.32,177780.37,mortgage,25,5
3,177780.37,1331.44,586.68,744.76,177035.61,mortgage,25,5
4,177035.61,1331.44,584.22,747.22,176288.39,mortgage,25,5
5,176288.39,1331.44,581.75,749.69,175538.7,mortgage,25,5
6,175538.7,1331.44,579.28,752.16,174786.54,mortgage,25,5
7,174786.54,1331.44,576.8,754.64,174031.9,mortgage,25,5
8,174031.9,1331.44,574.31,757.13,173274.77,mortgage,25,5
9,173274.77,1331.44,571.81,759.63,172515.14,mortgage,25,5
10,172515.14,1331.44,569.3,762.14,171753.0,mortgage,25,5
11,171753.0,1331.44,566.78,764.66,170988.34,mortgage,25,5
12,170988.34,1331.44,564.26,767.18,170221.16,mortgage,25,5
13,170221.16,1331.44,561.73,769.71,169451.45,mortgage,25,5
14,169451.45,1331.44,559.19,772.25,168679.2,mortgage,25,5
15,168679.2,1331.44,556.64,774.8,167904.4,mortgage,25,5
16,167904.4,1331.44,554.08,777.36,167127.04,mortgage,25,5
17,167127.04,1331.44,551.52,779.92,166347.12,mortgage,25,5
18,166347.12,1331.44,548.95,782.49,165564.63,mortgage,25,5
19,165564.63,1331.44,546.36,785.08,164779.55,mortgage,25,5
20,164779.55,1331.44,543.77,787.67,163991.88,mortgage,25,5
21,163991.88,1331.44,541.17,790.27,163201.61,mortgage,25,5
22,163201.61,1331.44,538.57,792.87,162408.74,mortgage,25,5
23,162408.74,1746.0,535.95,1210.05,161198.69,mortgage,25,5
24,161198.69,3010.1,531.96,2478.14,158720.55,mortgage,25,5
25,158720.55,3010.1,523.78,2486.32,156234.23,mortgage,25,5
26,156234.23,3010.1,515.57,2494.53,153739.7,mortgage,25,5
27,153739.7,3010.1,507.34,2502.76,151236.94,mortgage,25,5
28,151236.94,3010.1,499.08,2511.02,148725.92,mortgage,25,5
29,148725.92,3010.1,490.8,2519.3,146206.62,mortgage,25,5
30,146206.62,3010.1,482.48,2527.62,143679.0,mortgage,25,5
31,143679.0,3010.1,474.14,2535.96,141143.04,mortgage,25,5
32,141143.04,3010.1,465.77,2544.33,138598.71,mortgage,25,5
33,138598.71,3010.1,457.38,2552.72,136045.99,mortgage,25,5
34,136045.99,3010.1,448.95,2561.15,133484.84,mortgage,25,5
35,133484.84,3010.1,440.5,2569.6,130915.24,mortgage,25,5
36,130915.24,3010.1,432.02,2578.08,128337.16,mortgage,25,5
37,128337.16,3010.1,423.51,2586.59,125750.57,mortgage,25,5
38,125750.57,3010.1,414.98,2595.12,123155.45,mortgage,25,5
39,123155.45,3010.1,406.41,2603.69,120551.76,mortgage,25,5
40,120551.76,3010.1,397.82,2612.28,117939.48,mortgage,25,5
41,117939.48,3010.1,389.2,2620.9,115318.58,mortgage,25,5
42,115318.58,3010.1,380.55,2629.55,112689.03,mortgage,25,5
43,112689.03,3010.1,371.87,2638.23,110050.8,mortgage,25,5
44,110050.8,3010.1,363.17,2646.93,107403.87,mortgage,25,5
45,107403.87,3010.1,354.43,2655.67,104748.2,mortgage,25,5
46,104748.2,3010.1,345.67,2664.43,102083.77,mortgage,25,5
47,102083.77,3010.1,336.88,2673.22,99410.55,mortgage,25,5
48,99410.55,3010.1,328.05,2682.05,96728.5,mortgage,25,5
49,96728.5,3010.1,319.2,2690.9,94037.6,mortgage,25,5
50,94037.6,3010.1,310.32,2699.78,91337.82,mortgage,25,5
51,91337.82,3010.1,301.41,2708.69,88629.13,mortgage,25,5
52,88629.13,3010.1,292.48,2717.62,85911.51,mortgage,25,5
53,85911.51,3010.1,283.51,2726.59,83184.92,mortgage,25,5
54,83184.92,3010.1,274.51,2735.59,80449.33,mortgage,25,5
55,80449.33,3010.1,265.48,2744.62,77704.71,mortgage,25,5
56,77704.71,3010.1,256.43,2753.67,74951.04,mortgage,25,5
57,74951.04,3010.1,247.34,2762.76,72188.28,mortgage,25,5
58,72188.28,3010.1,238.22,2771.88,69416.4,mortgage,25,5
59,69416.4,3010.1,229.07,2781.03,66635.37,mortgage,25,5
60,66635.37,3010.1,219.9,2790.2,63845.17,mortgage,25,5
61,63845.17,3010.1,210.69,2799.41,61045.76,mortgage,25,5
62,61045.76,3010.1,201.45,2808.65,58237.11,mortgage,25,5
63,58237.11,3010.1,192.18,2817.92,55419.19,mortgage,25,5
64,55419.19,3010.1,182.88,2827.22,52591.97,mortgage,25,5
65,52591.97,3010.1,173.55,2836.55,49755.42,mortgage,25,5
66,49755.42,3010.1,164.19,2845.91,46909.51,mortgage,25,5
67,46909.51,3010.1,154.8,2855.3,44054.21,mortgage,25,5
68,44054.21,3010.1,145.38,2864.72,41189.49,mortgage,25,5
69,41189.49,3010.1,135.93,2874.17,38315.32,mortgage,25,5
70,38315.32,3010.1,126.44,2883.66,35431.66,mortgage,25,5
71,35431.66,3010.1,116.92,2893.18,32538.48,mortgage,25,5
72,32538.48,3010.1,107.38,2902.72,29635.76,mortgage,25,5
73,29635.76,3010.1,97.8,2912.3,26723.46,mortgage,25,5
74,26723.46,3010.1,88.19,2921.91,23801.55,mortgage,25,5
75,23801.55,3010.1,78.55,2931.55,20870.0,mortgage,25,5
76,20870.0,3010.1,68.87,2941.23,17928.77,mortgage,25,5
77,17928.77,3010.1,59.16,2950.94,14977.83,mortgage,25,5
78,14977.83,3010.1,49.43,2960.67,12017.16,mortgage,25,5
79,12017.16,3010.1,39.66,2970.44,9046.72,mortgage,25,5
80,9046.72,3010.1,29.85,2980.25,6066.47,mortgage,25,5
81,6066.47,3010.1,20.02,2990.08,3076.39,mortgage,25,5
82,3076.39,3010.1,10.15,2999.95,76.44,mortgage,25,5
83,76.44,3010.1,0.25,3009.85,-2933.41,mortgage,25,5
0,5000.0,1333.0,36.0,1297.0,3703.0,Car,26,1
1,3703.0,1333.0,26.66,1306.34,2396.66,Car,26,1
2,2396.66,1333.0,17.26,1315.74,1080.92,Car,26,1
3,1080.92,1333.0,7.78,1325.22,-244.3,Car,26,1
0,4000.0,70.0,16.0,54.0,3946.0,testing,26,2
1,3946.0,70.0,15.78,54.22,3891.78,testing,26,2
2,3891.78,70.0,15.57,54.43,3837.35,testing,26,2
3,3837.35,314.3,15.35,298.95,3538.4,testing,26,2
4,3538.4,1403.0,14.15,1388.85,2149.55,testing,26,2
5,2149.55,1403.0,8.6,1394.4,755.15,testing,26,2
6,755.15,1403.0,3.02,1399.98,-644.83,testing,26,2
0,8250.57,84.62,53.63,30.99,8219.58,WellsFargo1,26,3
1,8219.58,84.62,53.43,31.19,8188.39,WellsFargo1,26,3
2,8188.39,84.62,53.22,31.4,8156.99,WellsFargo1,26,3
3,8156.99,84.62,53.02,31.6,8125.39,WellsFargo1,26,3
4,8125.39,84.62,52.82,31.8,8093.59,WellsFargo1,26,3
5,8093.59,84.62,52.61,32.01,8061.58,WellsFargo1,26,3
6,8061.58,729.45,52.4,677.05,7384.53,WellsFargo1,26,3
7,7384.53,1487.62,48.0,1439.62,5944.91,WellsFargo1,26,3
8,5944.91,1487.62,38.64,1448.98,4495.93,WellsFargo1,26,3
9,4495.93,1487.62,29.22,1458.4,3037.53,WellsFargo1,26,3
10,3037.53,1487.62,19.74,1467.88,1569.65,WellsFargo1,26,3
11,1569.65,1487.62,10.2,1477.42,92.23,WellsFargo1,26,3
12,92.23,1487.62,0.6,1487.02,-1394.79,WellsFargo1,26,3
0,180000.0,1331.44,594.0,737.44,179262.56,mortgage,26,4
1,179262.56,1331.44,591.57,739.87,178522.69,mortgage,26,4
2,178522.69,1331.44,589.12,742.32,177780.37,mortgage,26,4
3,177780.37,1331.44,586.68,744.76,177035.61,mortgage,26,4
4,177035.61,1331.44,584.22,747.22,176288.39,mortgage,26,4
5,176288.39,1331.44,581.75,749.69,175538.7,mortgage,26,4
6,175538.7,1331.44,579.28,752.16,174786.54,mortgage,26,4
7,174786.54,1331.44,576.8,754.64,174031.9,mortgage,26,4
8,174031.9,1331.44,574.31,757.13,173274.77,mortgage,26,4
9,173274.77,1331.44,571.81,759.63,172515.14,mortgage,26,4
10,172515.14,1331.44,569.3,762.14,171753.0,mortgage,26,4
11,171753.0,1331.44,566.78,764.66,170988.34,mortgage,26,4
12,170988.34,2726.23,564.26,2161.97,168826.37,mortgage,26,4
13,168826.37,2819.06,557.13,2261.93,166564.44,mortgage,26,4
14,166564.44,2819.06,549.66,2269.4,164295.04,mortgage,26,4
15,164295.04,2819.06,542.17,2276.89,162018.15,mortgage,26,4
16,162018.15,2819.06,534.66,2284.4,159733.75,mortgage,26,4
17,159733.75,2819.06,527.12,2291.94,157441.81,mortgage,26,4
18,157441.81,2819.06,519.56,2299.5,155142.31,mortgage,26,4
19,155142.31,2819.06,511.97,2307.09,152835.22,mortgage,26,4
20,152835.22,2819.06,504.36,2314.7,150520.52,mortgage,26,4
21,150520.52,2819.06,496.72,2322.34,148198.18,mortgage,26,4
22,148198.18,2819.06,489.05,2330.01,145868.17,mortgage,26,4
23,145868.17,2819.06,481.36,2337.7,143530.47,mortgage,26,4
24,143530.47,2819.06,473.65,2345.41,141185.06,mortgage,26,4
25,141185.06,2819.06,465.91,2353.15,138831.91,mortgage,26,4
26,138831.91,2819.06,458.15,2360.91,136471.0,mortgage,26,4
27,136471.0,2819.06,450.35,2368.71,134102.29,mortgage,26,4
28,134102.29,2819.06,442.54,2376.52,131725.77,mortgage,26,4
29,131725.77,2819.06,434.7,2384.36,129341.41,mortgage,26,4
30,129341.41,2819.06,426.83,2392.23,126949.18,mortgage,26,4
31,126949.18,2819.06,418.93,2400.13,124549.05,mortgage,26,4
32,124549.05,2819.06,411.01,2408.05,122141.0,mortgage,26,4
33,122141.0,2819.06,403.07,2415.99,119725.01,mortgage,26,4
34,119725.01,2819.06,395.09,2423.97,117301.04,mortgage,26,4
35,117301.04,2819.06,387.09,2431.97,114869.07,mortgage,26,4
36,114869.07,2819.06,379.07,2439.99,112429.08,mortgage,26,4
37,112429.08,2819.06,371.02,2448.04,109981.04,mortgage,26,4
38,109981.04,2819.06,362.94,2456.12,107524.92,mortgage,26,4
39,107524.92,2819.06,354.83,2464.23,105060.69,mortgage,26,4
40,105060.69,2819.06,346.7,2472.36,102588.33,mortgage,26,4
41,102588.33,2819.06,338.54,2480.52,100107.81,mortgage,26,4
42,100107.81,2819.06,330.36,2488.7,97619.11,mortgage,26,4
43,97619.11,2819.06,322.14,2496.92,95122.19,mortgage,26,4
44,95122.19,2819.06,313.9,2505.16,92617.03,mortgage,26,4
45,92617.03,2819.06,305.64,2513.42,90103.61,mortgage,26,4
46,90103.61,2819.06,297.34,2521.72,87581.89,mortgage,26,4
47,87581.89,2819.06,289.02,2530.04,85051.85,mortgage,26,4
48,85051.85,2819.06,280.67,2538.39,82513.46,mortgage,26,4
49,82513.46,2819.06,272.29,2546.77,79966.69,mortgage,26,4
50,79966.69,2819.06,263.89,2555.17,77411.52,mortgage,26,4
51,77411.52,2819.06,255.46,2563.6,74847.92,mortgage,26,4
52,74847.92,2819.06,247.0,2572.06,72275.86,mortgage,26,4
53,72275.86,2819.06,238.51,2580.55,69695.31,mortgage,26,4
54,69695.31,2819.06,229.99,2589.07,67106.24,mortgage,26,4
55,67106.24,2819.06,221.45,2597.61,64508.63,mortgage,26,4
56,64508.63,2819.06,212.88,2606.18,61902.45,mortgage,26,4
57,61902.45,2819.06,204.28,2614.78,59287.67,mortgage,26,4
58,59287.67,2819.06,195.65,2623.41,56664.26,mortgage,26,4
59,56664.26,2819.06,186.99,2632.07,54032.19,mortgage,26,4
60,54032.19,2819.06,178.31,2640.75,51391.44,mortgage,26,4
61,51391.44,2819.06,169.59,2649.47,48741.97,mortgage,26,4
62,48741.97,2819.06,160.85,2658.21,46083.76,mortgage,26,4
63,46083.76,2819.06,152.08,2666.98,43416.78,mortgage,26,4
64,43416.78,2819.06,143.28,2675.78,40741.0,mortgage,26,4
65,40741.0,2819.06,134.45,2684.61,38056.39,mortgage,26,4
66,38056.39,2819.06,125.59,2693.47,35362.92,mortgage,26,4
67,35362.92,2819.06,116.7,2702.36,32660.56,mortgage,26,4
68,32660.56,2819.06,107.78,2711.28,29949.28,mortgage,26,4
69,29949.28,2819.06,98.83,2720.23,27229.05,mortgage,26,4
70,27229.05,2819.06,89.86,2729.2,24499.85,mortgage,26,4
71,24499.85,2819.06,80.85,2738.21,21761.64,mortgage,26,4
72,21761.64,2819.06,71.81,2747.25,19014.39,mortgage,26,4
73,19014.39,2819.06,62.75,2756.31,16258.08,mortgage,26,4
74,16258.08,2819.06,53.65,2765.41,13492.67,mortgage,26,4
75,13492.67,2819.06,44.53,2774.53,10718.14,mortgage,26,4
76,10718.14,2819.06,35.37,2783.69,7934.45,mortgage,26,4
77,7934.45,2819.06,26.18,2792.88,5141.57,mortgage,26,4
78,5141.57,2819.06,16.97,2802.09,2339.48,mortgage,26,4
79,2339.48,2819.06,7.72,2811.34,-471.86,mortgage,26,4
0,20000.0,191.04,108.0,83.04,19916.96,WellsFargo2,26,5
1,19916.96,191.04,107.55,83.49,19833.47,WellsFargo2,26,5
2,19833.47,191.04,107.1,83.94,19749.53,WellsFargo2,26,5
3,19749.53,191.04,106.65,84.39,19665.14,WellsFargo2,26,5
4,19665.14,191.04,106.19,84.85,19580.29,WellsFargo2,26,5
5,19580.29,191.04,105.73,85.31,19494.98,WellsFargo2,26,5
6,19494.98,191.04,105.27,85.77,19409.21,WellsFargo2,26,5
7,19409.21,191.04,104.81,86.23,19322.98,WellsFargo2,26,5
8,19322.98,191.04,104.34,86.7,19236.28,WellsFargo2,26,5
9,19236.28,191.04,103.88,87.16,19149.12,WellsFargo2,26,5
10,19149.12,191.04,103.41,87.63,19061.49,WellsFargo2,26,5
11,19061.49,191.04,102.93,88.11,18973.38,WellsFargo2,26,5
12,18973.38,191.04,102.46,88.58,18884.8,WellsFargo2,26,5
13,18884.8,191.04,101.98,89.06,18795.74,WellsFargo2,26,5
14,18795.74,191.04,101.5,89.54,18706.2,WellsFargo2,26,5
15,18706.2,191.04,101.01,90.03,18616.17,WellsFargo2,26,5
16,18616.17,191.04,100.53,90.51,18525.66,WellsFargo2,26,5
17,18525.66,191.04,100.04,91.0,18434.66,WellsFargo2,26,5
18,18434.66,191.04,99.55,91.49,18343.17,WellsFargo2,26,5
19,18343.17,191.04,99.05,91.99,18251.18,WellsFargo2,26,5
20,18251.18,191.04,98.56,92.48,18158.7,WellsFargo2,26,5
21,18158.7,191.04,98.06,92.98,18065.72,WellsFargo2,26,5
22,18065.72,191.04,97.55,93.49,17972.23,WellsFargo2,26,5
23,17972.23,191.04,97.05,93.99,17878.24,WellsFargo2,26,5
24,17878.24,191.04,96.54,94.5,17783.74,WellsFargo2,26,5
25,17783.74,191.04,96.03,95.01,17688.73,WellsFargo2,26,5
26,17688.73,191.04,95.52,95.52,17593.21,WellsFargo2,26,5
27,17593.21,191.04,95.0,96.04,17497.17,WellsFargo2,26,5
28,17497.17,191.04,94.48,96.56,17400.61,WellsFargo2,26,5
29,17400.61,191.04,93.96,97.08,17303.53,WellsFargo2,26,5
30,17303.53,191.04,93.44,97.6,17205.93,WellsFargo2,26,5
31,17205.93,191.04,92.91,98.13,17107.8,WellsFargo2,26,5
32,17107.8,191.04,92.38,98.66,17009.14,WellsFargo2,26,5
33,17009.14,191.04,91.85,99.19,16909.95,WellsFargo2,26,5
34,16909.95,191.04,91.31,99.73,16810.22,WellsFargo2,26,5
35,16810.22,191.04,90.78,100.26,16709.96,WellsFargo2,26,5
36,16709.96,191.04,90.23,100.81,16609.15,WellsFargo2,26,5
37,16609.15,191.04,89.69,101.35,16507.8,WellsFargo2,26,5
38,16507.8,191.04,89.14,101.9,16405.9,WellsFargo2,26,5
39,16405.9,191.04,88.59,102.45,16303.45,WellsFargo2,26,5
40,16303.45,191.04,88.04,103.0,16200.45,WellsFargo2,26,5
41,16200.45,191.04,87.48,103.56,16096.89,WellsFargo2,26,5
42,16096.89,191.04,86.92,104.12,15992.77,WellsFargo2,26,5
43,15992.77,191.04,86.36,104.68,15888.09,WellsFargo2,26,5
44,15888.09,191.04,85.8,105.24,15782.85,WellsFargo2,26,5
45,15782.85,191.04,85.23,105.81,15677.04,WellsFargo2,26,5
46,15677.04,191.04,84.66,106.38,15570.66,WellsFargo2,26,5
47,15570.66,191.04,84.08,106.96,15463.7,WellsFargo2,26,5
48,15463.7,191.04,83.5,107.54,15356.16,WellsFargo2,26,5
49,15356.16,191.04,82.92,108.12,15248.04,WellsFargo2,26,5
50,15248.04,191.04,82.34,108.7,15139.34,WellsFargo2,26,5
51,15139.34,191.04,81.75,109.29,15030.05,WellsFargo2,26,5
52,15030.05,191.04,81.16,109.88,14920.17,WellsFargo2,26,5
53,14920.17,191.04,80.57,110.47,14809.7,WellsFargo2,26,5
54,14809.7,191.04,79.97,111.07,14698.63,WellsFargo2,26,5
55,14698.63,191.04,79.37,111.67,14586.96,WellsFargo2,26,5
56,14586.96,191.04,78.77,112.27,14474.69,WellsFargo2,26,5
57,14474.69,191.04,78.16,112.88,14361.81,WellsFargo2,26,5
58,14361.81,191.04,77.55,113.49,14248.32,WellsFargo2,26,5
59,14248.32,191.04,76.94,114.1,14134.22,WellsFargo2,26,5
60,14134.22,191.04,76.32,114.72,14019.5,WellsFargo2,26,5
61,14019.5,191.04,75.71,115.33,13904.17,WellsFargo2,26,5
62,13904.17,191.04,75.08,115.96,13788.21,WellsFargo2,26,5
63,13788.21,191.04,74.46,116.58,13671.63,WellsFargo2,26,5
64,13671.63,191.04,73.83,117.21,13554.42,WellsFargo2,26,5
65,13554.42,191.04,73.19,117.85,13436.57,WellsFargo2,26,5
66,13436.57,191.04,72.56,118.48,13318.09,WellsFargo2,26,5
67,13318.09,191.04,71.92,119.12,13198.97,WellsFargo2,26,5
68,13198.97,191.04,71.27,119.77,13079.2,WellsFargo2,26,5
69,13079.2,191.04,70.63,120.41,12958.79,WellsFargo2,26,5
70,12958.79,191.04,69.98,121.06,12837.73,WellsFargo2,26,5
71,12837.73,191.04,69.32,121.72,12716.01,WellsFargo2,26,5
72,12716.01,191.04,68.67,122.37,12593.64,WellsFargo2,26,5
73,12593.64,191.04,68.01,123.03,12470.61,WellsFargo2,26,5
74,12470.61,191.04,67.34,123.7,12346.91,WellsFargo2,26,5
75,12346.91,191.04,66.67,124.37,12222.54,WellsFargo2,26,5
76,12222.54,191.04,66.0,125.04,12097.5,WellsFargo2,26,5
77,12097.5,191.04,65.33,125.71,11971.79,WellsFargo2,26,5
78,11971.79,191.04,64.65,126.39,11845.4,WellsFargo2,26,5
79,11845.4,662.9,63.97,598.93,11246.47,WellsFargo2,26,5
80,11246.47,3010.1,60.73,2949.37,8297.1,WellsFargo2,26,5
81,8297.1,3010.1,44.8,2965.3,5331.8,WellsFargo2,26,5
82,5331.8,3010.1,28.79,2981.31,2350.49,WellsFargo2,26,5
83,2350.49,3010.1,12.69,2997.41,-646.92,WellsFargo2,26,5
0,5000.0,1333.0,36.0,1297.0,3703.0,Car,27,1
1,3703.0,1333.0,26.66,1306.34,2396.66,Car,27,1
2,2396.66,1333.0,17.26,1315.74,1080.92,Car,27,1
3,1080.92,1333.0,7.78,1325.22,-244.3,Car,27,1
0,4000.0,70.0,16.0,54.0,3946.0,testing,27,2
1,3946.0,70.0,15.78,54.22,3891.78,testing,27,2
2,3891.78,70.0,15.57,54.43,3837.35,testing,27,2
3,3837.35,314.3,15.35,298.95,3538.4,testing,27,2
4,3538.4,1403.0,14.15,1388.85,2149.55,testing,27,2
5,2149.55,1403.0,8.6,1394.4,755.15,testing,27,2
6,755.15,1403.0,3.02,1399.98,-644.83,testing,27,2
0,20000.0,191.04,108.0,83.04,19916.96,WellsFargo2,27,3
1,19916.96,191.04,107.55,83.49,19833.47,WellsFargo2,27,3
2,19833.47,191.04,107.1,83.94,19749.53,WellsFargo2,27,3
3,19749.53,191.04,106.65,84.39,19665.14,WellsFargo2,27,3
4,19665.14,191.04,106.19,84.85,19580.29,WellsFargo2,27,3
5,19580.29,191.04,105.73,85.31,19494.98,WellsFargo2,27,3
6,19494.98,835.87,105.27,730.6,18764.38,WellsFargo2,27,3
7,18764.38,1594.04,101.33,1492.71,17271.67,WellsFargo2,27,3
8,17271.67,1594.04,93.27,1500.77,15770.9,WellsFargo2,27,3
9,15770.9,1594.04,85.16,1508.88,14262.02,WellsFargo2,27,3
10,14262.02,1594.04,77.01,1517.03,12744.99,WellsFargo2,27,3
11,12744.99,1594.04,68.82,1525.22,11219.77,WellsFargo2,27,3
12,11219.77,1594.04,60.59,1533.45,9686.32,WellsFargo2,27,3
13,9686.32,1594.04,52.31,1541.73,8144.59,WellsFargo2,27,3
14,8144.59,1594.04,43.98,1550.06,6594.53,WellsFargo2,27,3
15,6594.53,1594.04,35.61,1558.43,5036.1,WellsFargo2,27,3
16,5036.1,1594.04,27.19,1566.85,3469.25,WellsFargo2,27,3
17,3469.25,1594.04,18.73,1575.31,1893.94,WellsFargo2,27,3
18,1893.94,1594.04,10.23,1583.81,310.13,WellsFargo2,27,3
19,310.13,1594.04,1.67,1592.37,-1282.24,WellsFargo2,27,3
0,8250.57,84.62,53.63,30.99,8219.58,WellsFargo1,27,4
1,8219.58,84.62,53.43,31.19,8188.39,WellsFargo1,27,4
2,8188.39,84.62,53.22,31.4,8156.99,WellsFargo1,27,4
3,8156.99,84.62,53.02,31.6,8125.39,WellsFargo1,27,4
4,8125.39,84.62,52.82,31.8,8093.59,WellsFargo1,27,4
5,8093.59,84.62,52.61,32.01,8061.58,WellsFargo1,27,4
6,8061.58,84.62,52.4,32.22,8029.36,WellsFargo1,27,4
7,8029.36,84.62,52.19,32.43,7996.93,WellsFargo1,27,4
8,7996.93,84.62,51.98,32.64,7964.29,WellsFargo1,27,4
9,7964.29,84.62,51.77,32.85,7931.44,WellsFargo1,27,4
10,7931.44,84.62,51.55,33.07,7898.37,WellsFargo1,27,4
11,7898.37,84.62,51.34,33.28,7865.09,WellsFargo1,27,4
12,7865.09,84.62,51.12,33.5,7831.59,WellsFargo1,27,4
13,7831.59,84.62,50.91,33.71,7797.88,WellsFargo1,27,4
14,7797.88,84.62,50.69,33.93,7763.95,WellsFargo1,27,4
15,7763.95,84.62,50.47,34.15,7729.8,WellsFargo1,27,4
16,7729.8,84.62,50.24,34.38,7695.42,WellsFargo1,27,4
17,7695.42,84.62,50.02,34.6,7660.82,WellsFargo1,27,4
18,7660.82,84.62,49.8,34.82,7626.0,WellsFargo1,27,4
19,7626.0,1366.86,49.57,1317.29,6308.71,WellsFargo1,27,4
20,6308.71,1678.66,41.01,1637.65,4671.06,WellsFargo1,27,4
21,4671.06,1678.66,30.36,1648.3,3022.76,WellsFargo1,27,4
22,3022.76,1678.66,19.65,1659.01,1363.75,WellsFargo1,27,4
23,1363.75,1678.66,8.86,1669.8,-306.05,WellsFargo1,27,4
0,180000.0,1331.44,594.0,737.44,179262.56,mortgage,27,5
1,179262.56,1331.44,591.57,739.87,178522.69,mortgage,27,5
2,178522.69,1331.44,589.12,742.32,177780.37,mortgage,27,5
3,177780.37,1331.44,586.68,744.76,177035.61,mortgage,27,5
4,177035.61,1331.44,584.22,747.22,176288.39,mortgage,27,5
5,176288.39,1331.44,581.75,749.69,175538.7,mortgage,27,5
6,175538.7,1331.44,579.28,752.16,174786.54,mortgage,27,5
7,174786.54,1331.44,576.8,754.64,174031.9,mortgage,27,5
8,174031.9,1331.44,574.31,757.13,173274.77,mortgage,27,5
9,173274.77,1331.44,571.81,759.63,172515.14,mortgage,27,5
10,172515.14,1331.44,569.3,762.14,171753.0,mortgage,27,5
11,171753.0,1331.44,566.78,764.66,170988.34,mortgage,27,5
12,170988.34,1331.44,564.26,767.18,170221.16,mortgage,27,5
13,170221.16,1331.44,561.73,769.71,169451.45,mortgage,27,5
14,169451.45,1331.44,559.19,772.25,168679.2,mortgage,27,5
15,168679.2,1331.44,556.64,774.8,167904.4,mortgage,27,5
16,167904.4,1331.44,554.08,777.36,167127.04,mortgage,27,5
17,167127.04,1331.44,551.52,779.92,166347.12,mortgage,27,5
18,166347.12,1331.44,548.95,782.49,165564.63,mortgage,27,5
19,165564.63,1331.44,546.36,785.08,164779.55,mortgage,27,5
20,164779.55,1331.44,543.77,787.67,163991.88,mortgage,27,5
21,163991.88,1331.44,541.17,790.27,163201.61,mortgage,27,5
22,163201.61,1331.44,538.57,792.87,162408.74,mortgage,27,5
23,162408.74,1637.49,535.95,1101.54,161307.2,mortgage,27,5
24,161307.2,3010.1,532.31,2477.79,158829.41,mortgage,27,5
25,158829.41,3010.1,524.14,2485.96,156343.45,mortgage,27,5
26,156343.45,3010.1,515.93,2494.17,153849.28,mortgage,27,5
27,153849.28,3010.1,507.7,2502.4,151346.88,mortgage,27,5
28,151346.88,3010.1,499.44,2510.66,148836.22,mortgage,27,5
29,148836.22,3010.1,491.16,2518.94,146317.28,mortgage,27,5
30,146317.28,3010.1,482.85,2527.25,143790.03,mortgage,27,5
31,143790.03,3010.1,474.51,2535.59,141254.44,mortgage,27,5
32,141254.44,3010.1,466.14,2543.96,138710.48,mortgage,27,5
33,138710.48,3010.1,457.74,2552.36,136158.12,mortgage,27,5
34,136158.12,3010.1,449.32,2560.78,133597.34,mortgage,27,5
35,133597.34,3010.1,440.87,2569.23,131028.11,mortgage,27,5
36,131028.11,3010.1,432.39,2577.71,128450.4,mortgage,27,5
37,128450.4,3010.1,423.89,2586.21,125864.19,mortgage,27,5
38,125864.19,3010.1,415.35,2594.75,123269.44,mortgage,27,5
39,123269.44,3010.1,406.79,2603.31,120666.13,mortgage,27,5
40,120666.13,3010.1,398.2,2611.9,118054.23,mortgage,27,5
41,118054.23,3010.1,389.58,2620.52,115433.71,mortgage,27,5
42,115433.71,3010.1,380.93,2629.17,112804.54,mortgage,27,5
43,112804.54,3010.1,372.25,2637.85,110166.69,mortgage,27,5
44,110166.69,3010.1,363.55,2646.55,107520.14,mortgage,27,5
45,107520.14,3010.1,354.82,2655.28,104864.86,mortgage,27,5
46,104864.86,3010.1,346.05,2664.05,102200.81,mortgage,27,5
47,102200.81,3010.1,337.26,2672.84,99527.97,mortgage,27,5
48,99527.97,3010.1,328.44,2681.66,96846.31,mortgage,27,5
49,96846.31,3010.1,319.59,2690.51,94155.8,mortgage,27,5
50,94155.8,3010.1,310.71,2699.39,91456.41,mortgage,27,5
51,91456.41,3010.1,301.81,2708.29,88748.12,mortgage,27,5
52,88748.12,3010.1,292.87,2717.23,86030.89,mortgage,27,5
53,86030.89,3010.1,283.9,2726.2,83304.69,mortgage,27,5
54,83304.69,3010.1,274.91,2735.19,80569.5,mortgage,27,5
55,80569.5,3010.1,265.88,2744.22,77825.28,mortgage,27,5
56,77825.28,3010.1,256.82,2753.28,75072.0,mortgage,27,5
57,75072.0,3010.1,247.74,2762.36,72309.64,mortgage,27,5
58,72309.64,3010.1,238.62,2771.48,69538.16,mortgage,27,5
59,69538.16,3010.1,229.48,2780.62,66757.54,mortgage,27,5
60,66757.54,3010.1,220.3,2789.8,63967.74,mortgage,27,5
61,63967.74,3010.1,211.09,2799.01,61168.73,mortgage,27,5
62,61168.73,3010.1,201.86,2808.24,58360.49,mortgage,27,5
63,58360.49,3010.1,192.59,2817.51,55542.98,mortgage,27,5
64,55542.98,3010.1,183.29,2826.81,52716.17,mortgage,27,5
65,52716.17,3010.1,173.96,2836.14,49880.03,mortgage,27,5
66,49880.03,3010.1,164.6,2845.5,47034.53,mortgage,27,5
67,47034.53,3010.1,155.21,2854.89,44179.64,mortgage,27,5
68,44179.64,3010.1,145.79,2864.31,41315.33,mortgage,27,5
69,41315.33,3010.1,136.34,2873.76,38441.57,mortgage,27,5
70,38441.57,3010.1,126.86,2883.24,35558.33,mortgage,27,5
71,35558.33,3010.1,117.34,2892.76,32665.57,mortgage,27,5
72,32665.57,3010.1,107.8,2902.3,29763.27,mortgage,27,5
73,29763.27,3010.1,98.22,2911.88,26851.39,mortgage,27,5
74,26851.39,3010.1,88.61,2921.49,23929.9,mortgage,27,5
75,23929.9,3010.1,78.97,2931.13,20998.77,mortgage,27,5
76,20998.77,3010.1,69.3,2940.8,18057.97,mortgage,27,5
77,18057.97,3010.1,59.59,2950.51,15107.46,mortgage,27,5
78,15107.46,3010.1,49.85,2960.25,12147.21,mortgage,27,5
79,12147.21,3010.1,40.09,2970.01,9177.2,mortgage,27,5
80,9177.2,3010.1,30.28,2979.82,6197.38,mortgage,27,5
81,6197.38,3010.1,20.45,2989.65,3207.73,mortgage,27,5
82,3207.73,3010.1,10.59,2999.51,208.22,mortgage,27,5
83,208.22,3010.1,0.69,3009.41,-2801.19,mortgage,27,5
0,5000.0,1333.0,36.0,1297.0,3703.0,Car,28,1
1,3703.0,1333.0,26.66,1306.34,2396.66,Car,28,1
2,2396.66,1333.0,17.26,1315.74,1080.92,Car,28,1
3,1080.92,1333.0,7.78,1325.22,-244.3,Car,28,1
0,4000.0,70.0,16.0,54.0,3946.0,testing,28,2
1,3946.0,70.0,15.78,54.22,3891.78,testing,28,2
2,3891.78,70.0,15.57,54.43,3837.35,testing,28,2
3,3837.35,314.3,15.35,298.95,3538.4,testing,28,2
4,3538.4,1403.0,14.15,1388.85,2149.55,testing,28,2
5,2149.55,1403.0,8.6,1394.4,755.15,testing,28,2
6,755.15,1403.0,3.02,1399.98,-644.83,testing,28,2
0,20000.0,191.04,108.0,83.04,19916.96,WellsFargo2,28,3
1,19916.96,191.04,107.55,83.49,19833.47,WellsFargo2,28,3
2,19833.47,191.04,107.1,83.94,19749.53,WellsFargo2,28,3
3,19749.53,191.04,106.65,84.39,19665.14,WellsFargo2,28,3
4,19665.14,191.04,106.19,84.85,19580.29,WellsFargo2,28,3
5,19580.29,191.04,105.73,85.31,19494.98,WellsFargo2,28,3
6,19494.98,835.87,105.27,730.6,18764.38,WellsFargo2,28,3
7,18764.38,1594.04,101.33,1492.71,17271.67,WellsFargo2,28,3
8,17271.67,1594.04,93.27,1500.77,15770.9,WellsFargo2,28,3
9,15770.9,1594.04,85.16,1508.88,14262.02,WellsFargo2,28,3
10,14262.02,1594.04,77.01,1517.03,12744.99,WellsFargo2,28,3
11,12744.99,1594.04,68.82,1525.22,11219.77,WellsFargo2,28,3
12,11219.77,1594.04,60.59,1533.45,9686.32,WellsFargo2,28,3
13,9686.32,1594.04,52.31,1541.73,8144.59,WellsFargo2,28,3
14,8144.59,1594.04,43.98,1550.06,6594.53,WellsFargo2,28,3
15,6594.53,1594.04,35.61,1558.43,5036.1,WellsFargo2,28,3
16,5036.1,1594.04,27.19,1566.85,3469.25,WellsFargo2,28,3
17,3469.25,1594.04,18.73,1575.31,1893.94,WellsFargo2,28,3
18,1893.94,1594.04,10.23,1583.81,310.13,WellsFargo2,28,3
19,310.13,1594.04,1.67,1592.37,-1282.24,WellsFargo2,28,3
0,180000.0,1331.44,594.0,737.44,179262.56,mortgage,28,4
1,179262.56,1331.44,591.57,739.87,178522.69,mortgage,28,4
2,178522.69,1331.44,589.12,742.32,177780.37,mortgage,28,4
3,177780.37,1331.44,586.68,744.76,177035.61,mortgage,28,4
4,177035.61,1331.44,584.22,747.22,176288.39,mortgage,28,4
5,176288.39,1331.44,581.75,749.69,175538.7,mortgage,28,4
6,175538.7,1331.44,579.28,752.16,174786.54,mortgage,28,4
7,174786.54,1331.44,576.8,754.64,174031.9,mortgage,28,4
8,174031.9,1331.44,574.31,757.13,173274.77,mortgage,28,4
9,173274.77,1331.44,571.81,759.63,172515.14,mortgage,28,4
10,172515.14,1331.44,569.3,762.14,171753.0,mortgage,28,4
11,171753.0,1331.44,566.78,764.66,170988.34,mortgage,28,4
12,170988.34,1331.44,564.26,767.18,170221.16,mortgage,28,4
13,170221.16,1331.44,561.73,769.71,169451.45,mortgage,28,4
14,169451.45,1331.44,559.19,772.25,168679.2,mortgage,28,4
15,168679.2,1331.44,556.64,774.8,167904.4,mortgage,28,4
16,167904.4,1331.44,554.08,777.36,167127.04,mortgage,28,4
17,167127.04,1331.44,551.52,779.92,166347.12,mortgage,28,4
18,166347.12,1331.44,548.95,782.49,165564.63,mortgage,28,4
19,165564.63,2613.68,546.36,2067.32,163497.31,mortgage,28,4
20,163497.31,2925.48,539.54,2385.94,161111.37,mortgage,28,4
21,161111.37,2925.48,531.67,2393.81,158717.56,mortgage,28,4
22,158717.56,2925.48,523.77,2401.71,156315.85,mortgage,28,4
23,156315.85,2925.48,515.84,2409.64,153906.21,mortgage,28,4
24,153906.21,2925.48,507.89,2417.59,151488.62,mortgage,28,4
25,151488.62,2925.48,499.91,2425.57,149063.05,mortgage,28,4
26,149063.05,2925.48,491.91,2433.57,146629.48,mortgage,28,4
27,146629.48,2925.48,483.88,2441.6,144187.88,mortgage,28,4
28,144187.88,2925.48,475.82,2449.66,141738.22,mortgage,28,4
29,141738.22,2925.48,467.74,2457.74,139280.48,mortgage,28,4
30,139280.48,2925.48,459.63,2465.85,136814.63,mortgage,28,4
31,136814.63,2925.48,451.49,2473.99,134340.64,mortgage,28,4
32,134340.64,2925.48,443.32,2482.16,131858.48,mortgage,28,4
33,131858.48,2925.48,435.13,2490.35,129368.13,mortgage,28,4
34,129368.13,2925.48,426.91,2498.57,126869.56,mortgage,28,4
35,126869.56,2925.48,418.67,2506.81,124362.75,mortgage,28,4
36,124362.75,2925.48,410.4,2515.08,121847.67,mortgage,28,4
37,121847.67,2925.48,402.1,2523.38,119324.29,mortgage,28,4
38,119324.29,2925.48,393.77,2531.71,116792.58,mortgage,28,4
39,116792.58,2925.48,385.42,2540.06,114252.52,mortgage,28,4
40,114252.52,2925.48,377.03,2548.45,111704.07,mortgage,28,4
41,111704.07,2925.48,368.62,2556.86,109147.21,mortgage,28,4
42,109147.21,2925.48,360.19,2565.29,106581.92,mortgage,28,4
43,106581.92,2925.48,351.72,2573.76,104008.16,mortgage,28,4
44,104008.16,2925.48,343.23,2582.25,101425.91,mortgage,28,4
45,101425.91,2925.48,334.71,2590.77,98835.14,mortgage,28,4
46,98835.14,2925.48,326.16,2599.32,96235.82,mortgage,28,4
47,96235.82,2925.48,317.58,2607.9,93627.92,mortgage,28,4
48,93627.92,2925.48,308.97,2616.51,91011.41,mortgage,28,4
49,91011.41,2925.48,300.34,2625.14,88386.27,mortgage,28,4
50,88386.27,2925.48,291.67,2633.81,85752.46,mortgage,28,4
51,85752.46,2925.48,282.98,2642.5,83109.96,mortgage,28,4
52,83109.96,2925.48,274.26,2651.22,80458.74,mortgage,28,4
53,80458.74,2925.48,265.51,2659.97,77798.77,mortgage,28,4
54,77798.77,2925.48,256.74,2668.74,75130.03,mortgage,28,4
55,75130.03,2925.48,247.93,2677.55,72452.48,mortgage,28,4
56,72452.48,2925.48,239.09,2686.39,69766.09,mortgage,28,4
57,69766.09,2925.48,230.23,2695.25,67070.84,mortgage,28,4
58,67070.84,2925.48,221.33,2704.15,64366.69,mortgage,28,4
59,64366.69,2925.48,212.41,2713.07,61653.62,mortgage,28,4
60,61653.62,2925.48,203.46,2722.02,58931.6,mortgage,28,4
61,58931.6,2925.48,194.47,2731.01,56200.59,mortgage,28,4
62,56200.59,2925.48,185.46,2740.02,53460.57,mortgage,28,4
63,53460.57,2925.48,176.42,2749.06,50711.51,mortgage,28,4
64,50711.51,2925.48,167.35,2758.13,47953.38,mortgage,28,4
65,47953.38,2925.48,158.25,2767.23,45186.15,mortgage,28,4
66,45186.15,2925.48,149.11,2776.37,42409.78,mortgage,28,4
67,42409.78,2925.48,139.95,2785.53,39624.25,mortgage,28,4
68,39624.25,2925.48,130.76,2794.72,36829.53,mortgage,28,4
69,36829.53,2925.48,121.54,2803.94,34025.59,mortgage,28,4
70,34025.59,2925.48,112.28,2813.2,31212.39,mortgage,28,4
71,31212.39,2925.48,103.0,2822.48,28389.91,mortgage,28,4
72,28389.91,2925.48,93.69,2831.79,25558.12,mortgage,28,4
73,25558.12,2925.48,84.34,2841.14,22716.98,mortgage,28,4
74,22716.98,2925.48,74.97,2850.51,19866.47,mortgage,28,4
75,19866.47,2925.48,65.56,2859.92,17006.55,mortgage,28,4
76,17006.55,2925.48,56.12,2869.36,14137.19,mortgage,28,4
77,14137.19,2925.48,46.65,2878.83,11258.36,mortgage,28,4
78,11258.36,2925.48,37.15,2888.33,8370.03,mortgage,28,4
79,8370.03,2925.48,27.62,2897.86,5472.17,mortgage,28,4
80,5472.17,2925.48,18.06,2907.42,2564.75,mortgage,28,4
81,2564.75,2925.48,8.46,2917.02,-352.27,mortgage,28,4
0,8250.57,84.62,53.63,30.99,8219.58,WellsFargo1,28,5
1,8219.58,84.62,53.43,31.19,8188.39,WellsFargo1,28,5
2,8188.39,84.62,53.22,31.4,8156.99,WellsFargo1,28,5
3,8156.99,84.62,53.02,31.6,8125.39,WellsFargo1,28,5
4,8125.39,84.62,52.82,31.8,8093.59,WellsFargo1,28,5
5,8093.59,84.62,52.61,32.01,8061.58,WellsFargo1,28,5
6,8061.58,84.62,52.4,32.22,8029.36,WellsFargo1,28,5
7,8029.36,84.62,52.19,32.43,7996.93,WellsFargo1,28,5
8,7996.93,84.62,51.98,32.64,7964.29,WellsFargo1,28,5
9,7964.29,84.62,51.77,32.85,7931.44,WellsFargo1,28,5
10,7931.44,84.62,51.55,33.07,7898.37,WellsFargo1,28,5
11,7898.37,84.62,51.34,33.28,7865.09,WellsFargo1,28,5
12,7865.09,84.62,51.12,33.5,7831.59,WellsFargo1,28,5
13,7831.59,84.62,50.91,33.71,7797.88,WellsFargo1,28,5
14,7797.88,84.62,50.69,33.93,7763.95,WellsFargo1,28,5
15,7763.95,84.62,50.47,34.15,7729.8,WellsFargo1,28,5
16,7729.8,84.62,50.24,34.38,7695.42,WellsFargo1,28,5
17,7695.42,84.62,50.02,34.6,7660.82,WellsFargo1,28,5
18,7660.82,84.62,49.8,34.82,7626.0,WellsFargo1,28,5
19,7626.0,84.62,49.57,35.05,7590.95,WellsFargo1,28,5
20,7590.95,84.62,49.34,35.28,7555.67,WellsFargo1,28,5
21,7555.67,84.62,49.11,35.51,7520.16,WellsFargo1,28,5
22,7520.16,84.62,48.88,35.74,7484.42,WellsFargo1,28,5
23,7484.42,84.62,48.65,35.97,7448.45,WellsFargo1,28,5
24,7448.45,84.62,48.41,36.21,7412.24,WellsFargo1,28,5
25,7412.24,84.62,48.18,36.44,7375.8,WellsFargo1,28,5
26,7375.8,84.62,47.94,36.68,7339.12,WellsFargo1,28,5
27,7339.12,84.62,47.7,36.92,7302.2,WellsFargo1,28,5
28,7302.2,84.62,47.46,37.16,7265.04,WellsFargo1,28,5
29,7265.04,84.62,47.22,37.4,7227.64,WellsFargo1,28,5
30,7227.64,84.62,46.98,37.64,7190.0,WellsFargo1,28,5
31,7190.0,84.62,46.73,37.89,7152.11,WellsFargo1,28,5
32,7152.11,84.62,46.49,38.13,7113.98,WellsFargo1,28,5
33,7113.98,84.62,46.24,38.38,7075.6,WellsFargo1,28,5
34,7075.6,84.62,45.99,38.63,7036.97,WellsFargo1,28,5
35,7036.97,84.62,45.74,38.88,6998.09,WellsFargo1,28,5
36,6998.09,84.62,45.49,39.13,6958.96,WellsFargo1,28,5
37,6958.96,84.62,45.23,39.39,6919.57,WellsFargo1,28,5
38,6919.57,84.62,44.98,39.64,6879.93,WellsFargo1,28,5
39,6879.93,84.62,44.72,39.9,6840.03,WellsFargo1,28,5
40,6840.03,84.62,44.46,40.16,6799.87,WellsFargo1,28,5
41,6799.87,84.62,44.2,40.42,6759.45,WellsFargo1,28,5
42,6759.45,84.62,43.94,40.68,6718.77,WellsFargo1,28,5
43,6718.77,84.62,43.67,40.95,6677.82,WellsFargo1,28,5
44,6677.82,84.62,43.41,41.21,6636.61,WellsFargo1,28,5
45,6636.61,84.62,43.14,41.48,6595.13,WellsFargo1,28,5
46,6595.13,84.62,42.87,41.75,6553.38,WellsFargo1,28,5
47,6553.38,84.62,42.6,42.02,6511.36,WellsFargo1,28,5
48,6511.36,84.62,42.32,42.3,6469.06,WellsFargo1,28,5
49,6469.06,84.62,42.05,42.57,6426.49,WellsFargo1,28,5
50,6426.49,84.62,41.77,42.85,6383.64,WellsFargo1,28,5
51,6383.64,84.62,41.49,43.13,6340.51,WellsFargo1,28,5
52,6340.51,84.62,41.21,43.41,6297.1,WellsFargo1,28,5
53,6297.1,84.62,40.93,43.69,6253.41,WellsFargo1,28,5
54,6253.41,84.62,40.65,43.97,6209.44,WellsFargo1,28,5
55,6209.44,84.62,40.36,44.26,6165.18,WellsFargo1,28,5
56,6165.18,84.62,40.07,44.55,6120.63,WellsFargo1,28,5
57,6120.63,84.62,39.78,44.84,6075.79,WellsFargo1,28,5
58,6075.79,84.62,39.49,45.13,6030.66,WellsFargo1,28,5
59,6030.66,84.62,39.2,45.42,5985.24,WellsFargo1,28,5
60,5985.24,84.62,38.9,45.72,5939.52,WellsFargo1,28,5
61,5939.52,84.62,38.61,46.01,5893.51,WellsFargo1,28,5
62,5893.51,84.62,38.31,46.31,5847.2,WellsFargo1,28,5
63,5847.2,84.62,38.01,46.61,5800.59,WellsFargo1,28,5
64,5800.59,84.62,37.7,46.92,5753.67,WellsFargo1,28,5
65,5753.67,84.62,37.4,47.22,5706.45,WellsFargo1,28,5
66,5706.45,84.62,37.09,47.53,5658.92,WellsFargo1,28,5
67,5658.92,84.62,36.78,47.84,5611.08,WellsFargo1,28,5
68,5611.08,84.62,36.47,48.15,5562.93,WellsFargo1,28,5
69,5562.93,84.62,36.16,48.46,5514.47,WellsFargo1,28,5
70,5514.47,84.62,35.84,48.78,5465.69,WellsFargo1,28,5
71,5465.69,84.62,35.53,49.09,5416.6,WellsFargo1,28,5
72,5416.6,84.62,35.21,49.41,5367.19,WellsFargo1,28,5
73,5367.19,84.62,34.89,49.73,5317.46,WellsFargo1,28,5
74,5317.46,84.62,34.56,50.06,5267.4,WellsFargo1,28,5
75,5267.4,84.62,34.24,50.38,5217.02,WellsFargo1,28,5
76,5217.02,84.62,33.91,50.71,5166.31,WellsFargo1,28,5
77,5166.31,84.62,33.58,51.04,5115.27,WellsFargo1,28,5
78,5115.27,84.62,33.25,51.37,5063.9,WellsFargo1,28,5
79,5063.9,84.62,32.92,51.7,5012.2,WellsFargo1,28,5
80,5012.2,84.62,32.58,52.04,4960.16,WellsFargo1,28,5
81,4960.16,436.89,32.24,404.65,4555.51,WellsFargo1,28,5
82,4555.51,3010.1,29.61,2980.49,1575.02,WellsFargo1,28,5
83,1575.02,3010.1,10.24,2999.86,-1424.84,WellsFargo1,28,5
0,5000.0,1333.0,36.0,1297.0,3703.0,Car,29,1
1,3703.0,1333.0,26.66,1306.34,2396.66,Car,29,1
2,2396.66,1333.0,17.26,1315.74,1080.92,Car,29,1
3,1080.92,1333.0,7.78,1325.22,-244.3,Car,29,1
0,4000.0,70.0,16.0,54.0,3946.0,testing,29,2
1,3946.0,70.0,15.78,54.22,3891.78,testing,29,2
2,3891.78,70.0,15.57,54.43,3837.35,testing,29,2
3,3837.35,314.3,15.35,298.95,3538.4,testing,29,2
4,3538.4,1403.0,14.15,1388.85,2149.55,testing,29,2
5,2149.55,1403.0,8.6,1394.4,755.15,testing,29,2
6,755.15,1403.0,3.02,1399.98,-644.83,testing,29,2
0,180000.0,1331.44,594.0,737.44,179262.56,mortgage,29,3
1,179262.56,1331.44,591.57,739.87,178522.69,mortgage,29,3
2,178522.69,1331.44,589.12,742.32,177780.37,mortgage,29,3
3,177780.37,1331.44,586.68,744.76,177035.61,mortgage,29,3
4,177035.61,1331.44,584.22,747.22,176288.39,mortgage,29,3
5,176288.39,1331.44,581.75,749.69,175538.7,mortgage,29,3
6,175538.7,1976.27,579.28,1396.99,174141.71,mortgage,29,3
7,174141.71,2734.44,574.67,2159.77,171981.94,mortgage,29,3
8,171981.94,2734.44,567.54,2166.9,169815.04,mortgage,29,3
9,169815.04,2734.44,560.39,2174.05,167640.99,mortgage,29,3
10,167640.99,2734.44,553.22,2181.22,165459.77,mortgage,29,3
11,165459.77,2734.44,546.02,2188.42,163271.35,mortgage,29,3
12,163271.35,2734.44,538.8,2195.64,161075.71,mortgage,29,3
13,161075.71,2734.44,531.55,2202.89,158872.82,mortgage,29,3
14,158872.82,2734.44,524.28,2210.16,156662.66,mortgage,29,3
15,156662.66,2734.44,516.99,2217.45,154445.21,mortgage,29,3
16,154445.21,2734.44,509.67,2224.77,152220.44,mortgage,29,3
17,152220.44,2734.44,502.33,2232.11,149988.33,mortgage,29,3
18,149988.33,2734.44,494.96,2239.48,147748.85,mortgage,29,3
19,147748.85,2734.44,487.57,2246.87,145501.98,mortgage,29,3
20,145501.98,2734.44,480.16,2254.28,143247.7,mortgage,29,3
21,143247.7,2734.44,472.72,2261.72,140985.98,mortgage,29,3
22,140985.98,2734.44,465.25,2269.19,138716.79,mortgage,29,3
23,138716.79,2734.44,457.77,2276.67,136440.12,mortgage,29,3
24,136440.12,2734.44,450.25,2284.19,134155.93,mortgage,29,3
25,134155.93,2734.44,442.71,2291.73,131864.2,mortgage,29,3
26,131864.2,2734.44,435.15,2299.29,129564.91,mortgage,29,3
27,129564.91,2734.44,427.56,2306.88,127258.03,mortgage,29,3
28,127258.03,2734.44,419.95,2314.49,124943.54,mortgage,29,3
29,124943.54,2734.44,412.31,2322.13,122621.41,mortgage,29,3
30,122621.41,2734.44,404.65,2329.79,120291.62,mortgage,29,3
31,120291.62,2734.44,396.96,2337.48,117954.14,mortgage,29,3
32,117954.14,2734.44,389.25,2345.19,115608.95,mortgage,29,3
33,115608.95,2734.44,381.51,2352.93,113256.02,mortgage,29,3
34,113256.02,2734.44,373.74,2360.7,110895.32,mortgage,29,3
35,110895.32,2734.44,365.95,2368.49,108526.83,mortgage,29,3
36,108526.83,2734.44,358.14,2376.3,106150.53,mortgage,29,3
37,106150.53,2734.44,350.3,2384.14,103766.39,mortgage,29,3
38,103766.39,2734.44,342.43,2392.01,101374.38,mortgage,29,3
39,101374.38,2734.44,334.54,2399.9,98974.48,mortgage,29,3
40,98974.48,2734.44,326.62,2407.82,96566.66,mortgage,29,3
41,96566.66,2734.44,318.67,2415.77,94150.89,mortgage,29,3
42,94150.89,2734.44,310.7,2423.74,91727.15,mortgage,29,3
43,91727.15,2734.44,302.7,2431.74,89295.41,mortgage,29,3
44,89295.41,2734.44,294.67,2439.77,86855.64,mortgage,29,3
45,86855.64,2734.44,286.62,2447.82,84407.82,mortgage,29,3
46,84407.82,2734.44,278.55,2455.89,81951.93,mortgage,29,3
47,81951.93,2734.44,270.44,2464.0,79487.93,mortgage,29,3
48,79487.93,2734.44,262.31,2472.13,77015.8,mortgage,29,3
49,77015.8,2734.44,254.15,2480.29,74535.51,mortgage,29,3
50,74535.51,2734.44,245.97,2488.47,72047.04,mortgage,29,3
51,72047.04,2734.44,237.76,2496.68,69550.36,mortgage,29,3
52,69550.36,2734.44,229.52,2504.92,67045.44,mortgage,29,3
53,67045.44,2734.44,221.25,2513.19,64532.25,mortgage,29,3
54,64532.25,2734.44,212.96,2521.48,62010.77,mortgage,29,3
55,62010.77,2734.44,204.64,2529.8,59480.97,mortgage,29,3
56,59480.97,2734.44,196.29,2538.15,56942.82,mortgage,29,3
57,56942.82,2734.44,187.91,2546.53,54396.29,mortgage,29,3
58,54396.29,2734.44,179.51,2554.93,51841.36,mortgage,29,3
59,51841.36,2734.44,171.08,2563.36,49278.0,mortgage,29,3
60,49278.0,2734.44,162.62,2571.82,46706.18,mortgage,29,3
61,46706.18,2734.44,154.13,2580.31,44125.87,mortgage,29,3
62,44125.87,2734.44,145.62,2588.82,41537.05,mortgage,29,3
63,41537.05,2734.44,137.07,2597.37,38939.68,mortgage,29,3
64,38939.68,2734.44,128.5,2605.94,36333.74,mortgage,29,3
65,36333.74,2734.44,119.9,2614.54,33719.2,mortgage,29,3
66,33719.2,2734.44,111.27,2623.17,31096.03,mortgage,29,3
67,31096.03,2734.44,102.62,2631.82,28464.21,mortgage,29,3
68,28464.21,2734.44,93.93,2640.51,25823.7,mortgage,29,3
69,25823.7,2734.44,85.22,2649.22,23174.48,mortgage,29,3
70,23174.48,2734.44,76.48,2657.96,20516.52,mortgage,29,3
71,20516.52,2734.44,67.7,2666.74,17849.78,mortgage,29,3
72,17849.78,2734.44,58.9,2675.54,15174.24,mortgage,29,3
73,15174.24,2734.44,50.07,2684.37,12489.87,mortgage,29,3
74,12489.87,2734.44,41.22,2693.22,9796.65,mortgage,29,3
75,9796.65,2734.44,32.33,2702.11,7094.54,mortgage,29,3
76,7094.54,2734.44,23.41,2711.03,4383.51,mortgage,29,3
77,4383.51,2734.44,14.47,2719.97,1663.54,mortgage,29,3
78,1663.54,2734.44,5.49,2728.95,-1065.41,mortgage,29,3
0,8250.57,84.62,53.63,30.99,8219.58,WellsFargo1,29,4
1,8219.58,84.62,53.43,31.19,8188.39,WellsFargo1,29,4
2,8188.39,84.62,53.22,31.4,8156.99,WellsFargo1,29,4
3,8156.99,84.62,53.02,31.6,8125.39,WellsFargo1,29,4
4,8125.39,84.62,52.82,31.8,8093.59,WellsFargo1,29,4
5,8093.59,84.62,52.61,32.01,8061.58,WellsFargo1,29,4
6,8061.58,84.62,52.4,32.22,8029.36,WellsFargo1,29,4
7,8029.36,84.62,52.19,32.43,7996.93,WellsFargo1,29,4
8,7996.93,84.62,51.98,32.64,7964.29,WellsFargo1,29,4
9,7964.29,84.62,51.77,32.85,7931.44,WellsFargo1,29,4
10,7931.44,84.62,51.55,33.07,7898.37,WellsFargo1,29,4
11,7898.37,84.62,51.34,33.28,7865.09,WellsFargo1,29,4
12,7865.09,84.62,51.12,33.5,7831.59,WellsFargo1,29,4
13,7831.59,84.62,50.91,33.71,7797.88,WellsFargo1,29,4
14,7797.88,84.62,50.69,33.93,7763.95,WellsFargo1,29,4
15,7763.95,84.62,50.47,34.15,7729.8,WellsFargo1,29,4
16,7729.8,84.62,50.24,34.38,7695.42,WellsFargo1,29,4
17,7695.42,84.62,50.02,34.6,7660.82,WellsFargo1,29,4
18,7660.82,84.62,49.8,34.82,7626.0,WellsFargo1,29,4
19,7626.0,84.62,49.57,35.05,7590.95,WellsFargo1,29,4
20,7590.95,84.62,49.34,35.28,7555.67,WellsFargo1,29,4
21,7555.67,84.62,49.11,35.51,7520.16,WellsFargo1,29,4
22,7520.16,84.62,48.88,35.74,7484.42,WellsFargo1,29,4
23,7484.42,84.62,48.65,35.97,7448.45,WellsFargo1,29,4
24,7448.45,84.62,48.41,36.21,7412.24,WellsFargo1,29,4
25,7412.24,84.62,48.18,36.44,7375.8,WellsFargo1,29,4
26,7375.8,84.62,47.94,36.68,7339.12,WellsFargo1,29,4
27,7339.12,84.62,47.7,36.92,7302.2,WellsFargo1,29,4
28,7302.2,84.62,47.46,37.16,7265.04,WellsFargo1,29,4
29,7265.04,84.62,47.22,37.4,7227.64,WellsFargo1,29,4
30,7227.64,84.62,46.98,37.64,7190.0,WellsFargo1,29,4
31,7190.0,84.62,46.73,37.89,7152.11,WellsFargo1,29,4
32,7152.11,84.62,46.49,38.13,7113.98,WellsFargo1,29,4
33,7113.98,84.62,46.24,38.38,7075.6,WellsFargo1,29,4
34,7075.6,84.62,45.99,38.63,7036.97,WellsFargo1,29,4
35,7036.97,84.62,45.74,38.88,6998.09,WellsFargo1,29,4
36,6998.09,84.62,45.49,39.13,6958.96,WellsFargo1,29,4
37,6958.96,84.62,45.23,39.39,6919.57,WellsFargo1,29,4
38,6919.57,84.62,44.98,39.64,6879.93,WellsFargo1,29,4
39,6879.93,84.62,44.72,39.9,6840.03,WellsFargo1,29,4
40,6840.03,84.62,44.46,40.16,6799.87,WellsFargo1,29,4
41,6799.87,84.62,44.2,40.42,6759.45,WellsFargo1,29,4
42,6759.45,84.62,43.94,40.68,6718.77,WellsFargo1,29,4
43,6718.77,84.62,43.67,40.95,6677.82,WellsFargo1,29,4
44,6677.82,84.62,43.41,41.21,6636.61,WellsFargo1,29,4
45,6636.61,84.62,43.14,41.48,6595.13,WellsFargo1,29,4
46,6595.13,84.62,42.87,41.75,6553.38,WellsFargo1,29,4
47,6553.38,84.62,42.6,42.02,6511.36,WellsFargo1,29,4
48,6511.36,84.62,42.32,42.3,6469.06,WellsFargo1,29,4
49,6469.06,84.62,42.05,42.57,6426.49,WellsFargo1,29,4
50,6426.49,84.62,41.77,42.85,6383.64,WellsFargo1,29,4
51,6383.64,84.62,41.49,43.13,6340.51,WellsFargo1,29,4
52,6340.51,84.62,41.21,43.41,6297.1,WellsFargo1,29,4
53,6297.1,84.62,40.93,43.69,6253.41,WellsFargo1,29,4
54,6253.41,84.62,40.65,43.97,6209.44,WellsFargo1,29,4
55,6209.44,84.62,40.36,44.26,6165.18,WellsFargo1,29,4
56,6165.18,84.62,40.07,44.55,6120.63,WellsFargo1,29,4
57,6120.63,84.62,39.78,44.84,6075.79,WellsFargo1,29,4
58,6075.79,84.62,39.49,45.13,6030.66,WellsFargo1,29,4
59,6030.66,84.62,39.2,45.42,5985.24,WellsFargo1,29,4
60,5985.24,84.62,38.9,45.72,5939.52,WellsFargo1,29,4
61,5939.52,84.62,38.61,46.01,5893.51,WellsFargo1,29,4
62,5893.51,84.62,38.31,46.31,5847.2,WellsFargo1,29,4
63,5847.2,84.62,38.01,46.61,5800.59,WellsFargo1,29,4
64,5800.59,84.62,37.7,46.92,5753.67,WellsFargo1,29,4
65,5753.67,84.62,37.4,47.22,5706.45,WellsFargo1,29,4
66,5706.45,84.62,37.09,47.53,5658.92,WellsFargo1,29,4
67,5658.92,84.62,36.78,47.84,5611.08,WellsFargo1,29,4
68,5611.08,84.62,36.47,48.15,5562.93,WellsFargo1,29,4
69,5562.93,84.62,36.16,48.46,5514.47,WellsFargo1,29,4
70,5514.47,84.62,35.84,48.78,5465.69,WellsFargo1,29,4
71,5465.69,84.62,35.53,49.09,5416.6,WellsFargo1,29,4
72,5416.6,84.62,35.21,49.41,5367.19,WellsFargo1,29,4
73,5367.19,84.62,34.89,49.73,5317.46,WellsFargo1,29,4
74,5317.46,84.62,34.56,50.06,5267.4,WellsFargo1,29,4
75,5267.4,84.62,34.24,50.38,5217.02,WellsFargo1,29,4
76,5217.02,84.62,33.91,50.71,5166.31,WellsFargo1,29,4
77,5166.31,84.62,33.58,51.04,5115.27,WellsFargo1,29,4
78,5115.27,1150.03,33.25,1116.78,3998.49,WellsFargo1,29,4
79,3998.49,2819.06,25.99,2793.07,1205.42,WellsFargo1,29,4
80,1205.42,2819.06,7.84,2811.22,-1605.8,WellsFargo1,29,4
0,20000.0,191.04,108.0,83.04,19916.96,WellsFargo2,29,5
1,19916.96,191.04,107.55,83.49,19833.47,WellsFargo2,29,5
2,19833.47,191.04,107.1,83.94,19749.53,WellsFargo2,29,5
3,19749.53,191.04,106.65,84.39,19665.14,WellsFargo2,29,5
4,19665.14,191.04,106.19,84.85,19580.29,WellsFargo2,29,5
5,19580.29,191.04,105.73,85.31,19494.98,WellsFargo2,29,5
6,19494.98,191.04,105.27,85.77,19409.21,WellsFargo2,29,5
7,19409.21,191.04,104.81,86.23,19322.98,WellsFargo2,29,5
8,19322.98,191.04,104.34,86.7,19236.28,WellsFargo2,29,5
9,19236.28,191.04,103.88,87.16,19149.12,WellsFargo2,29,5
10,19149.12,191.04,103.41,87.63,19061.49,WellsFargo2,29,5
11,19061.49,191.04,102.93,88.11,18973.38,WellsFargo2,29,5
12,18973.38,191.04,102.46,88.58,18884.8,WellsFargo2,29,5
13,18884.8,191.04,101.98,89.06,18795.74,WellsFargo2,29,5
14,18795.74,191.04,101.5,89.54,18706.2,WellsFargo2,29,5
15,18706.2,191.04,101.01,90.03,18616.17,WellsFargo2,29,5
16,18616.17,191.04,100.53,90.51,18525.66,WellsFargo2,29,5
17,18525.66,191.04,100.04,91.0,18434.66,WellsFargo2,29,5
18,18434.66,191.04,99.55,91.49,18343.17,WellsFargo2,29,5
19,18343.17,191.04,99.05,91.99,18251.18,WellsFargo2,29,5
20,18251.18,191.04,98.56,92.48,18158.7,WellsFargo2,29,5
21,18158.7,191.04,98.06,92.98,18065.72,WellsFargo2,29,5
22,18065.72,191.04,97.55,93.49,17972.23,WellsFargo2,29,5
23,17972.23,191.04,97.05,93.99,17878.24,WellsFargo2,29,5
24,17878.24,191.04,96.54,94.5,17783.74,WellsFargo2,29,5
25,17783.74,191.04,96.03,95.01,17688.73,WellsFargo2,29,5
26,17688.73,191.04,95.52,95.52,17593.21,WellsFargo2,29,5
27,17593.21,191.04,95.0,96.04,17497.17,WellsFargo2,29,5
28,17497.17,191.04,94.48,96.56,17400.61,WellsFargo2,29,5
29,17400.61,191.04,93.96,97.08,17303.53,WellsFargo2,29,5
30,17303.53,191.04,93.44,97.6,17205.93,WellsFargo2,29,5
31,17205.93,191.04,92.91,98.13,17107.8,WellsFargo2,29,5
32,17107.8,191.04,92.38,98.66,17009.14,WellsFargo2,29,5
33,17009.14,191.04,91.85,99.19,16909.95,WellsFargo2,29,5
34,16909.95,191.04,91.31,99.73,16810.22,WellsFargo2,29,5
35,16810.22,191.04,90.78,100.26,16709.96,WellsFargo2,29,5
36,16709.96,191.04,90.23,100.81,16609.15,WellsFargo2,29,5
37,16609.15,191.04,89.69,101.35,16507.8,WellsFargo2,29,5
38,16507.8,191.04,89.14,101.9,16405.9,WellsFargo2,29,5
39,16405.9,191.04,88.59,102.45,16303.45,WellsFargo2,29,5
40,16303.45,191.04,88.04,103.0,16200.45,WellsFargo2,29,5
41,16200.45,191.04,87.48,103.56,16096.89,WellsFargo2,29,5
42,16096.89,191.04,86.92,104.12,15992.77,WellsFargo2,29,5
43,15992.77,191.04,86.36,104.68,15888.09,WellsFargo2,29,5
44,15888.09,191.04,85.8,105.24,15782.85,WellsFargo2,29,5
45,15782.85,191.04,85.23,105.81,15677.04,WellsFargo2,29,5
46,15677.04,191.04,84.66,106.38,15570.66,WellsFargo2,29,5
47,15570.66,191.04,84.08,106.96,15463.7,WellsFargo2,29,5
48,15463.7,191.04,83.5,107.54,15356.16,WellsFargo2,29,5
49,15356.16,191.04,82.92,108.12,15248.04,WellsFargo2,29,5
50,15248.04,191.04,82.34,108.7,15139.34,WellsFargo2,29,5
51,15139.34,191.04,81.75,109.29,15030.05,WellsFargo2,29,5
52,15030.05,191.04,81.16,109.88,14920.17,WellsFargo2,29,5
53,14920.17,191.04,80.57,110.47,14809.7,WellsFargo2,29,5
54,14809.7,191.04,79.97,111.07,14698.63,WellsFargo2,29,5
55,14698.63,191.04,79.37,111.67,14586.96,WellsFargo2,29,5
56,14586.96,191.04,78.77,112.27,14474.69,WellsFargo2,29,5
57,14474.69,191.04,78.16,112.88,14361.81,WellsFargo2,29,5
58,14361.81,191.04,77.55,113.49,14248.32,WellsFargo2,29,5
59,14248.32,191.04,76.94,114.1,14134.22,WellsFargo2,29,5
60,14134.22,191.04,76.32,114.72,14019.5,WellsFargo2,29,5
61,14019.5,191.04,75.71,115.33,13904.17,WellsFargo2,29,5
62,13904.17,191.04,75.08,115.96,13788.21,WellsFargo2,29,5
63,13788.21,191.04,74.46,116.58,13671.63,WellsFargo2,29,5
64,13671.63,191.04,73.83,117.21,13554.42,WellsFargo2,29,5
65,13554.42,191.04,73.19,117.85,13436.57,WellsFargo2,29,5
66,13436.57,191.04,72.56,118.48,13318.09,WellsFargo2,29,5
67,13318.09,191.04,71.92,119.12,13198.97,WellsFargo2,29,5
68,13198.97,191.04,71.27,119.77,13079.2,WellsFargo2,29,5
69,13079.2,191.04,70.63,120.41,12958.79,WellsFargo2,29,5
70,12958.79,191.04,69.98,121.06,12837.73,WellsFargo2,29,5
71,12837.73,191.04,69.32,121.72,12716.01,WellsFargo2,29,5
72,12716.01,191.04,68.67,122.37,12593.64,WellsFargo2,29,5
73,12593.64,191.04,68.01,123.03,12470.61,WellsFargo2,29,5
74,12470.61,191.04,67.34,123.7,12346.91,WellsFargo2,29,5
75,12346.91,191.04,66.67,124.37,12222.54,WellsFargo2,29,5
76,12222.54,191.04,66.0,125.04,12097.5,WellsFargo2,29,5
77,12097.5,191.04,65.33,125.71,11971.79,WellsFargo2,29,5
78,11971.79,191.04,64.65,126.39,11845.4,WellsFargo2,29,5
79,11845.4,191.04,63.97,127.07,11718.33,WellsFargo2,29,5
80,11718.33,1796.84,63.28,1733.56,9984.77,WellsFargo2,29,5
81,9984.77,3010.1,53.92,2956.18,7028.59,WellsFargo2,29,5
82,7028.59,3010.1,37.95,2972.15,4056.44,WellsFargo2,29,5
83,4056.44,3010.1,21.9,2988.2,1068.24,WellsFargo2,29,5
84,1068.24,3010.1,5.77,3004.33,-1936.09,WellsFargo2,29,5
0,5000.0,1333.0,36.0,1297.0,3703.0,Car,30,1
1,3703.0,1333.0,26.66,1306.34,2396.66,Car,30,1
2,2396.66,1333.0,17.26,1315.74,1080.92,Car,30,1
3,1080.92,1333.0,7.78,1325.22,-244.3,Car,30,1
0,4000.0,70.0,16.0,54.0,3946.0,testing,30,2
1,3946.0,70.0,15.78,54.22,3891.78,testing,30,2
2,3891.78,70.0,15.57,54.43,3837.35,testing,30,2
3,3837.35,314.3,15.35,298.95,3538.4,testing,30,2
4,3538.4,1403.0,14.15,1388.85,2149.55,testing,30,2
5,2149.55,1403.0,8.6,1394.4,755.15,testing,30,2
6,755.15,1403.0,3.02,1399.98,-644.83,testing,30,2
0,180000.0,1331.44,594.0,737.44,179262.56,mortgage,30,3
1,179262.56,1331.44,591.57,739.87,178522.69,mortgage,30,3
2,178522.69,1331.44,589.12,742.32,177780.37,mortgage,30,3
3,177780.37,1331.44,586.68,744.76,177035.61,mortgage,30,3
4,177035.61,1331.44,584.22,747.22,176288.39,mortgage,30,3
5,176288.39,1331.44,581.75,749.69,175538.7,mortgage,30,3
6,175538.7,1976.27,579.28,1396.99,174141.71,mortgage,30,3
7,174141.71,2734.44,574.67,2159.77,171981.94,mortgage,30,3
8,171981.94,2734.44,567.54,2166.9,169815.04,mortgage,30,3
9,169815.04,2734.44,560.39,2174.05,167640.99,mortgage,30,3
10,167640.99,2734.44,553.22,2181.22,165459.77,mortgage,30,3
11,165459.77,2734.44,546.02,2188.42,163271.35,mortgage,30,3
12,163271.35,2734.44,538.8,2195.64,161075.71,mortgage,30,3
13,161075.71,2734.44,531.55,2202.89,158872.82,mortgage,30,3
14,158872.82,2734.44,524.28,2210.16,156662.66,mortgage,30,3
15,156662.66,2734.44,516.99,2217.45,154445.21,mortgage,30,3
16,154445.21,2734.44,509.67,2224.77,152220.44,mortgage,30,3
17,152220.44,2734.44,502.33,2232.11,149988.33,mortgage,30,3
18,149988.33,2734.44,494.96,2239.48,147748.85,mortgage,30,3
19,147748.85,2734.44,487.57,2246.87,145501.98,mortgage,30,3
20,145501.98,2734.44,480.16,2254.28,143247.7,mortgage,30,3
21,143247.7,2734.44,472.72,2261.72,140985.98,mortgage,30,3
22,140985.98,2734.44,465.25,2269.19,138716.79,mortgage,30,3
23,138716.79,2734.44,457.77,2276.67,136440.12,mortgage,30,3
24,136440.12,2734.44,450.25,2284.19,134155.93,mortgage,30,3
25,134155.93,2734.44,442.71,2291.73,131864.2,mortgage,30,3
26,131864.2,2734.44,435.15,2299.29,129564.91,mortgage,30,3
27,129564.91,2734.44,427.56,2306.88,127258.03,mortgage,30,3
28,127258.03,2734.44,419.95,2314.49,124943.54,mortgage,30,3
29,124943.54,2734.44,412.31,2322.13,122621.41,mortgage,30,3
30,122621.41,2734.44,404.65,2329.79,120291.62,mortgage,30,3
31,120291.62,2734.44,396.96,2337.48,117954.14,mortgage,30,3
32,117954.14,2734.44,389.25,2345.19,115608.95,mortgage,30,3
33,115608.95,2734.44,381.51,2352.93,113256.02,mortgage,30,3
34,113256.02,2734.44,373.74,2360.7,110895.32,mortgage,30,3
35,110895.32,2734.44,365.95,2368.49,108526.83,mortgage,30,3
36,108526.83,2734.44,358.14,2376.3,106150.53,mortgage,30,3
37,106150.53,2734.44,350.3,2384.14,103766.39,mortgage,30,3
38,103766.39,2734.44,342.43,2392.01,101374.38,mortgage,30,3
39,101374.38,2734.44,334.54,2399.9,98974.48,mortgage,30,3
40,98974.48,2734.44,326.62,2407.82,96566.66,mortgage,30,3
41,96566.66,2734.44,318.67,2415.77,94150.89,mortgage,30,3
42,94150.89,2734.44,310.7,2423.74,91727.15,mortgage,30,3
43,91727.15,2734.44,302.7,2431.74,89295.41,mortgage,30,3
44,89295.41,2734.44,294.67,2439.77,86855.64,mortgage,30,3
45,86855.64,2734.44,286.62,2447.82,84407.82,mortgage,30,3
46,84407.82,2734.44,278.55,2455.89,81951.93,mortgage,30,3
47,81951.93,2734.44,270.44,2464.0,79487.93,mortgage,30,3
48,79487.93,2734.44,262.31,2472.13,77015.8,mortgage,30,3
49,77015.8,2734.44,254.15,2480.29,74535.51,mortgage,30,3
50,74535.51,2734.44,245.97,2488.47,72047.04,mortgage,30,3
51,72047.04,2734.44,237.76,2496.68,69550.36,mortgage,30,3
52,69550.36,2734.44,229.52,2504.92,67045.44,mortgage,30,3
53,67045.44,2734.44,221.25,2513.19,64532.25,mortgage,30,3
54,64532.25,2734.44,212.96,2521.48,62010.77,mortgage,30,3
55,62010.77,2734.44,204.64,2529.8,59480.97,mortgage,30,3
56,59480.97,2734.44,196.29,2538.15,56942.82,mortgage,30,3
57,56942.82,2734.44,187.91,2546.53,54396.29,mortgage,30,3
58,54396.29,2734.44,179.51,2554.93,51841.36,mortgage,30,3
59,51841.36,2734.44,171.08,2563.36,49278.0,mortgage,30,3
60,49278.0,2734.44,162.62,2571.82,46706.18,mortgage,30,3
61,46706.18,2734.44,154.13,2580.31,44125.87,mortgage,30,3
62,44125.87,2734.44,145.62,2588.82,41537.05,mortgage,30,3
63,41537.05,2734.44,137.07,2597.37,38939.68,mortgage,30,3
64,38939.68,2734.44,128.5,2605.94,36333.74,mortgage,30,3
65,36333.74,2734.44,119.9,2614.54,33719.2,mortgage,30,3
66,33719.2,2734.44,111.27,2623.17,31096.03,mortgage,30,3
67,31096.03,2734.44,102.62,2631.82,28464.21,mortgage,30,3
68,28464.21,2734.44,93.93,2640.51,25823.7,mortgage,30,3
69,25823.7,2734.44,85.22,2649.22,23174.48,mortgage,30,3
70,23174.48,2734.44,76.48,2657.96,20516.52,mortgage,30,3
71,20516.52,2734.44,67.7,2666.74,17849.78,mortgage,30,3
72,17849.78,2734.44,58.9,2675.54,15174.24,mortgage,30,3
73,15174.24,2734.44,50.07,2684.37,12489.87,mortgage,30,3
74,12489.87,2734.44,41.22,2693.22,9796.65,mortgage,30,3
75,9796.65,2734.44,32.33,2702.11,7094.54,mortgage,30,3
76,7094.54,2734.44,23.41,2711.03,4383.51,mortgage,30,3
77,4383.51,2734.44,14.47,2719.97,1663.54,mortgage,30,3
78,1663.54,2734.44,5.49,2728.95,-1065.41,mortgage,30,3
0,20000.0,191.04,108.0,83.04,19916.96,WellsFargo2,30,4
1,19916.96,191.04,107.55,83.49,19833.47,WellsFargo2,30,4
2,19833.47,191.04,107.1,83.94,19749.53,WellsFargo2,30,4
3,19749.53,191.04,106.65,84.39,19665.14,WellsFargo2,30,4
4,19665.14,191.04,106.19,84.85,19580.29,WellsFargo2,30,4
5,19580.29,191.04,105.73,85.31,19494.98,WellsFargo2,30,4
6,19494.98,191.04,105.27,85.77,19409.21,WellsFargo2,30,4
7,19409.21,191.04,104.81,86.23,19322.98,WellsFargo2,30,4
8,19322.98,191.04,104.34,86.7,19236.28,WellsFargo2,30,4
9,19236.28,191.04,103.88,87.16,19149.12,WellsFargo2,30,4
10,19149.12,191.04,103.41,87.63,19061.49,WellsFargo2,30,4
11,19061.49,191.04,102.93,88.11,18973.38,WellsFargo2,30,4
12,18973.38,191.04,102.46,88.58,18884.8,WellsFargo2,30,4
13,18884.8,191.04,101.98,89.06,18795.74,WellsFargo2,30,4
14,18795.74,191.04,101.5,89.54,18706.2,WellsFargo2,30,4
15,18706.2,191.04,101.01,90.03,18616.17,WellsFargo2,30,4
16,18616.17,191.04,100.53,90.51,18525.66,WellsFargo2,30,4
17,18525.66,191.04,100.04,91.0,18434.66,WellsFargo2,30,4
18,18434.66,191.04,99.55,91.49,18343.17,WellsFargo2,30,4
19,18343.17,191.04,99.05,91.99,18251.18,WellsFargo2,30,4
20,18251.18,191.04,98.56,92.48,18158.7,WellsFargo2,30,4
21,18158.7,191.04,98.06,92.98,18065.72,WellsFargo2,30,4
22,18065.72,191.04,97.55,93.49,17972.23,WellsFargo2,30,4
23,17972.23,191.04,97.05,93.99,17878.24,WellsFargo2,30,4
24,17878.24,191.04,96.54,94.5,17783.74,WellsFargo2,30,4
25,17783.74,191.04,96.03,95.01,17688.73,WellsFargo2,30,4
26,17688.73,191.04,95.52,95.52,17593.21,WellsFargo2,30,4
27,17593.21,191.04,95.0,96.04,17497.17,WellsFargo2,30,4
28,17497.17,191.04,94.48,96.56,17400.61,WellsFargo2,30,4
29,17400.61,191.04,93.96,97.08,17303.53,WellsFargo2,30,4
30,17303.53,191.04,93.44,97.6,17205.93,WellsFargo2,30,4
31,17205.93,191.04,92.91,98.13,17107.8,WellsFargo2,30,4
32,17107.8,191.04,92.38,98.66,17009.14,WellsFargo2,30,4
33,17009.14,191.04,91.85,99.19,16909.95,WellsFargo2,30,4
34,16909.95,191.04,91.31,99.73,16810.22,WellsFargo2,30,4
35,16810.22,191.04,90.78,100.26,16709.96,WellsFargo2,30,4
36,16709.96,191.04,90.23,100.81,16609.15,WellsFargo2,30,4
37,16609.15,191.04,89.69,101.35,16507.8,WellsFargo2,30,4
38,16507.8,191.04,89.14,101.9,16405.9,WellsFargo2,30,4
39,16405.9,191.04,88.59,102.45,16303.45,WellsFargo2,30,4
40,16303.45,191.04,88.04,103.0,16200.45,WellsFargo2,30,4
41,16200.45,191.04,87.48,103.56,16096.89,WellsFargo2,30,4
42,16096.89,191.04,86.92,104.12,15992.77,WellsFargo2,30,4
43,15992.77,191.04,86.36,104.68,15888.09,WellsFargo2,30,4
44,15888.09,191.04,85.8,105.24,15782.85,WellsFargo2,30,4
45,15782.85,191.04,85.23,105.81,15677.04,WellsFargo2,30,4
46,15677.04,191.04,84.66,106.38,15570.66,WellsFargo2,30,4
47,15570.66,191.04,84.08,106.96,15463.7,WellsFargo2,30,4
48,15463.7,191.04,83.5,107.54,15356.16,WellsFargo2,30,4
49,15356.16,191.04,82.92,108.12,15248.04,WellsFargo2,30,4
50,15248.04,191.04,82.34,108.7,15139.34,WellsFargo2,30,4
51,15139.34,191.04,81.75,109.29,15030.05,WellsFargo2,30,4
52,15030.05,191.04,81.16,109.88,14920.17,WellsFargo2,30,4
53,14920.17,191.04,80.57,110.47,14809.7,WellsFargo2,30,4
54,14809.7,191.04,79.97,111.07,14698.63,WellsFargo2,30,4
55,14698.63,191.04,79.37,111.67,14586.96,WellsFargo2,30,4
56,14586.96,191.04,78.77,112.27,14474.69,WellsFargo2,30,4
57,14474.69,191.04,78.16,112.88,14361.81,WellsFargo2,30,4
58,14361.81,191.04,77.55,113.49,14248.32,WellsFargo2,30,4
59,14248.32,191.04,76.94,114.1,14134.22,WellsFargo2,30,4
60,14134.22,191.04,76.32,114.72,14019.5,WellsFargo2,30,4
61,14019.5,191.04,75.71,115.33,13904.17,WellsFargo2,30,4
62,13904.17,191.04,75.08,115.96,13788.21,WellsFargo2,30,4
63,13788.21,191.04,74.46,116.58,13671.63,WellsFargo2,30,4
64,13671.63,191.04,73.83,117.21,13554.42,WellsFargo2,30,4
65,13554.42,191.04,73.19,117.85,13436.57,WellsFargo2,30,4
66,13436.57,191.04,72.56,118.48,13318.09,WellsFargo2,30,4
67,13318.09,191.04,71.92,119.12,13198.97,WellsFargo2,30,4
68,13198.97,191.04,71.27,119.77,13079.2,WellsFargo2,30,4
69,13079.2,191.04,70.63,120.41,12958.79,WellsFargo2,30,4
70,12958.79,191.04,69.98,121.06,12837.73,WellsFargo2,30,4
71,12837.73,191.04,69.32,121.72,12716.01,WellsFargo2,30,4
72,12716.01,191.04,68.67,122.37,12593.64,WellsFargo2,30,4
73,12593.64,191.04,68.01,123.03,12470.61,WellsFargo2,30,4
74,12470.61,191.04,67.34,123.7,12346.91,WellsFargo2,30,4
75,12346.91,191.04,66.67,124.37,12222.54,WellsFargo2,30,4
76,12222.54,191.04,66.0,125.04,12097.5,WellsFargo2,30,4
77,12097.5,191.04,65.33,125.71,11971.79,WellsFargo2,30,4
78,11971.79,1256.45,64.65,1191.8,10779.99,WellsFargo2,30,4
79,10779.99,2925.48,58.21,2867.27,7912.72,WellsFargo2,30,4
80,7912.72,2925.48,42.73,2882.75,5029.97,WellsFargo2,30,4
81,5029.97,2925.48,27.16,2898.32,2131.65,WellsFargo2,30,4
82,2131.65,2925.48,11.51,2913.97,-782.32,WellsFargo2,30,4
0,8250.57,84.62,53.63,30.99,8219.58,WellsFargo1,30,5
1,8219.58,84.62,53.43,31.19,8188.39,WellsFargo1,30,5
2,8188.39,84.62,53.22,31.4,8156.99,WellsFargo1,30,5
3,8156.99,84.62,53.02,31.6,8125.39,WellsFargo1,30,5
4,8125.39,84.62,52.82,31.8,8093.59,WellsFargo1,30,5
5,8093.59,84.62,52.61,32.01,8061.58,WellsFargo1,30,5
6,8061.58,84.62,52.4,32.22,8029.36,WellsFargo1,30,5
7,8029.36,84.62,52.19,32.43,7996.93,WellsFargo1,30,5
8,7996.93,84.62,51.98,32.64,7964.29,WellsFargo1,30,5
9,7964.29,84.62,51.77,32.85,7931.44,WellsFargo1,30,5
10,7931.44,84.62,51.55,33.07,7898.37,WellsFargo1,30,5
11,7898.37,84.62,51.34,33.28,7865.09,WellsFargo1,30,5
12,7865.09,84.62,51.12,33.5,7831.59,WellsFargo1,30,5
13,7831.59,84.62,50.91,33.71,7797.88,WellsFargo1,30,5
14,7797.88,84.62,50.69,33.93,7763.95,WellsFargo1,30,5
15,7763.95,84.62,50.47,34.15,7729.8,WellsFargo1,30,5
16,7729.8,84.62,50.24,34.38,7695.42,WellsFargo1,30,5
17,7695.42,84.62,50.02,34.6,7660.82,WellsFargo1,30,5
18,7660.82,84.62,49.8,34.82,7626.0,WellsFargo1,30,5
19,7626.0,84.62,49.57,35.05,7590.95,WellsFargo1,30,5
20,7590.95,84.62,49.34,35.28,7555.67,WellsFargo1,30,5
21,7555.67,84.62,49.11,35.51,7520.16,WellsFargo1,30,5
22,7520.16,84.62,48.88,35.74,7484.42,WellsFargo1,30,5
23,7484.42,84.62,48.65,35.97,7448.45,WellsFargo1,30,5
24,7448.45,84.62,48.41,36.21,7412.24,WellsFargo1,30,5
25,7412.24,84.62,48.18,36.44,7375.8,WellsFargo1,30,5
26,7375.8,84.62,47.94,36.68,7339.12,WellsFargo1,30,5
27,7339.12,84.62,47.7,36.92,7302.2,WellsFargo1,30,5
28,7302.2,84.62,47.46,37.16,7265.04,WellsFargo1,30,5
29,7265.04,84.62,47.22,37.4,7227.64,WellsFargo1,30,5
30,7227.64,84.62,46.98,37.64,7190.0,WellsFargo1,30,5
31,7190.0,84.62,46.73,37.89,7152.11,WellsFargo1,30,5
32,7152.11,84.62,46.49,38.13,7113.98,WellsFargo1,30,5
33,7113.98,84.62,46.24,38.38,7075.6,WellsFargo1,30,5
34,7075.6,84.62,45.99,38.63,7036.97,WellsFargo1,30,5
35,7036.97,84.62,45.74,38.88,6998.09,WellsFargo1,30,5
36,6998.09,84.62,45.49,39.13,6958.96,WellsFargo1,30,5
37,6958.96,84.62,45.23,39.39,6919.57,WellsFargo1,30,5
38,6919.57,84.62,44.98,39.64,6879.93,WellsFargo1,30,5
39,6879.93,84.62,44.72,39.9,6840.03,WellsFargo1,30,5
40,6840.03,84.62,44.46,40.16,6799.87,WellsFargo1,30,5
41,6799.87,84.62,44.2,40.42,6759.45,WellsFargo1,30,5
42,6759.45,84.62,43.94,40.68,6718.77,WellsFargo1,30,5
43,6718.77,84.62,43.67,40.95,6677.82,WellsFargo1,30,5
44,6677.82,84.62,43.41,41.21,6636.61,WellsFargo1,30,5
45,6636.61,84.62,43.14,41.48,6595.13,WellsFargo1,30,5
46,6595.13,84.62,42.87,41.75,6553.38,WellsFargo1,30,5
47,6553.38,84.62,42.6,42.02,6511.36,WellsFargo1,30,5
48,6511.36,84.62,42.32,42.3,6469.06,WellsFargo1,30,5
49,6469.06,84.62,42.05,42.57,6426.49,WellsFargo1,30,5
50,6426.49,84.62,41.77,42.85,6383.64,WellsFargo1,30,5
51,6383.64,84.62,41.49,43.13,6340.51,WellsFargo1,30,5
52,6340.51,84.62,41.21,43.41,6297.1,WellsFargo1,30,5
53,6297.1,84.62,40.93,43.69,6253.41,WellsFargo1,30,5
54,6253.41,84.62,40.65,43.97,6209.44,WellsFargo1,30,5
55,6209.44,84.62,40.36,44.26,6165.18,WellsFargo1,30,5
56,6165.18,84.62,40.07,44.55,6120.63,WellsFargo1,30,5
57,6120.63,84.62,39.78,44.84,6075.79,WellsFargo1,30,5
58,6075.79,84.62,39.49,45.13,6030.66,WellsFargo1,30,5
59,6030.66,84.62,39.2,45.42,5985.24,WellsFargo1,30,5
60,5985.24,84.62,38.9,45.72,5939.52,WellsFargo1,30,5
61,5939.52,84.62,38.61,46.01,5893.51,WellsFargo1,30,5
62,5893.51,84.62,38.31,46.31,5847.2,WellsFargo1,30,5
63,5847.2,84.62,38.01,46.61,5800.59,WellsFargo1,30,5
64,5800.59,84.62,37.7,46.92,5753.67,WellsFargo1,30,5
65,5753.67,84.62,37.4,47.22,5706.45,WellsFargo1,30,5
66,5706.45,84.62,37.09,47.53,5658.92,WellsFargo1,30,5
67,5658.92,84.62,36.78,47.84,5611.08,WellsFargo1,30,5
68,5611.08,84.62,36.47,48.15,5562.93,WellsFargo1,30,5
69,5562.93,84.62,36.16,48.46,5514.47,WellsFargo1,30,5
70,5514.47,84.62,35.84,48.78,5465.69,WellsFargo1,30,5
71,5465.69,84.62,35.53,49.09,5416.6,WellsFargo1,30,5
72,5416.6,84.62,35.21,49.41,5367.19,WellsFargo1,30,5
73,5367.19,84.62,34.89,49.73,5317.46,WellsFargo1,30,5
74,5317.46,84.62,34.56,50.06,5267.4,WellsFargo1,30,5
75,5267.4,84.62,34.24,50.38,5217.02,WellsFargo1,30,5
76,5217.02,84.62,33.91,50.71,5166.31,WellsFargo1,30,5
77,5166.31,84.62,33.58,51.04,5115.27,WellsFargo1,30,5
78,5115.27,84.62,33.25,51.37,5063.9,WellsFargo1,30,5
79,5063.9,84.62,32.92,51.7,5012.2,WellsFargo1,30,5
80,5012.2,84.62,32.58,52.04,4960.16,WellsFargo1,30,5
81,4960.16,84.62,32.24,52.38,4907.78,WellsFargo1,30,5
82,4907.78,866.94,31.9,835.04,4072.74,WellsFargo1,30,5
83,4072.74,3010.1,26.47,2983.63,1089.11,WellsFargo1,30,5
84,1089.11,3010.1,7.08,3003.02,-1913.91,WellsFargo1,30,5
0,5000.0,1333.0,36.0,1297.0,3703.0,Car,31,1
1,3703.0,1333.0,26.66,1306.34,2396.66,Car,31,1
2,2396.66,1333.0,17.26,1315.74,1080.92,Car,31,1
3,1080.92,1333.0,7.78,1325.22,-244.3,Car,31,1
0,8250.57,84.62,53.63,30.99,8219.58,WellsFargo1,31,2
1,8219.58,84.62,53.43,31.19,8188.39,WellsFargo1,31,2
2,8188.39,84.62,53.22,31.4,8156.99,WellsFargo1,31,2
3,8156.99,328.92,53.02,275.9,7881.09,WellsFargo1,31,2
4,7881.09,1417.62,51.23,1366.39,6514.7,WellsFargo1,31,2
5,6514.7,1417.62,42.35,1375.27,5139.43,WellsFargo1,31,2
6,5139.43,1417.62,33.41,1384.21,3755.22,WellsFargo1,31,2
7,3755.22,1417.62,24.41,1393.21,2362.01,WellsFargo1,31,2
8,2362.01,1417.62,15.35,1402.27,959.74,WellsFargo1,31,2
9,959.74,1417.62,6.24,1411.38,-451.64,WellsFargo1,31,2
0,4000.0,70.0,16.0,54.0,3946.0,testing,31,3
1,3946.0,70.0,15.78,54.22,3891.78,testing,31,3
2,3891.78,70.0,15.57,54.43,3837.35,testing,31,3
3,3837.35,70.0,15.35,54.65,3782.7,testing,31,3
4,3782.7,70.0,15.13,54.87,3727.83,testing,31,3
5,3727.83,70.0,14.91,55.09,3672.74,testing,31,3
6,3672.74,70.0,14.69,55.31,3617.43,testing,31,3
7,3617.43,70.0,14.47,55.53,3561.9,testing,31,3
8,3561.9,70.0,14.25,55.75,3506.15,testing,31,3
9,3506.15,521.64,14.02,507.62,2998.53,testing,31,3
10,2998.53,1487.62,11.99,1475.63,1522.9,testing,31,3
11,1522.9,1487.62,6.09,1481.53,41.37,testing,31,3
12,41.37,1487.62,0.17,1487.45,-1446.08,testing,31,3
0,20000.0,191.04,108.0,83.04,19916.96,WellsFargo2,31,4
1,19916.96,191.04,107.55,83.49,19833.47,WellsFargo2,31,4
2,19833.47,191.04,107.1,83.94,19749.53,WellsFargo2,31,4
3,19749.53,191.04,106.65,84.39,19665.14,WellsFargo2,31,4
4,19665.14,191.04,106.19,84.85,19580.29,WellsFargo2,31,4
5,19580.29,191.04,105.73,85.31,19494.98,WellsFargo2,31,4
6,19494.98,191.04,105.27,85.77,19409.21,WellsFargo2,31,4
7,19409.21,191.04,104.81,86.23,19322.98,WellsFargo2,31,4
8,19322.98,191.04,104.34,86.7,19236.28,WellsFargo2,31,4
9,19236.28,191.04,103.88,87.16,19149.12,WellsFargo2,31,4
10,19149.12,191.04,103.41,87.63,19061.49,WellsFargo2,31,4
11,19061.49,191.04,102.93,88.11,18973.38,WellsFargo2,31,4
12,18973.38,1637.12,102.46,1534.66,17438.72,WellsFargo2,31,4
13,17438.72,1678.66,94.17,1584.49,15854.23,WellsFargo2,31,4
14,15854.23,1678.66,85.61,1593.05,14261.18,WellsFargo2,31,4
15,14261.18,1678.66,77.01,1601.65,12659.53,WellsFargo2,31,4
16,12659.53,1678.66,68.36,1610.3,11049.23,WellsFargo2,31,4
17,11049.23,1678.66,59.67,1618.99,9430.24,WellsFargo2,31,4
18,9430.24,1678.66,50.92,1627.74,7802.5,WellsFargo2,31,4
19,7802.5,1678.66,42.13,1636.53,6165.97,WellsFargo2,31,4
20,6165.97,1678.66,33.3,1645.36,4520.61,WellsFargo2,31,4
21,4520.61,1678.66,24.41,1654.25,2866.36,WellsFargo2,31,4
22,2866.36,1678.66,15.48,1663.18,1203.18,WellsFargo2,31,4
23,1203.18,1678.66,6.5,1672.16,-468.98,WellsFargo2,31,4
0,180000.0,1331.44,594.0,737.44,179262.56,mortgage,31,5
1,179262.56,1331.44,591.57,739.87,178522.69,mortgage,31,5
2,178522.69,1331.44,589.12,742.32,177780.37,mortgage,31,5
3,177780.37,1331.44,586.68,744.76,177035.61,mortgage,31,5
4,177035.61,1331.44,584.22,747.22,176288.39,mortgage,31,5
5,176288.39,1331.44,581.75,749.69,175538.7,mortgage,31,5
6,175538.7,1331.44,579.28,752.16,174786.54,mortgage,31,5
7,174786.54,1331.44,576.8,754.64,174031.9,mortgage,31,5
8,174031.9,1331.44,574.31,757.13,173274.77,mortgage,31,5
9,173274.77,1331.44,571.81,759.63,172515.14,mortgage,31,5
10,172515.14,1331.44,569.3,762.14,171753.0,mortgage,31,5
11,171753.0,1331.44,566.78,764.66,170988.34,mortgage,31,5
12,170988.34,1331.44,564.26,767.18,170221.16,mortgage,31,5
13,170221.16,1331.44,561.73,769.71,169451.45,mortgage,31,5
14,169451.45,1331.44,559.19,772.25,168679.2,mortgage,31,5
15,168679.2,1331.44,556.64,774.8,167904.4,mortgage,31,5
16,167904.4,1331.44,554.08,777.36,167127.04,mortgage,31,5
17,167127.04,1331.44,551.52,779.92,166347.12,mortgage,31,5
18,166347.12,1331.44,548.95,782.49,165564.63,mortgage,31,5
19,165564.63,1331.44,546.36,785.08,164779.55,mortgage,31,5
20,164779.55,1331.44,543.77,787.67,163991.88,mortgage,31,5
21,163991.88,1331.44,541.17,790.27,163201.61,mortgage,31,5
22,163201.61,1331.44,538.57,792.87,162408.74,mortgage,31,5
23,162408.74,1800.42,535.95,1264.47,161144.27,mortgage,31,5
24,161144.27,3010.1,531.78,2478.32,158665.95,mortgage,31,5
25,158665.95,3010.1,523.6,2486.5,156179.45,mortgage,31,5
26,156179.45,3010.1,515.39,2494.71,153684.74,mortgage,31,5
27,153684.74,3010.1,507.16,2502.94,151181.8,mortgage,31,5
28,151181.8,3010.1,498.9,2511.2,148670.6,mortgage,31,5
29,148670.6,3010.1,490.61,2519.49,146151.11,mortgage,31,5
30,146151.11,3010.1,482.3,2527.8,143623.31,mortgage,31,5
31,143623.31,3010.1,473.96,2536.14,141087.17,mortgage,31,5
32,141087.17,3010.1,465.59,2544.51,138542.66,mortgage,31,5
33,138542.66,3010.1,457.19,2552.91,135989.75,mortgage,31,5
34,135989.75,3010.1,448.77,2561.33,133428.42,mortgage,31,5
35,133428.42,3010.1,440.31,2569.79,130858.63,mortgage,31,5
36,130858.63,3010.1,431.83,2578.27,128280.36,mortgage,31,5
37,128280.36,3010.1,423.33,2586.77,125693.59,mortgage,31,5
38,125693.59,3010.1,414.79,2595.31,123098.28,mortgage,31,5
39,123098.28,3010.1,406.22,2603.88,120494.4,mortgage,31,5
40,120494.4,3010.1,397.63,2612.47,117881.93,mortgage,31,5
41,117881.93,3010.1,389.01,2621.09,115260.84,mortgage,31,5
42,115260.84,3010.1,380.36,2629.74,112631.1,mortgage,31,5
43,112631.1,3010.1,371.68,2638.42,109992.68,mortgage,31,5
44,109992.68,3010.1,362.98,2647.12,107345.56,mortgage,31,5
45,107345.56,3010.1,354.24,2655.86,104689.7,mortgage,31,5
46,104689.7,3010.1,345.48,2664.62,102025.08,mortgage,31,5
47,102025.08,3010.1,336.68,2673.42,99351.66,mortgage,31,5
48,99351.66,3010.1,327.86,2682.24,96669.42,mortgage,31,5
49,96669.42,3010.1,319.01,2691.09,93978.33,mortgage,31,5
50,93978.33,3010.1,310.13,2699.97,91278.36,mortgage,31,5
51,91278.36,3010.1,301.22,2708.88,88569.48,mortgage,31,5
52,88569.48,3010.1,292.28,2717.82,85851.66,mortgage,31,5
53,85851.66,3010.1,283.31,2726.79,83124.87,mortgage,31,5
54,83124.87,3010.1,274.31,2735.79,80389.08,mortgage,31,5
55,80389.08,3010.1,265.28,2744.82,77644.26,mortgage,31,5
56,77644.26,3010.1,256.23,2753.87,74890.39,mortgage,31,5
57,74890.39,3010.1,247.14,2762.96,72127.43,mortgage,31,5
58,72127.43,3010.1,238.02,2772.08,69355.35,mortgage,31,5
59,69355.35,3010.1,228.87,2781.23,66574.12,mortgage,31,5
60,66574.12,3010.1,219.69,2790.41,63783.71,mortgage,31,5
61,63783.71,3010.1,210.49,2799.61,60984.1,mortgage,31,5
62,60984.1,3010.1,201.25,2808.85,58175.25,mortgage,31,5
63,58175.25,3010.1,191.98,2818.12,55357.13,mortgage,31,5
64,55357.13,3010.1,182.68,2827.42,52529.71,mortgage,31,5
65,52529.71,3010.1,173.35,2836.75,49692.96,mortgage,31,5
66,49692.96,3010.1,163.99,2846.11,46846.85,mortgage,31,5
67,46846.85,3010.1,154.59,2855.51,43991.34,mortgage,31,5
68,43991.34,3010.1,145.17,2864.93,41126.41,mortgage,31,5
69,41126.41,3010.1,135.72,2874.38,38252.03,mortgage,31,5
70,38252.03,3010.1,126.23,2883.87,35368.16,mortgage,31,5
71,35368.16,3010.1,116.71,2893.39,32474.77,mortgage,31,5
72,32474.77,3010.1,107.17,2902.93,29571.84,mortgage,31,5
73,29571.84,3010.1,97.59,2912.51,26659.33,mortgage,31,5
74,26659.33,3010.1,87.98,2922.12,23737.21,mortgage,31,5
75,23737.21,3010.1,78.33,2931.77,20805.44,mortgage,31,5
76,20805.44,3010.1,68.66,2941.44,17864.0,mortgage,31,5
77,17864.0,3010.1,58.95,2951.15,14912.85,mortgage,31,5
78,14912.85,3010.1,49.21,2960.89,11951.96,mortgage,31,5
79,11951.96,3010.1,39.44,2970.66,8981.3,mortgage,31,5
80,8981.3,3010.1,29.64,2980.46,6000.84,mortgage,31,5
81,6000.84,3010.1,19.8,2990.3,3010.54,mortgage,31,5
82,3010.54,3010.1,9.93,3000.17,10.37,mortgage,31,5
83,10.37,3010.1,0.03,3010.07,-2999.7,mortgage,31,5
0,5000.0,1333.0,36.0,1297.0,3703.0,Car,32,1
1,3703.0,1333.0,26.66,1306.34,2396.66,Car,32,1
2,2396.66,1333.0,17.26,1315.74,1080.92,Car,32,1
3,1080.92,1333.0,7.78,1325.22,-244.3,Car,32,1
0,8250.57,84.62,53.63,30.99,8219.58,WellsFargo1,32,2
1,8219.58,84.62,53.43,31.19,8188.39,WellsFargo1,32,2
2,8188.39,84.62,53.22,31.4,8156.99,WellsFargo1,32,2
3,8156.99,328.92,53.02,275.9,7881.09,WellsFargo1,32,2
4,7881.09,1417.62,51.23,1366.39,6514.7,WellsFargo1,32,2
5,6514.7,1417.62,42.35,1375.27,5139.43,WellsFargo1,32,2
6,5139.43,1417.62,33.41,1384.21,3755.22,WellsFargo1,32,2
7,3755.22,1417.62,24.41,1393.21,2362.01,WellsFargo1,32,2
8,2362.01,1417.62,15.35,1402.27,959.74,WellsFargo1,32,2
9,959.74,1417.62,6.24,1411.38,-451.64,WellsFargo1,32,2
0,4000.0,70.0,16.0,54.0,3946.0,testing,32,3
1,3946.0,70.0,15.78,54.22,3891.78,testing,32,3
2,3891.78,70.0,15.57,54.43,3837.35,testing,32,3
3,3837.35,70.0,15.35,54.65,3782.7,testing,32,3
4,3782.7,70.0,15.13,54.87,3727.83,testing,32,3
5,3727.83,70.0,14.91,55.09,3672.74,testing,32,3
6,3672.74,70.0,14.69,55.31,3617.43,testing,32,3
7,3617.43,70.0,14.47,55.53,3561.9,testing,32,3
8,3561.9,70.0,14.25,55.75,3506.15,testing,32,3
9,3506.15,521.64,14.02,507.62,2998.53,testing,32,3
10,2998.53,1487.62,11.99,1475.63,1522.9,testing,32,3
11,1522.9,1487.62,6.09,1481.53,41.37,testing,32,3
12,41.37,1487.62,0.17,1487.45,-1446.08,testing,32,3
0,180000.0,1331.44,594.0,737.44,179262.56,mortgage,32,4
1,179262.56,1331.44,591.57,739.87,178522.69,mortgage,32,4
2,178522.69,1331.44,589.12,742.32,177780.37,mortgage,32,4
3,177780.37,1331.44,586.68,744.76,177035.61,mortgage,32,4
4,177035.61,1331.44,584.22,747.22,176288.39,mortgage,32,4
5,176288.39,1331.44,581.75,749.69,175538.7,mortgage,32,4
6,175538.7,1331.44,579.28,752.16,174786.54,mortgage,32,4
7,174786.54,1331.44,576.8,754.64,174031.9,mortgage,32,4
8,174031.9,1331.44,574.31,757.13,173274.77,mortgage,32,4
9,173274.77,1331.44,571.81,759.63,172515.14,mortgage,32,4
10,172515.14,1331.44,569.3,762.14,171753.0,mortgage,32,4
11,171753.0,1331.44,566.78,764.66,170988.34,mortgage,32,4
12,170988.34,2777.52,564.26,2213.26,168775.08,mortgage,32,4
13,168775.08,2819.06,556.96,2262.1,166512.98,mortgage,32,4
14,166512.98,2819.06,549.49,2269.57,164243.41,mortgage,32,4
15,164243.41,2819.06,542.0,2277.06,161966.35,mortgage,32,4
16,161966.35,2819.06,534.49,2284.57,159681.78,mortgage,32,4
17,159681.78,2819.06,526.95,2292.11,157389.67,mortgage,32,4
18,157389.67,2819.06,519.39,2299.67,155090.0,mortgage,32,4
19,155090.0,2819.06,511.8,2307.26,152782.74,mortgage,32,4
20,152782.74,2819.06,504.18,2314.88,150467.86,mortgage,32,4
21,150467.86,2819.06,496.54,2322.52,148145.34,mortgage,32,4
22,148145.34,2819.06,488.88,2330.18,145815.16,mortgage,32,4
23,145815.16,2819.06,481.19,2337.87,143477.29,mortgage,32,4
24,143477.29,2819.06,473.48,2345.58,141131.71,mortgage,32,4
25,141131.71,2819.06,465.73,2353.33,138778.38,mortgage,32,4
26,138778.38,2819.06,457.97,2361.09,136417.29,mortgage,32,4
27,136417.29,2819.06,450.18,2368.88,134048.41,mortgage,32,4
28,134048.41,2819.06,442.36,2376.7,131671.71,mortgage,32,4
29,131671.71,2819.06,434.52,2384.54,129287.17,mortgage,32,4
30,129287.17,2819.06,426.65,2392.41,126894.76,mortgage,32,4
31,126894.76,2819.06,418.75,2400.31,124494.45,mortgage,32,4
32,124494.45,2819.06,410.83,2408.23,122086.22,mortgage,32,4
33,122086.22,2819.06,402.88,2416.18,119670.04,mortgage,32,4
34,119670.04,2819.06,394.91,2424.15,117245.89,mortgage,32,4
35,117245.89,2819.06,386.91,2432.15,114813.74,mortgage,32,4
36,114813.74,2819.06,378.89,2440.17,112373.57,mortgage,32,4
37,112373.57,2819.06,370.83,2448.23,109925.34,mortgage,32,4
38,109925.34,2819.06,362.75,2456.31,107469.03,mortgage,32,4
39,107469.03,2819.06,354.65,2464.41,105004.62,mortgage,32,4
40,105004.62,2819.06,346.52,2472.54,102532.08,mortgage,32,4
41,102532.08,2819.06,338.36,2480.7,100051.38,mortgage,32,4
42,100051.38,2819.06,330.17,2488.89,97562.49,mortgage,32,4
43,97562.49,2819.06,321.96,2497.1,95065.39,mortgage,32,4
44,95065.39,2819.06,313.72,2505.34,92560.05,mortgage,32,4
45,92560.05,2819.06,305.45,2513.61,90046.44,mortgage,32,4
46,90046.44,2819.06,297.15,2521.91,87524.53,mortgage,32,4
47,87524.53,2819.06,288.83,2530.23,84994.3,mortgage,32,4
48,84994.3,2819.06,280.48,2538.58,82455.72,mortgage,32,4
49,82455.72,2819.06,272.1,2546.96,79908.76,mortgage,32,4
50,79908.76,2819.06,263.7,2555.36,77353.4,mortgage,32,4
51,77353.4,2819.06,255.27,2563.79,74789.61,mortgage,32,4
52,74789.61,2819.06,246.81,2572.25,72217.36,mortgage,32,4
53,72217.36,2819.06,238.32,2580.74,69636.62,mortgage,32,4
54,69636.62,2819.06,229.8,2589.26,67047.36,mortgage,32,4
55,67047.36,2819.06,221.26,2597.8,64449.56,mortgage,32,4
56,64449.56,2819.06,212.68,2606.38,61843.18,mortgage,32,4
57,61843.18,2819.06,204.08,2614.98,59228.2,mortgage,32,4
58,59228.2,2819.06,195.45,2623.61,56604.59,mortgage,32,4
59,56604.59,2819.06,186.8,2632.26,53972.33,mortgage,32,4
60,53972.33,2819.06,178.11,2640.95,51331.38,mortgage,32,4
61,51331.38,2819.06,169.39,2649.67,48681.71,mortgage,32,4
62,48681.71,2819.06,160.65,2658.41,46023.3,mortgage,32,4
63,46023.3,2819.06,151.88,2667.18,43356.12,mortgage,32,4
64,43356.12,2819.06,143.08,2675.98,40680.14,mortgage,32,4
65,40680.14,2819.06,134.24,2684.82,37995.32,mortgage,32,4
66,37995.32,2819.06,125.38,2693.68,35301.64,mortgage,32,4
67,35301.64,2819.06,116.5,2702.56,32599.08,mortgage,32,4
68,32599.08,2819.06,107.58,2711.48,29887.6,mortgage,32,4
69,29887.6,2819.06,98.63,2720.43,27167.17,mortgage,32,4
70,27167.17,2819.06,89.65,2729.41,24437.76,mortgage,32,4
71,24437.76,2819.06,80.64,2738.42,21699.34,mortgage,32,4
72,21699.34,2819.06,71.61,2747.45,18951.89,mortgage,32,4
73,18951.89,2819.06,62.54,2756.52,16195.37,mortgage,32,4
74,16195.37,2819.06,53.44,2765.62,13429.75,mortgage,32,4
75,13429.75,2819.06,44.32,2774.74,10655.01,mortgage,32,4
76,10655.01,2819.06,35.16,2783.9,7871.11,mortgage,32,4
77,7871.11,2819.06,25.97,2793.09,5078.02,mortgage,32,4
78,5078.02,2819.06,16.76,2802.3,2275.72,mortgage,32,4
79,2275.72,2819.06,7.51,2811.55,-535.83,mortgage,32,4
0,20000.0,191.04,108.0,83.04,19916.96,WellsFargo2,32,5
1,19916.96,191.04,107.55,83.49,19833.47,WellsFargo2,32,5
2,19833.47,191.04,107.1,83.94,19749.53,WellsFargo2,32,5
3,19749.53,191.04,106.65,84.39,19665.14,WellsFargo2,32,5
4,19665.14,191.04,106.19,84.85,19580.29,WellsFargo2,32,5
5,19580.29,191.04,105.73,85.31,19494.98,WellsFargo2,32,5
6,19494.98,191.04,105.27,85.77,19409.21,WellsFargo2,32,5
7,19409.21,191.04,104.81,86.23,19322.98,WellsFargo2,32,5
8,19322.98,191.04,104.34,86.7,19236.28,WellsFargo2,32,5
9,19236.28,191.04,103.88,87.16,19149.12,WellsFargo2,32,5
10,19149.12,191.04,103.41,87.63,19061.49,WellsFargo2,32,5
11,19061.49,191.04,102.93,88.11,18973.38,WellsFargo2,32,5
12,18973.38,191.04,102.46,88.58,18884.8,WellsFargo2,32,5
13,18884.8,191.04,101.98,89.06,18795.74,WellsFargo2,32,5
14,18795.74,191.04,101.5,89.54,18706.2,WellsFargo2,32,5
15,18706.2,191.04,101.01,90.03,18616.17,WellsFargo2,32,5
16,18616.17,191.04,100.53,90.51,18525.66,WellsFargo2,32,5
17,18525.66,191.04,100.04,91.0,18434.66,WellsFargo2,32,5
18,18434.66,191.04,99.55,91.49,18343.17,WellsFargo2,32,5
19,18343.17,191.04,99.05,91.99,18251.18,WellsFargo2,32,5
20,18251.18,191.04,98.56,92.48,18158.7,WellsFargo2,32,5
21,18158.7,191.04,98.06,92.98,18065.72,WellsFargo2,32,5
22,18065.72,191.04,97.55,93.49,17972.23,WellsFargo2,32,5
23,17972.23,191.04,97.05,93.99,17878.24,WellsFargo2,32,5
24,17878.24,191.04,96.54,94.5,17783.74,WellsFargo2,32,5
25,17783.74,191.04,96.03,95.01,17688.73,WellsFargo2,32,5
26,17688.73,191.04,95.52,95.52,17593.21,WellsFargo2,32,5
27,17593.21,191.04,95.0,96.04,17497.17,WellsFargo2,32,5
28,17497.17,191.04,94.48,96.56,17400.61,WellsFargo2,32,5
29,17400.61,191.04,93.96,97.08,17303.53,WellsFargo2,32,5
30,17303.53,191.04,93.44,97.6,17205.93,WellsFargo2,32,5
31,17205.93,191.04,92.91,98.13,17107.8,WellsFargo2,32,5
32,17107.8,191.04,92.38,98.66,17009.14,WellsFargo2,32,5
33,17009.14,191.04,91.85,99.19,16909.95,WellsFargo2,32,5
34,16909.95,191.04,91.31,99.73,16810.22,WellsFargo2,32,5
35,16810.22,191.04,90.78,100.26,16709.96,WellsFargo2,32,5
36,16709.96,191.04,90.23,100.81,16609.15,WellsFargo2,32,5
37,16609.15,191.04,89.69,101.35,16507.8,WellsFargo2,32,5
38,16507.8,191.04,89.14,101.9,16405.9,WellsFargo2,32,5
39,16405.9,191.04,88.59,102.45,16303.45,WellsFargo2,32,5
40,16303.45,191.04,88.04,103.0,16200.45,WellsFargo2,32,5
41,16200.45,191.04,87.48,103.56,16096.89,WellsFargo2,32,5
42,16096.89,191.04,86.92,104.12,15992.77,WellsFargo2,32,5
43,15992.77,191.04,86.36,104.68,15888.09,WellsFargo2,32,5
44,15888.09,191.04,85.8,105.24,15782.85,WellsFargo2,32,5
45,15782.85,191.04,85.23,105.81,15677.04,WellsFargo2,32,5
46,15677.04,191.04,84.66,106.38,15570.66,WellsFargo2,32,5
47,15570.66,191.04,84.08,106.96,15463.7,WellsFargo2,32,5
48,15463.7,191.04,83.5,107.54,15356.16,WellsFargo2,32,5
49,15356.16,191.04,82.92,108.12,15248.04,WellsFargo2,32,5
50,15248.04,191.04,82.34,108.7,15139.34,WellsFargo2,32,5
51,15139.34,191.04,81.75,109.29,15030.05,WellsFargo2,32,5
52,15030.05,191.04,81.16,109.88,14920.17,WellsFargo2,32,5
53,14920.17,191.04,80.57,110.47,14809.7,WellsFargo2,32,5
54,14809.7,191.04,79.97,111.07,14698.63,WellsFargo2,32,5
55,14698.63,191.04,79.37,111.67,14586.96,WellsFargo2,32,5
56,14586.96,191.04,78.77,112.27,14474.69,WellsFargo2,32,5
57,14474.69,191.04,78.16,112.88,14361.81,WellsFargo2,32,5
58,14361.81,191.04,77.55,113.49,14248.32,WellsFargo2,32,5
59,14248.32,191.04,76.94,114.1,14134.22,WellsFargo2,32,5
60,14134.22,191.04,76.32,114.72,14019.5,WellsFargo2,32,5
61,14019.5,191.04,75.71,115.33,13904.17,WellsFargo2,32,5
62,13904.17,191.04,75.08,115.96,13788.21,WellsFargo2,32,5
63,13788.21,191.04,74.46,116.58,13671.63,WellsFargo2,32,5
64,13671.63,191.04,73.83,117.21,13554.42,WellsFargo2,32,5
65,13554.42,191.04,73.19,117.85,13436.57,WellsFargo2,32,5
66,13436.57,191.04,72.56,118.48,13318.09,WellsFargo2,32,5
67,13318.09,191.04,71.92,119.12,13198.97,WellsFargo2,32,5
68,13198.97,191.04,71.27,119.77,13079.2,WellsFargo2,32,5
69,13079.2,191.04,70.63,120.41,12958.79,WellsFargo2,32,5
70,12958.79,191.04,69.98,121.06,12837.73,WellsFargo2,32,5
71,12837.73,191.04,69.32,121.72,12716.01,WellsFargo2,32,5
72,12716.01,191.04,68.67,122.37,12593.64,WellsFargo2,32,5
73,12593.64,191.04,68.01,123.03,12470.61,WellsFargo2,32,5
74,12470.61,191.04,67.34,123.7,12346.91,WellsFargo2,32,5
75,12346.91,191.04,66.67,124.37,12222.54,WellsFargo2,32,5
76,12222.54,191.04,66.0,125.04,12097.5,WellsFargo2,32,5
77,12097.5,191.04,65.33,125.71,11971.79,WellsFargo2,32,5
78,11971.79,191.04,64.65,126.39,11845.4,WellsFargo2,32,5
79,11845.4,726.87,63.97,662.9,11182.5,WellsFargo2,32,5
80,11182.5,3010.1,60.39,2949.71,8232.79,WellsFargo2,32,5
81,8232.79,3010.1,44.46,2965.64,5267.15,WellsFargo2,32,5
82,5267.15,3010.1,28.44,2981.66,2285.49,WellsFargo2,32,5
83,2285.49,3010.1,12.34,2997.76,-712.27,WellsFargo2,32,5
0,5000.0,1333.0,36.0,1297.0,3703.0,Car,33,1
1,3703.0,1333.0,26.66,1306.34,2396.66,Car,33,1
2,2396.66,1333.0,17.26,1315.74,1080.92,Car,33,1
3,1080.92,1333.0,7.78,1325.22,-244.3,Car,33,1
0,8250.57,84.62,53.63,30.99,8219.58,WellsFargo1,33,2
1,8219.58,84.62,53.43,31.19,8188.39,WellsFargo1,33,2
2,8188.39,84.62,53.22,31.4,8156.99,WellsFargo1,33,2
3,8156.99,328.92,53.02,275.9,7881.09,WellsFargo1,33,2
4,7881.09,1417.62,51.23,1366.39,6514.7,WellsFargo1,33,2
5,6514.7,1417.62,42.35,1375.27,5139.43,WellsFargo1,33,2
6,5139.43,1417.62,33.41,1384.21,3755.22,WellsFargo1,33,2
7,3755.22,1417.62,24.41,1393.21,2362.01,WellsFargo1,33,2
8,2362.01,1417.62,15.35,1402.27,959.74,WellsFargo1,33,2
9,959.74,1417.62,6.24,1411.38,-451.64,WellsFargo1,33,2
0,20000.0,191.04,108.0,83.04,19916.96,WellsFargo2,33,3
1,19916.96,191.04,107.55,83.49,19833.47,WellsFargo2,33,3
2,19833.47,191.04,107.1,83.94,19749.53,WellsFargo2,33,3
3,19749.53,191.04,106.65,84.39,19665.14,WellsFargo2,33,3
4,19665.14,191.04,106.19,84.85,19580.29,WellsFargo2,33,3
5,19580.29,191.04,105.73,85.31,19494.98,WellsFargo2,33,3
6,19494.98,191.04,105.27,85.77,19409.21,WellsFargo2,33,3
7,19409.21,191.04,104.81,86.23,19322.98,WellsFargo2,33,3
8,19322.98,191.04,104.34,86.7,19236.28,WellsFargo2,33,3
9,19236.28,642.68,103.88,538.8,18697.48,WellsFargo2,33,3
10,18697.48,1608.66,100.97,1507.69,17189.79,WellsFargo2,33,3
11,17189.79,1608.66,92.82,1515.84,15673.95,WellsFargo2,33,3
12,15673.95,1608.66,84.64,1524.02,14149.93,WellsFargo2,33,3
13,14149.93,1608.66,76.41,1532.25,12617.68,WellsFargo2,33,3
14,12617.68,1608.66,68.14,1540.52,11077.16,WellsFargo2,33,3
15,11077.16,1608.66,59.82,1548.84,9528.32,WellsFargo2,33,3
16,9528.32,1608.66,51.45,1557.21,7971.11,WellsFargo2,33,3
17,7971.11,1608.66,43.04,1565.62,6405.49,WellsFargo2,33,3
18,6405.49,1608.66,34.59,1574.07,4831.42,WellsFargo2,33,3
19,4831.42,1608.66,26.09,1582.57,3248.85,WellsFargo2,33,3
20,3248.85,1608.66,17.54,1591.12,1657.73,WellsFargo2,33,3
21,1657.73,1608.66,8.95,1599.71,58.02,WellsFargo2,33,3
22,58.02,1608.66,0.31,1608.35,-1550.33,WellsFargo2,33,3
0,4000.0,70.0,16.0,54.0,3946.0,testing,33,4
1,3946.0,70.0,15.78,54.22,3891.78,testing,33,4
2,3891.78,70.0,15.57,54.43,3837.35,testing,33,4
3,3837.35,70.0,15.35,54.65,3782.7,testing,33,4
4,3782.7,70.0,15.13,54.87,3727.83,testing,33,4
5,3727.83,70.0,14.91,55.09,3672.74,testing,33,4
6,3672.74,70.0,14.69,55.31,3617.43,testing,33,4
7,3617.43,70.0,14.47,55.53,3561.9,testing,33,4
8,3561.9,70.0,14.25,55.75,3506.15,testing,33,4
9,3506.15,70.0,14.02,55.98,3450.17,testing,33,4
10,3450.17,70.0,13.8,56.2,3393.97,testing,33,4
11,3393.97,70.0,13.58,56.42,3337.55,testing,33,4
12,3337.55,70.0,13.35,56.65,3280.9,testing,33,4
13,3280.9,70.0,13.12,56.88,3224.02,testing,33,4
14,3224.02,70.0,12.9,57.1,3166.92,testing,33,4
15,3166.92,70.0,12.67,57.33,3109.59,testing,33,4
16,3109.59,70.0,12.44,57.56,3052.03,testing,33,4
17,3052.03,70.0,12.21,57.79,2994.24,testing,33,4
18,2994.24,70.0,11.98,58.02,2936.22,testing,33,4
19,2936.22,70.0,11.74,58.26,2877.96,testing,33,4
20,2877.96,70.0,11.51,58.49,2819.47,testing,33,4
21,2819.47,70.0,11.28,58.72,2760.75,testing,33,4
22,2760.75,1620.33,11.04,1609.29,1151.46,testing,33,4
23,1151.46,1678.66,4.61,1674.05,-522.59,testing,33,4
0,180000.0,1331.44,594.0,737.44,179262.56,mortgage,33,5
1,179262.56,1331.44,591.57,739.87,178522.69,mortgage,33,5
2,178522.69,1331.44,589.12,742.32,177780.37,mortgage,33,5
3,177780.37,1331.44,586.68,744.76,177035.61,mortgage,33,5
4,177035.61,1331.44,584.22,747.22,176288.39,mortgage,33,5
5,176288.39,1331.44,581.75,749.69,175538.7,mortgage,33,5
6,175538.7,1331.44,579.28,752.16,174786.54,mortgage,33,5
7,174786.54,1331.44,576.8,754.64,174031.9,mortgage,33,5
8,174031.9,1331.44,574.31,757.13,173274.77,mortgage,33,5
9,173274.77,1331.44,571.81,759.63,172515.14,mortgage,33,5
10,172515.14,1331.44,569.3,762.14,171753.0,mortgage,33,5
11,171753.0,1331.44,566.78,764.66,170988.34,mortgage,33,5
12,170988.34,1331.44,564.26,767.18,170221.16,mortgage,33,5
13,170221.16,1331.44,561.73,769.71,169451.45,mortgage,33,5
14,169451.45,1331.44,559.19,772.25,168679.2,mortgage,33,5
15,168679.2,1331.44,556.64,774.8,167904.4,mortgage,33,5
16,167904.4,1331.44,554.08,777.36,167127.04,mortgage,33,5
17,167127.04,1331.44,551.52,779.92,166347.12,mortgage,33,5
18,166347.12,1331.44,548.95,782.49,165564.63,mortgage,33,5
19,165564.63,1331.44,546.36,785.08,164779.55,mortgage,33,5
20,164779.55,1331.44,543.77,787.67,163991.88,mortgage,33,5
21,163991.88,1331.44,541.17,790.27,163201.61,mortgage,33,5
22,163201.61,1331.44,538.57,792.87,162408.74,mortgage,33,5
23,162408.74,1854.03,535.95,1318.08,161090.66,mortgage,33,5
24,161090.66,3010.1,531.6,2478.5,158612.16,mortgage,33,5
25,158612.16,3010.1,523.42,2486.68,156125.48,mortgage,33,5
26,156125.48,3010.1,515.21,2494.89,153630.59,mortgage,33,5
27,153630.59,3010.1,506.98,2503.12,151127.47,mortgage,33,5
28,151127.47,3010.1,498.72,2511.38,148616.09,mortgage,33,5
29,148616.09,3010.1,490.43,2519.67,146096.42,mortgage,33,5
30,146096.42,3010.1,482.12,2527.98,143568.44,mortgage,33,5
31,143568.44,3010.1,473.78,2536.32,141032.12,mortgage,33,5
32,141032.12,3010.1,465.41,2544.69,138487.43,mortgage,33,5
33,138487.43,3010.1,457.01,2553.09,135934.34,mortgage,33,5
34,135934.34,3010.1,448.58,2561.52,133372.82,mortgage,33,5
35,133372.82,3010.1,440.13,2569.97,130802.85,mortgage,33,5
36,130802.85,3010.1,431.65,2578.45,128224.4,mortgage,33,5
37,128224.4,3010.1,423.14,2586.96,125637.44,mortgage,33,5
38,125637.44,3010.1,414.6,2595.5,123041.94,mortgage,33,5
39,123041.94,3010.1,406.04,2604.06,120437.88,mortgage,33,5
40,120437.88,3010.1,397.45,2612.65,117825.23,mortgage,33,5
41,117825.23,3010.1,388.82,2621.28,115203.95,mortgage,33,5
42,115203.95,3010.1,380.17,2629.93,112574.02,mortgage,33,5
43,112574.02,3010.1,371.49,2638.61,109935.41,mortgage,33,5
44,109935.41,3010.1,362.79,2647.31,107288.1,mortgage,33,5
45,107288.1,3010.1,354.05,2656.05,104632.05,mortgage,33,5
46,104632.05,3010.1,345.29,2664.81,101967.24,mortgage,33,5
47,101967.24,3010.1,336.49,2673.61,99293.63,mortgage,33,5
48,99293.63,3010.1,327.67,2682.43,96611.2,mortgage,33,5
49,96611.2,3010.1,318.82,2691.28,93919.92,mortgage,33,5
50,93919.92,3010.1,309.94,2700.16,91219.76,mortgage,33,5
51,91219.76,3010.1,301.03,2709.07,88510.69,mortgage,33,5
52,88510.69,3010.1,292.09,2718.01,85792.68,mortgage,33,5
53,85792.68,3010.1,283.12,2726.98,83065.7,mortgage,33,5
54,83065.7,3010.1,274.12,2735.98,80329.72,mortgage,33,5
55,80329.72,3010.1,265.09,2745.01,77584.71,mortgage,33,5
56,77584.71,3010.1,256.03,2754.07,74830.64,mortgage,33,5
57,74830.64,3010.1,246.94,2763.16,72067.48,mortgage,33,5
58,72067.48,3010.1,237.82,2772.28,69295.2,mortgage,33,5
59,69295.2,3010.1,228.67,2781.43,66513.77,mortgage,33,5
60,66513.77,3010.1,219.5,2790.6,63723.17,mortgage,33,5
61,63723.17,3010.1,210.29,2799.81,60923.36,mortgage,33,5
62,60923.36,3010.1,201.05,2809.05,58114.31,mortgage,33,5
63,58114.31,3010.1,191.78,2818.32,55295.99,mortgage,33,5
64,55295.99,3010.1,182.48,2827.62,52468.37,mortgage,33,5
65,52468.37,3010.1,173.15,2836.95,49631.42,mortgage,33,5
66,49631.42,3010.1,163.78,2846.32,46785.1,mortgage,33,5
67,46785.1,3010.1,154.39,2855.71,43929.39,mortgage,33,5
68,43929.39,3010.1,144.97,2865.13,41064.26,mortgage,33,5
69,41064.26,3010.1,135.51,2874.59,38189.67,mortgage,33,5
70,38189.67,3010.1,126.03,2884.07,35305.6,mortgage,33,5
71,35305.6,3010.1,116.51,2893.59,32412.01,mortgage,33,5
72,32412.01,3010.1,106.96,2903.14,29508.87,mortgage,33,5
73,29508.87,3010.1,97.38,2912.72,26596.15,mortgage,33,5
74,26596.15,3010.1,87.77,2922.33,23673.82,mortgage,33,5
75,23673.82,3010.1,78.12,2931.98,20741.84,mortgage,33,5
76,20741.84,3010.1,68.45,2941.65,17800.19,mortgage,33,5
77,17800.19,3010.1,58.74,2951.36,14848.83,mortgage,33,5
78,14848.83,3010.1,49.0,2961.1,11887.73,mortgage,33,5
79,11887.73,3010.1,39.23,2970.87,8916.86,mortgage,33,5
80,8916.86,3010.1,29.43,2980.67,5936.19,mortgage,33,5
81,5936.19,3010.1,19.59,2990.51,2945.68,mortgage,33,5
82,2945.68,3010.1,9.72,3000.38,-54.7,mortgage,33,5
0,5000.0,1333.0,36.0,1297.0,3703.0,Car,34,1
1,3703.0,1333.0,26.66,1306.34,2396.66,Car,34,1
2,2396.66,1333.0,17.26,1315.74,1080.92,Car,34,1
3,1080.92,1333.0,7.78,1325.22,-244.3,Car,34,1
0,8250.57,84.62,53.63,30.99,8219.58,WellsFargo1,34,2
1,8219.58,84.62,53.43,31.19,8188.39,WellsFargo1,34,2
2,8188.39,84.62,53.22,31.4,8156.99,WellsFargo1,34,2
3,8156.99,328.92,53.02,275.9,7881.09,WellsFargo1,34,2
4,7881.09,1417.62,51.23,1366.39,6514.7,WellsFargo1,34,2
5,6514.7,1417.62,42.35,1375.27,5139.43,WellsFargo1,34,2
6,5139.43,1417.62,33.41,1384.21,3755.22,WellsFargo1,34,2
7,3755.22,1417.62,24.41,1393.21,2362.01,WellsFargo1,34,2
8,2362.01,1417.62,15.35,1402.27,959.74,WellsFargo1,34,2
9,959.74,1417.62,6.24,1411.38,-451.64,WellsFargo1,34,2
0,20000.0,191.04,108.0,83.04,19916.96,WellsFargo2,34,3
1,19916.96,191.04,107.55,83.49,19833.47,WellsFargo2,34,3
2,19833.47,191.04,107.1,83.94,19749.53,WellsFargo2,34,3
3,19749.53,191.04,106.65,84.39,19665.14,WellsFargo2,34,3
4,19665.14,191.04,106.19,84.85,19580.29,WellsFargo2,34,3
5,19580.29,191.04,105.73,85.31,19494.98,WellsFargo2,34,3
6,19494.98,191.04,105.27,85.77,19409.21,WellsFargo2,34,3
7,19409.21,191.04,104.81,86.23,19322.98,WellsFargo2,34,3
8,19322.98,191.04,104.34,86.7,19236.28,WellsFargo2,34,3
9,19236.28,642.68,103.88,538.8,18697.48,WellsFargo2,34,3
10,18697.48,1608.66,100.97,1507.69,17189.79,WellsFargo2,34,3
11,17189.79,1608.66,92.82,1515.84,15673.95,WellsFargo2,34,3
12,15673.95,1608.66,84.64,1524.02,14149.93,WellsFargo2,34,3
13,14149.93,1608.66,76.41,1532.25,12617.68,WellsFargo2,34,3
14,12617.68,1608.66,68.14,1540.52,11077.16,WellsFargo2,34,3
15,11077.16,1608.66,59.82,1548.84,9528.32,WellsFargo2,34,3
16,9528.32,1608.66,51.45,1557.21,7971.11,WellsFargo2,34,3
17,7971.11,1608.66,43.04,1565.62,6405.49,WellsFargo2,34,3
18,6405.49,1608.66,34.59,1574.07,4831.42,WellsFargo2,34,3
19,4831.42,1608.66,26.09,1582.57,3248.85,WellsFargo2,34,3
20,3248.85,1608.66,17.54,1591.12,1657.73,WellsFargo2,34,3
21,1657.73,1608.66,8.95,1599.71,58.02,WellsFargo2,34,3
22,58.02,1608.66,0.31,1608.35,-1550.33,WellsFargo2,34,3
0,180000.0,1331.44,594.0,737.44,179262.56,mortgage,34,4
1,179262.56,1331.44,591.57,739.87,178522.69,mortgage,34,4
2,178522.69,1331.44,589.12,742.32,177780.37,mortgage,34,4
3,177780.37,1331.44,586.68,744.76,177035.61,mortgage,34,4
4,177035.61,1331.44,584.22,747.22,176288.39,mortgage,34,4
5,176288.39,1331.44,581.75,749.69,175538.7,mortgage,34,4
6,175538.7,1331.44,579.28,752.16,174786.54,mortgage,34,4
7,174786.54,1331.44,576.8,754.64,174031.9,mortgage,34,4
8,174031.9,1331.44,574.31,757.13,173274.77,mortgage,34,4
9,173274.77,1331.44,571.81,759.63,172515.14,mortgage,34,4
10,172515.14,1331.44,569.3,762.14,171753.0,mortgage,34,4
11,171753.0,1331.44,566.78,764.66,170988.34,mortgage,34,4
12,170988.34,1331.44,564.26,767.18,170221.16,mortgage,34,4
13,170221.16,1331.44,561.73,769.71,169451.45,mortgage,34,4
14,169451.45,1331.44,559.19,772.25,168679.2,mortgage,34,4
15,168679.2,1331.44,556.64,774.8,167904.4,mortgage,34,4
16,167904.4,1331.44,554.08,777.36,167127.04,mortgage,34,4
17,167127.04,1331.44,551.52,779.92,166347.12,mortgage,34,4
18,166347.12,1331.44,548.95,782.49,165564.63,mortgage,34,4
19,165564.63,1331.44,546.36,785.08,164779.55,mortgage,34,4
20,164779.55,1331.44,543.77,787.67,163991.88,mortgage,34,4
21,163991.88,1331.44,541.17,790.27,163201.61,mortgage,34,4
22,163201.61,2881.77,538.57,2343.2,160858.41,mortgage,34,4
23,160858.41,2940.1,530.83,2409.27,158449.14,mortgage,34,4
24,158449.14,2940.1,522.88,2417.22,156031.92,mortgage,34,4
25,156031.92,2940.1,514.91,2425.19,153606.73,mortgage,34,4
26,153606.73,2940.1,506.9,2433.2,151173.53,mortgage,34,4
27,151173.53,2940.1,498.87,2441.23,148732.3,mortgage,34,4
28,148732.3,2940.1,490.82,2449.28,146283.02,mortgage,34,4
29,146283.02,2940.1,482.73,2457.37,143825.65,mortgage,34,4
30,143825.65,2940.1,474.62,2465.48,141360.17,mortgage,34,4
31,141360.17,2940.1,466.49,2473.61,138886.56,mortgage,34,4
32,138886.56,2940.1,458.33,2481.77,136404.79,mortgage,34,4
33,136404.79,2940.1,450.14,2489.96,133914.83,mortgage,34,4
34,133914.83,2940.1,441.92,2498.18,131416.65,mortgage,34,4
35,131416.65,2940.1,433.67,2506.43,128910.22,mortgage,34,4
36,128910.22,2940.1,425.4,2514.7,126395.52,mortgage,34,4
37,126395.52,2940.1,417.11,2522.99,123872.53,mortgage,34,4
38,123872.53,2940.1,408.78,2531.32,121341.21,mortgage,34,4
39,121341.21,2940.1,400.43,2539.67,118801.54,mortgage,34,4
40,118801.54,2940.1,392.05,2548.05,116253.49,mortgage,34,4
41,116253.49,2940.1,383.64,2556.46,113697.03,mortgage,34,4
42,113697.03,2940.1,375.2,2564.9,111132.13,mortgage,34,4
43,111132.13,2940.1,366.74,2573.36,108558.77,mortgage,34,4
44,108558.77,2940.1,358.24,2581.86,105976.91,mortgage,34,4
45,105976.91,2940.1,349.72,2590.38,103386.53,mortgage,34,4
46,103386.53,2940.1,341.18,2598.92,100787.61,mortgage,34,4
47,100787.61,2940.1,332.6,2607.5,98180.11,mortgage,34,4
48,98180.11,2940.1,323.99,2616.11,95564.0,mortgage,34,4
49,95564.0,2940.1,315.36,2624.74,92939.26,mortgage,34,4
50,92939.26,2940.1,306.7,2633.4,90305.86,mortgage,34,4
51,90305.86,2940.1,298.01,2642.09,87663.77,mortgage,34,4
52,87663.77,2940.1,289.29,2650.81,85012.96,mortgage,34,4
53,85012.96,2940.1,280.54,2659.56,82353.4,mortgage,34,4
54,82353.4,2940.1,271.77,2668.33,79685.07,mortgage,34,4
55,79685.07,2940.1,262.96,2677.14,77007.93,mortgage,34,4
56,77007.93,2940.1,254.13,2685.97,74321.96,mortgage,34,4
57,74321.96,2940.1,245.26,2694.84,71627.12,mortgage,34,4
58,71627.12,2940.1,236.37,2703.73,68923.39,mortgage,34,4
59,68923.39,2940.1,227.45,2712.65,66210.74,mortgage,34,4
60,66210.74,2940.1,218.5,2721.6,63489.14,mortgage,34,4
61,63489.14,2940.1,209.51,2730.59,60758.55,mortgage,34,4
62,60758.55,2940.1,200.5,2739.6,58018.95,mortgage,34,4
63,58018.95,2940.1,191.46,2748.64,55270.31,mortgage,34,4
64,55270.31,2940.1,182.39,2757.71,52512.6,mortgage,34,4
65,52512.6,2940.1,173.29,2766.81,49745.79,mortgage,34,4
66,49745.79,2940.1,164.16,2775.94,46969.85,mortgage,34,4
67,46969.85,2940.1,155.0,2785.1,44184.75,mortgage,34,4
68,44184.75,2940.1,145.81,2794.29,41390.46,mortgage,34,4
69,41390.46,2940.1,136.59,2803.51,38586.95,mortgage,34,4
70,38586.95,2940.1,127.34,2812.76,35774.19,mortgage,34,4
71,35774.19,2940.1,118.05,2822.05,32952.14,mortgage,34,4
72,32952.14,2940.1,108.74,2831.36,30120.78,mortgage,34,4
73,30120.78,2940.1,99.4,2840.7,27280.08,mortgage,34,4
74,27280.08,2940.1,90.02,2850.08,24430.0,mortgage,34,4
75,24430.0,2940.1,80.62,2859.48,21570.52,mortgage,34,4
76,21570.52,2940.1,71.18,2868.92,18701.6,mortgage,34,4
77,18701.6,2940.1,61.72,2878.38,15823.22,mortgage,34,4
78,15823.22,2940.1,52.22,2887.88,12935.34,mortgage,34,4
79,12935.34,2940.1,42.69,2897.41,10037.93,mortgage,34,4
80,10037.93,2940.1,33.13,2906.97,7130.96,mortgage,34,4
81,7130.96,2940.1,23.53,2916.57,4214.39,mortgage,34,4
82,4214.39,2940.1,13.91,2926.19,1288.2,mortgage,34,4
83,1288.2,2940.1,4.25,2935.85,-1647.65,mortgage,34,4
0,4000.0,70.0,16.0,54.0,3946.0,testing,34,5
1,3946.0,70.0,15.78,54.22,3891.78,testing,34,5
2,3891.78,70.0,15.57,54.43,3837.35,testing,34,5
3,3837.35,70.0,15.35,54.65,3782.7,testing,34,5
4,3782.7,70.0,15.13,54.87,3727.83,testing,34,5
5,3727.83,70.0,14.91,55.09,3672.74,testing,34,5
6,3672.74,70.0,14.69,55.31,3617.43,testing,34,5
7,3617.43,70.0,14.47,55.53,3561.9,testing,34,5
8,3561.9,70.0,14.25,55.75,3506.15,testing,34,5
9,3506.15,70.0,14.02,55.98,3450.17,testing,34,5
10,3450.17,70.0,13.8,56.2,3393.97,testing,34,5
11,3393.97,70.0,13.58,56.42,3337.55,testing,34,5
12,3337.55,70.0,13.35,56.65,3280.9,testing,34,5
13,3280.9,70.0,13.12,56.88,3224.02,testing,34,5
14,3224.02,70.0,12.9,57.1,3166.92,testing,34,5
15,3166.92,70.0,12.67,57.33,3109.59,testing,34,5
16,3109.59,70.0,12.44,57.56,3052.03,testing,34,5
17,3052.03,70.0,12.21,57.79,2994.24,testing,34,5
18,2994.24,70.0,11.98,58.02,2936.22,testing,34,5
19,2936.22,70.0,11.74,58.26,2877.96,testing,34,5
20,2877.96,70.0,11.51,58.49,2819.47,testing,34,5
21,2819.47,70.0,11.28,58.72,2760.75,testing,34,5
22,2760.75,70.0,11.04,58.96,2701.79,testing,34,5
23,2701.79,70.0,10.81,59.19,2642.6,testing,34,5
24,2642.6,70.0,10.57,59.43,2583.17,testing,34,5
25,2583.17,70.0,10.33,59.67,2523.5,testing,34,5
26,2523.5,70.0,10.09,59.91,2463.59,testing,34,5
27,2463.59,70.0,9.85,60.15,2403.44,testing,34,5
28,2403.44,70.0,9.61,60.39,2343.05,testing,34,5
29,2343.05,70.0,9.37,60.63,2282.42,testing,34,5
30,2282.42,70.0,9.13,60.87,2221.55,testing,34,5
31,2221.55,70.0,8.89,61.11,2160.44,testing,34,5
32,2160.44,70.0,8.64,61.36,2099.08,testing,34,5
33,2099.08,70.0,8.4,61.6,2037.48,testing,34,5
34,2037.48,70.0,8.15,61.85,1975.63,testing,34,5
35,1975.63,70.0,7.9,62.1,1913.53,testing,34,5
36,1913.53,70.0,7.65,62.35,1851.18,testing,34,5
37,1851.18,70.0,7.4,62.6,1788.58,testing,34,5
38,1788.58,70.0,7.15,62.85,1725.73,testing,34,5
39,1725.73,70.0,6.9,63.1,1662.63,testing,34,5
40,1662.63,70.0,6.65,63.35,1599.28,testing,34,5
41,1599.28,70.0,6.4,63.6,1535.68,testing,34,5
42,1535.68,70.0,6.14,63.86,1471.82,testing,34,5
43,1471.82,70.0,5.89,64.11,1407.71,testing,34,5
44,1407.71,70.0,5.63,64.37,1343.34,testing,34,5
45,1343.34,70.0,5.37,64.63,1278.71,testing,34,5
46,1278.71,70.0,5.11,64.89,1213.82,testing,34,5
47,1213.82,70.0,4.86,65.14,1148.68,testing,34,5
48,1148.68,70.0,4.59,65.41,1083.27,testing,34,5
49,1083.27,70.0,4.33,65.67,1017.6,testing,34,5
50,1017.6,70.0,4.07,65.93,951.67,testing,34,5
51,951.67,70.0,3.81,66.19,885.48,testing,34,5
52,885.48,70.0,3.54,66.46,819.02,testing,34,5
53,819.02,70.0,3.28,66.72,752.3,testing,34,5
54,752.3,70.0,3.01,66.99,685.31,testing,34,5
55,685.31,70.0,2.74,67.26,618.05,testing,34,5
56,618.05,70.0,2.47,67.53,550.52,testing,34,5
57,550.52,70.0,2.2,67.8,482.72,testing,34,5
58,482.72,70.0,1.93,68.07,414.65,testing,34,5
59,414.65,70.0,1.66,68.34,346.31,testing,34,5
60,346.31,70.0,1.39,68.61,277.7,testing,34,5
61,277.7,70.0,1.11,68.89,208.81,testing,34,5
62,208.81,70.0,0.84,69.16,139.65,testing,34,5
63,139.65,70.0,0.56,69.44,70.21,testing,34,5
64,70.21,70.0,0.28,69.72,0.49,testing,34,5
65,0.49,70.0,0.0,70.0,-69.51,testing,34,5
0,5000.0,1333.0,36.0,1297.0,3703.0,Car,35,1
1,3703.0,1333.0,26.66,1306.34,2396.66,Car,35,1
2,2396.66,1333.0,17.26,1315.74,1080.92,Car,35,1
3,1080.92,1333.0,7.78,1325.22,-244.3,Car,35,1
0,8250.57,84.62,53.63,30.99,8219.58,WellsFargo1,35,2
1,8219.58,84.62,53.43,31.19,8188.39,WellsFargo1,35,2
2,8188.39,84.62,53.22,31.4,8156.99,WellsFargo1,35,2
3,8156.99,328.92,53.02,275.9,7881.09,WellsFargo1,35,2
4,7881.09,1417.62,51.23,1366.39,6514.7,WellsFargo1,35,2
5,6514.7,1417.62,42.35,1375.27,5139.43,WellsFargo1,35,2
6,5139.43,1417.62,33.41,1384.21,3755.22,WellsFargo1,35,2
7,3755.22,1417.62,24.41,1393.21,2362.01,WellsFargo1,35,2
8,2362.01,1417.62,15.35,1402.27,959.74,WellsFargo1,35,2
9,959.74,1417.62,6.24,1411.38,-451.64,WellsFargo1,35,2
0,180000.0,1331.44,594.0,737.44,179262.56,mortgage,35,3
1,179262.56,1331.44,591.57,739.87,178522.69,mortgage,35,3
2,178522.69,1331.44,589.12,742.32,177780.37,mortgage,35,3
3,177780.37,1331.44,586.68,744.76,177035.61,mortgage,35,3
4,177035.61,1331.44,584.22,747.22,176288.39,mortgage,35,3
5,176288.39,1331.44,581.75,749.69,175538.7,mortgage,35,3
6,175538.7,1331.44,579.28,752.16,174786.54,mortgage,35,3
7,174786.54,1331.44,576.8,754.64,174031.9,mortgage,35,3
8,174031.9,1331.44,574.31,757.13,173274.77,mortgage,35,3
9,173274.77,1783.08,571.81,1211.27,172063.5,mortgage,35,3
10,172063.5,2749.06,567.81,2181.25,169882.25,mortgage,35,3
11,169882.25,2749.06,560.61,2188.45,167693.8,mortgage,35,3
12,167693.8,2749.06,553.39,2195.67,165498.13,mortgage,35,3
13,165498.13,2749.06,546.14,2202.92,163295.21,mortgage,35,3
14,163295.21,2749.06,538.87,2210.19,161085.02,mortgage,35,3
15,161085.02,2749.06,531.58,2217.48,158867.54,mortgage,35,3
16,158867.54,2749.06,524.26,2224.8,156642.74,mortgage,35,3
17,156642.74,2749.06,516.92,2232.14,154410.6,mortgage,35,3
18,154410.6,2749.06,509.55,2239.51,152171.09,mortgage,35,3
19,152171.09,2749.06,502.16,2246.9,149924.19,mortgage,35,3
20,149924.19,2749.06,494.75,2254.31,147669.88,mortgage,35,3
21,147669.88,2749.06,487.31,2261.75,145408.13,mortgage,35,3
22,145408.13,2749.06,479.85,2269.21,143138.92,mortgage,35,3
23,143138.92,2749.06,472.36,2276.7,140862.22,mortgage,35,3
24,140862.22,2749.06,464.85,2284.21,138578.01,mortgage,35,3
25,138578.01,2749.06,457.31,2291.75,136286.26,mortgage,35,3
26,136286.26,2749.06,449.74,2299.32,133986.94,mortgage,35,3
27,133986.94,2749.06,442.16,2306.9,131680.04,mortgage,35,3
28,131680.04,2749.06,434.54,2314.52,129365.52,mortgage,35,3
29,129365.52,2749.06,426.91,2322.15,127043.37,mortgage,35,3
30,127043.37,2749.06,419.24,2329.82,124713.55,mortgage,35,3
31,124713.55,2749.06,411.55,2337.51,122376.04,mortgage,35,3
32,122376.04,2749.06,403.84,2345.22,120030.82,mortgage,35,3
33,120030.82,2749.06,396.1,2352.96,117677.86,mortgage,35,3
34,117677.86,2749.06,388.34,2360.72,115317.14,mortgage,35,3
35,115317.14,2749.06,380.55,2368.51,112948.63,mortgage,35,3
36,112948.63,2749.06,372.73,2376.33,110572.3,mortgage,35,3
37,110572.3,2749.06,364.89,2384.17,108188.13,mortgage,35,3
38,108188.13,2749.06,357.02,2392.04,105796.09,mortgage,35,3
39,105796.09,2749.06,349.13,2399.93,103396.16,mortgage,35,3
40,103396.16,2749.06,341.21,2407.85,100988.31,mortgage,35,3
41,100988.31,2749.06,333.26,2415.8,98572.51,mortgage,35,3
42,98572.51,2749.06,325.29,2423.77,96148.74,mortgage,35,3
43,96148.74,2749.06,317.29,2431.77,93716.97,mortgage,35,3
44,93716.97,2749.06,309.27,2439.79,91277.18,mortgage,35,3
45,91277.18,2749.06,301.21,2447.85,88829.33,mortgage,35,3
46,88829.33,2749.06,293.14,2455.92,86373.41,mortgage,35,3
47,86373.41,2749.06,285.03,2464.03,83909.38,mortgage,35,3
48,83909.38,2749.06,276.9,2472.16,81437.22,mortgage,35,3
49,81437.22,2749.06,268.74,2480.32,78956.9,mortgage,35,3
50,78956.9,2749.06,260.56,2488.5,76468.4,mortgage,35,3
51,76468.4,2749.06,252.35,2496.71,73971.69,mortgage,35,3
52,73971.69,2749.06,244.11,2504.95,71466.74,mortgage,35,3
53,71466.74,2749.06,235.84,2513.22,68953.52,mortgage,35,3
54,68953.52,2749.06,227.55,2521.51,66432.01,mortgage,35,3
55,66432.01,2749.06,219.23,2529.83,63902.18,mortgage,35,3
56,63902.18,2749.06,210.88,2538.18,61364.0,mortgage,35,3
57,61364.0,2749.06,202.5,2546.56,58817.44,mortgage,35,3
58,58817.44,2749.06,194.1,2554.96,56262.48,mortgage,35,3
59,56262.48,2749.06,185.67,2563.39,53699.09,mortgage,35,3
60,53699.09,2749.06,177.21,2571.85,51127.24,mortgage,35,3
61,51127.24,2749.06,168.72,2580.34,48546.9,mortgage,35,3
62,48546.9,2749.06,160.2,2588.86,45958.04,mortgage,35,3
63,45958.04,2749.06,151.66,2597.4,43360.64,mortgage,35,3
64,43360.64,2749.06,143.09,2605.97,40754.67,mortgage,35,3
65,40754.67,2749.06,134.49,2614.57,38140.1,mortgage,35,3
66,38140.1,2749.06,125.86,2623.2,35516.9,mortgage,35,3
67,35516.9,2749.06,117.21,2631.85,32885.05,mortgage,35,3
68,32885.05,2749.06,108.52,2640.54,30244.51,mortgage,35,3
69,30244.51,2749.06,99.81,2649.25,27595.26,mortgage,35,3
70,27595.26,2749.06,91.06,2658.0,24937.26,mortgage,35,3
71,24937.26,2749.06,82.29,2666.77,22270.49,mortgage,35,3
72,22270.49,2749.06,73.49,2675.57,19594.92,mortgage,35,3
73,19594.92,2749.06,64.66,2684.4,16910.52,mortgage,35,3
74,16910.52,2749.06,55.8,2693.26,14217.26,mortgage,35,3
75,14217.26,2749.06,46.92,2702.14,11515.12,mortgage,35,3
76,11515.12,2749.06,38.0,2711.06,8804.06,mortgage,35,3
77,8804.06,2749.06,29.05,2720.01,6084.05,mortgage,35,3
78,6084.05,2749.06,20.08,2728.98,3355.07,mortgage,35,3
79,3355.07,2749.06,11.07,2737.99,617.08,mortgage,35,3
80,617.08,2749.06,2.04,2747.02,-2129.94,mortgage,35,3
0,4000.0,70.0,16.0,54.0,3946.0,testing,35,4
1,3946.0,70.0,15.78,54.22,3891.78,testing,35,4
2,3891.78,70.0,15.57,54.43,3837.35,testing,35,4
3,3837.35,70.0,15.35,54.65,3782.7,testing,35,4
4,3782.7,70.0,15.13,54.87,3727.83,testing,35,4
5,3727.83,70.0,14.91,55.09,3672.74,testing,35,4
6,3672.74,70.0,14.69,55.31,3617.43,testing,35,4
7,3617.43,70.0,14.47,55.53,3561.9,testing,35,4
8,3561.9,70.0,14.25,55.75,3506.15,testing,35,4
9,3506.15,70.0,14.02,55.98,3450.17,testing,35,4
10,3450.17,70.0,13.8,56.2,3393.97,testing,35,4
11,3393.97,70.0,13.58,56.42,3337.55,testing,35,4
12,3337.55,70.0,13.35,56.65,3280.9,testing,35,4
13,3280.9,70.0,13.12,56.88,3224.02,testing,35,4
14,3224.02,70.0,12.9,57.1,3166.92,testing,35,4
15,3166.92,70.0,12.67,57.33,3109.59,testing,35,4
16,3109.59,70.0,12.44,57.56,3052.03,testing,35,4
17,3052.03,70.0,12.21,57.79,2994.24,testing,35,4
18,2994.24,70.0,11.98,58.02,2936.22,testing,35,4
19,2936.22,70.0,11.74,58.26,2877.96,testing,35,4
20,2877.96,70.0,11.51,58.49,2819.47,testing,35,4
21,2819.47,70.0,11.28,58.72,2760.75,testing,35,4
22,2760.75,70.0,11.04,58.96,2701.79,testing,35,4
23,2701.79,70.0,10.81,59.19,2642.6,testing,35,4
24,2642.6,70.0,10.57,59.43,2583.17,testing,35,4
25,2583.17,70.0,10.33,59.67,2523.5,testing,35,4
26,2523.5,70.0,10.09,59.91,2463.59,testing,35,4
27,2463.59,70.0,9.85,60.15,2403.44,testing,35,4
28,2403.44,70.0,9.61,60.39,2343.05,testing,35,4
29,2343.05,70.0,9.37,60.63,2282.42,testing,35,4
30,2282.42,70.0,9.13,60.87,2221.55,testing,35,4
31,2221.55,70.0,8.89,61.11,2160.44,testing,35,4
32,2160.44,70.0,8.64,61.36,2099.08,testing,35,4
33,2099.08,70.0,8.4,61.6,2037.48,testing,35,4
34,2037.48,70.0,8.15,61.85,1975.63,testing,35,4
35,1975.63,70.0,7.9,62.1,1913.53,testing,35,4
36,1913.53,70.0,7.65,62.35,1851.18,testing,35,4
37,1851.18,70.0,7.4,62.6,1788.58,testing,35,4
38,1788.58,70.0,7.15,62.85,1725.73,testing,35,4
39,1725.73,70.0,6.9,63.1,1662.63,testing,35,4
40,1662.63,70.0,6.65,63.35,1599.28,testing,35,4
41,1599.28,70.0,6.4,63.6,1535.68,testing,35,4
42,1535.68,70.0,6.14,63.86,1471.82,testing,35,4
43,1471.82,70.0,5.89,64.11,1407.71,testing,35,4
44,1407.71,70.0,5.63,64.37,1343.34,testing,35,4
45,1343.34,70.0,5.37,64.63,1278.71,testing,35,4
46,1278.71,70.0,5.11,64.89,1213.82,testing,35,4
47,1213.82,70.0,4.86,65.14,1148.68,testing,35,4
48,1148.68,70.0,4.59,65.41,1083.27,testing,35,4
49,1083.27,70.0,4.33,65.67,1017.6,testing,35,4
50,1017.6,70.0,4.07,65.93,951.67,testing,35,4
51,951.67,70.0,3.81,66.19,885.48,testing,35,4
52,885.48,70.0,3.54,66.46,819.02,testing,35,4
53,819.02,70.0,3.28,66.72,752.3,testing,35,4
54,752.3,70.0,3.01,66.99,685.31,testing,35,4
55,685.31,70.0,2.74,67.26,618.05,testing,35,4
56,618.05,70.0,2.47,67.53,550.52,testing,35,4
57,550.52,70.0,2.2,67.8,482.72,testing,35,4
58,482.72,70.0,1.93,68.07,414.65,testing,35,4
59,414.65,70.0,1.66,68.34,346.31,testing,35,4
60,346.31,70.0,1.39,68.61,277.7,testing,35,4
61,277.7,70.0,1.11,68.89,208.81,testing,35,4
62,208.81,70.0,0.84,69.16,139.65,testing,35,4
63,139.65,70.0,0.56,69.44,70.21,testing,35,4
64,70.21,70.0,0.28,69.72,0.49,testing,35,4
65,0.49,70.0,0.0,70.0,-69.51,testing,35,4
0,20000.0,191.04,108.0,83.04,19916.96,WellsFargo2,35,5
1,19916.96,191.04,107.55,83.49,19833.47,WellsFargo2,35,5
2,19833.47,191.04,107.1,83.94,19749.53,WellsFargo2,35,5
3,19749.53,191.04,106.65,84.39,19665.14,WellsFargo2,35,5
4,19665.14,191.04,106.19,84.85,19580.29,WellsFargo2,35,5
5,19580.29,191.04,105.73,85.31,19494.98,WellsFargo2,35,5
6,19494.98,191.04,105.27,85.77,19409.21,WellsFargo2,35,5
7,19409.21,191.04,104.81,86.23,19322.98,WellsFargo2,35,5
8,19322.98,191.04,104.34,86.7,19236.28,WellsFargo2,35,5
9,19236.28,191.04,103.88,87.16,19149.12,WellsFargo2,35,5
10,19149.12,191.04,103.41,87.63,19061.49,WellsFargo2,35,5
11,19061.49,191.04,102.93,88.11,18973.38,WellsFargo2,35,5
12,18973.38,191.04,102.46,88.58,18884.8,WellsFargo2,35,5
13,18884.8,191.04,101.98,89.06,18795.74,WellsFargo2,35,5
14,18795.74,191.04,101.5,89.54,18706.2,WellsFargo2,35,5
15,18706.2,191.04,101.01,90.03,18616.17,WellsFargo2,35,5
16,18616.17,191.04,100.53,90.51,18525.66,WellsFargo2,35,5
17,18525.66,191.04,100.04,91.0,18434.66,WellsFargo2,35,5
18,18434.66,191.04,99.55,91.49,18343.17,WellsFargo2,35,5
19,18343.17,191.04,99.05,91.99,18251.18,WellsFargo2,35,5
20,18251.18,191.04,98.56,92.48,18158.7,WellsFargo2,35,5
21,18158.7,191.04,98.06,92.98,18065.72,WellsFargo2,35,5
22,18065.72,191.04,97.55,93.49,17972.23,WellsFargo2,35,5
23,17972.23,191.04,97.05,93.99,17878.24,WellsFargo2,35,5
24,17878.24,191.04,96.54,94.5,17783.74,WellsFargo2,35,5
25,17783.74,191.04,96.03,95.01,17688.73,WellsFargo2,35,5
26,17688.73,191.04,95.52,95.52,17593.21,WellsFargo2,35,5
27,17593.21,191.04,95.0,96.04,17497.17,WellsFargo2,35,5
28,17497.17,191.04,94.48,96.56,17400.61,WellsFargo2,35,5
29,17400.61,191.04,93.96,97.08,17303.53,WellsFargo2,35,5
30,17303.53,191.04,93.44,97.6,17205.93,WellsFargo2,35,5
31,17205.93,191.04,92.91,98.13,17107.8,WellsFargo2,35,5
32,17107.8,191.04,92.38,98.66,17009.14,WellsFargo2,35,5
33,17009.14,191.04,91.85,99.19,16909.95,WellsFargo2,35,5
34,16909.95,191.04,91.31,99.73,16810.22,WellsFargo2,35,5
35,16810.22,191.04,90.78,100.26,16709.96,WellsFargo2,35,5
36,16709.96,191.04,90.23,100.81,16609.15,WellsFargo2,35,5
37,16609.15,191.04,89.69,101.35,16507.8,WellsFargo2,35,5
38,16507.8,191.04,89.14,101.9,16405.9,WellsFargo2,35,5
39,16405.9,191.04,88.59,102.45,16303.45,WellsFargo2,35,5
40,16303.45,191.04,88.04,103.0,16200.45,WellsFargo2,35,5
41,16200.45,191.04,87.48,103.56,16096.89,WellsFargo2,35,5
42,16096.89,191.04,86.92,104.12,15992.77,WellsFargo2,35,5
43,15992.77,191.04,86.36,104.68,15888.09,WellsFargo2,35,5
44,15888.09,191.04,85.8,105.24,15782.85,WellsFargo2,35,5
45,15782.85,191.04,85.23,105.81,15677.04,WellsFargo2,35,5
46,15677.04,191.04,84.66,106.38,15570.66,WellsFargo2,35,5
47,15570.66,191.04,84.08,106.96,15463.7,WellsFargo2,35,5
48,15463.7,191.04,83.5,107.54,15356.16,WellsFargo2,35,5
49,15356.16,191.04,82.92,108.12,15248.04,WellsFargo2,35,5
50,15248.04,191.04,82.34,108.7,15139.34,WellsFargo2,35,5
51,15139.34,191.04,81.75,109.29,15030.05,WellsFargo2,35,5
52,15030.05,191.04,81.16,109.88,14920.17,WellsFargo2,35,5
53,14920.17,191.04,80.57,110.47,14809.7,WellsFargo2,35,5
54,14809.7,191.04,79.97,111.07,14698.63,WellsFargo2,35,5
55,14698.63,191.04,79.37,111.67,14586.96,WellsFargo2,35,5
56,14586.96,191.04,78.77,112.27,14474.69,WellsFargo2,35,5
57,14474.69,191.04,78.16,112.88,14361.81,WellsFargo2,35,5
58,14361.81,191.04,77.55,113.49,14248.32,WellsFargo2,35,5
59,14248.32,191.04,76.94,114.1,14134.22,WellsFargo2,35,5
60,14134.22,191.04,76.32,114.72,14019.5,WellsFargo2,35,5
61,14019.5,191.04,75.71,115.33,13904.17,WellsFargo2,35,5
62,13904.17,191.04,75.08,115.96,13788.21,WellsFargo2,35,5
63,13788.21,191.04,74.46,116.58,13671.63,WellsFargo2,35,5
64,13671.63,191.04,73.83,117.21,13554.42,WellsFargo2,35,5
65,13554.42,260.55,73.19,187.36,13367.06,WellsFargo2,35,5
66,13367.06,3010.1,72.18,2937.92,10429.14,WellsFargo2,35,5
67,10429.14,3010.1,56.32,2953.78,7475.36,WellsFargo2,35,5
68,7475.36,3010.1,40.37,2969.73,4505.63,WellsFargo2,35,5
69,4505.63,3010.1,24.33,2985.77,1519.86,WellsFargo2,35,5
70,1519.86,3010.1,8.21,3001.89,-1482.03,WellsFargo2,35,5
0,5000.0,1333.0,36.0,1297.0,3703.0,Car,36,1
1,3703.0,1333.0,26.66,1306.34,2396.66,Car,36,1
2,2396.66,1333.0,17.26,1315.74,1080.92,Car,36,1
3,1080.92,1333.0,7.78,1325.22,-244.3,Car,36,1
0,8250.57,84.62,53.63,30.99,8219.58,WellsFargo1,36,2
1,8219.58,84.62,53.43,31.19,8188.39,WellsFargo1,36,2
2,8188.39,84.62,53.22,31.4,8156.99,WellsFargo1,36,2
3,8156.99,328.92,53.02,275.9,7881.09,WellsFargo1,36,2
4,7881.09,1417.62,51.23,1366.39,6514.7,WellsFargo1,36,2
5,6514.7,1417.62,42.35,1375.27,5139.43,WellsFargo1,36,2
6,5139.43,1417.62,33.41,1384.21,3755.22,WellsFargo1,36,2
7,3755.22,1417.62,24.41,1393.21,2362.01,WellsFargo1,36,2
8,2362.01,1417.62,15.35,1402.27,959.74,WellsFargo1,36,2
9,959.74,1417.62,6.24,1411.38,-451.64,WellsFargo1,36,2
0,180000.0,1331.44,594.0,737.44,179262.56,mortgage,36,3
1,179262.56,1331.44,591.57,739.87,178522.69,mortgage,36,3
2,178522.69,1331.44,589.12,742.32,177780.37,mortgage,36,3
3,177780.37,1331.44,586.68,744.76,177035.61,mortgage,36,3
4,177035.61,1331.44,584.22,747.22,176288.39,mortgage,36,3
5,176288.39,1331.44,581.75,749.69,175538.7,mortgage,36,3
6,175538.7,1331.44,579.28,752.16,174786.54,mortgage,36,3
7,174786.54,1331.44,576.8,754.64,174031.9,mortgage,36,3
8,174031.9,1331.44,574.31,757.13,173274.77,mortgage,36,3
9,173274.77,1783.08,571.81,1211.27,172063.5,mortgage,36,3
10,172063.5,2749.06,567.81,2181.25,169882.25,mortgage,36,3
11,169882.25,2749.06,560.61,2188.45,167693.8,mortgage,36,3
12,167693.8,2749.06,553.39,2195.67,165498.13,mortgage,36,3
13,165498.13,2749.06,546.14,2202.92,163295.21,mortgage,36,3
14,163295.21,2749.06,538.87,2210.19,161085.02,mortgage,36,3
15,161085.02,2749.06,531.58,2217.48,158867.54,mortgage,36,3
16,158867.54,2749.06,524.26,2224.8,156642.74,mortgage,36,3
17,156642.74,2749.06,516.92,2232.14,154410.6,mortgage,36,3
18,154410.6,2749.06,509.55,2239.51,152171.09,mortgage,36,3
19,152171.09,2749.06,502.16,2246.9,149924.19,mortgage,36,3
20,149924.19,2749.06,494.75,2254.31,147669.88,mortgage,36,3
21,147669.88,2749.06,487.31,2261.75,145408.13,mortgage,36,3
22,145408.13,2749.06,479.85,2269.21,143138.92,mortgage,36,3
23,143138.92,2749.06,472.36,2276.7,140862.22,mortgage,36,3
24,140862.22,2749.06,464.85,2284.21,138578.01,mortgage,36,3
25,138578.01,2749.06,457.31,2291.75,136286.26,mortgage,36,3
26,136286.26,2749.06,449.74,2299.32,133986.94,mortgage,36,3
27,133986.94,2749.06,442.16,2306.9,131680.04,mortgage,36,3
28,131680.04,2749.06,434.54,2314.52,129365.52,mortgage,36,3
29,129365.52,2749.06,426.91,2322.15,127043.37,mortgage,36,3
30,127043.37,2749.06,419.24,2329.82,124713.55,mortgage,36,3
31,124713.55,2749.06,411.55,2337.51,122376.04,mortgage,36,3
32,122376.04,2749.06,403.84,2345.22,120030.82,mortgage,36,3
33,120030.82,2749.06,396.1,2352.96,117677.86,mortgage,36,3
34,117677.86,2749.06,388.34,2360.72,115317.14,mortgage,36,3
35,115317.14,2749.06,380.55,2368.51,112948.63,mortgage,36,3
36,112948.63,2749.06,372.73,2376.33,110572.3,mortgage,36,3
37,110572.3,2749.06,364.89,2384.17,108188.13,mortgage,36,3
38,108188.13,2749.06,357.02,2392.04,105796.09,mortgage,36,3
39,105796.09,2749.06,349.13,2399.93,103396.16,mortgage,36,3
40,103396.16,2749.06,341.21,2407.85,100988.31,mortgage,36,3
41,100988.31,2749.06,333.26,2415.8,98572.51,mortgage,36,3
42,98572.51,2749.06,325.29,2423.77,96148.74,mortgage,36,3
43,96148.74,2749.06,317.29,2431.77,93716.97,mortgage,36,3
44,93716.97,2749.06,309.27,2439.79,91277.18,mortgage,36,3
45,91277.18,2749.06,301.21,2447.85,88829.33,mortgage,36,3
46,88829.33,2749.06,293.14,2455.92,86373.41,mortgage,36,3
47,86373.41,2749.06,285.03,2464.03,83909.38,mortgage,36,3
48,83909.38,2749.06,276.9,2472.16,81437.22,mortgage,36,3
49,81437.22,2749.06,268.74,2480.32,78956.9,mortgage,36,3
50,78956.9,2749.06,260.56,2488.5,76468.4,mortgage,36,3
51,76468.4,2749.06,252.35,2496.71,73971.69,mortgage,36,3
52,73971.69,2749.06,244.11,2504.95,71466.74,mortgage,36,3
53,71466.74,2749.06,235.84,2513.22,68953.52,mortgage,36,3
54,68953.52,2749.06,227.55,2521.51,66432.01,mortgage,36,3
55,66432.01,2749.06,219.23,2529.83,63902.18,mortgage,36,3
56,63902.18,2749.06,210.88,2538.18,61364.0,mortgage,36,3
57,61364.0,2749.06,202.5,2546.56,58817.44,mortgage,36,3
58,58817.44,2749.06,194.1,2554.96,56262.48,mortgage,36,3
59,56262.48,2749.06,185.67,2563.39,53699.09,mortgage,36,3
60,53699.09,2749.06,177.21,2571.85,51127.24,mortgage,36,3
61,51127.24,2749.06,168.72,2580.34,48546.9,mortgage,36,3
62,48546.9,2749.06,160.2,2588.86,45958.04,mortgage,36,3
63,45958.04,2749.06,151.66,2597.4,43360.64,mortgage,36,3
64,43360.64,2749.06,143.09,2605.97,40754.67,mortgage,36,3
65,40754.67,2749.06,134.49,2614.57,38140.1,mortgage,36,3
66,38140.1,2749.06,125.86,2623.2,35516.9,mortgage,36,3
67,35516.9,2749.06,117.21,2631.85,32885.05,mortgage,36,3
68,32885.05,2749.06,108.52,2640.54,30244.51,mortgage,36,3
69,30244.51,2749.06,99.81,2649.25,27595.26,mortgage,36,3
70,27595.26,2749.06,91.06,2658.0,24937.26,mortgage,36,3
71,24937.26,2749.06,82.29,2666.77,22270.49,mortgage,36,3
72,22270.49,2749.06,73.49,2675.57,19594.92,mortgage,36,3
73,19594.92,2749.06,64.66,2684.4,16910.52,mortgage,36,3
74,16910.52,2749.06,55.8,2693.26,14217.26,mortgage,36,3
75,14217.26,2749.06,46.92,2702.14,11515.12,mortgage,36,3
76,11515.12,2749.06,38.0,2711.06,8804.06,mortgage,36,3
77,8804.06,2749.06,29.05,2720.01,6084.05,mortgage,36,3
78,6084.05,2749.06,20.08,2728.98,3355.07,mortgage,36,3
79,3355.07,2749.06,11.07,2737.99,617.08,mortgage,36,3
80,617.08,2749.06,2.04,2747.02,-2129.94,mortgage,36,3
0,20000.0,191.04,108.0,83.04,19916.96,WellsFargo2,36,4
1,19916.96,191.04,107.55,83.49,19833.47,WellsFargo2,36,4
2,19833.47,191.04,107.1,83.94,19749.53,WellsFargo2,36,4
3,19749.53,191.04,106.65,84.39,19665.14,WellsFargo2,36,4
4,19665.14,191.04,106.19,84.85,19580.29,WellsFargo2,36,4
5,19580.29,191.04,105.73,85.31,19494.98,WellsFargo2,36,4
6,19494.98,191.04,105.27,85.77,19409.21,WellsFargo2,36,4
7,19409.21,191.04,104.81,86.23,19322.98,WellsFargo2,36,4
8,19322.98,191.04,104.34,86.7,19236.28,WellsFargo2,36,4
9,19236.28,191.04,103.88,87.16,19149.12,WellsFargo2,36,4
10,19149.12,191.04,103.41,87.63,19061.49,WellsFargo2,36,4
11,19061.49,191.04,102.93,88.11,18973.38,WellsFargo2,36,4
12,18973.38,191.04,102.46,88.58,18884.8,WellsFargo2,36,4
13,18884.8,191.04,101.98,89.06,18795.74,WellsFargo2,36,4
14,18795.74,191.04,101.5,89.54,18706.2,WellsFargo2,36,4
15,18706.2,191.04,101.01,90.03,18616.17,WellsFargo2,36,4
16,18616.17,191.04,100.53,90.51,18525.66,WellsFargo2,36,4
17,18525.66,191.04,100.04,91.0,18434.66,WellsFargo2,36,4
18,18434.66,191.04,99.55,91.49,18343.17,WellsFargo2,36,4
19,18343.17,191.04,99.05,91.99,18251.18,WellsFargo2,36,4
20,18251.18,191.04,98.56,92.48,18158.7,WellsFargo2,36,4
21,18158.7,191.04,98.06,92.98,18065.72,WellsFargo2,36,4
22,18065.72,191.04,97.55,93.49,17972.23,WellsFargo2,36,4
23,17972.23,191.04,97.05,93.99,17878.24,WellsFargo2,36,4
24,17878.24,191.04,96.54,94.5,17783.74,WellsFargo2,36,4
25,17783.74,191.04,96.03,95.01,17688.73,WellsFargo2,36,4
26,17688.73,191.04,95.52,95.52,17593.21,WellsFargo2,36,4
27,17593.21,191.04,95.0,96.04,17497.17,WellsFargo2,36,4
28,17497.17,191.04,94.48,96.56,17400.61,WellsFargo2,36,4
29,17400.61,191.04,93.96,97.08,17303.53,WellsFargo2,36,4
30,17303.53,191.04,93.44,97.6,17205.93,WellsFargo2,36,4
31,17205.93,191.04,92.91,98.13,17107.8,WellsFargo2,36,4
32,17107.8,191.04,92.38,98.66,17009.14,WellsFargo2,36,4
33,17009.14,191.04,91.85,99.19,16909.95,WellsFargo2,36,4
34,16909.95,191.04,91.31,99.73,16810.22,WellsFargo2,36,4
35,16810.22,191.04,90.78,100.26,16709.96,WellsFargo2,36,4
36,16709.96,191.04,90.23,100.81,16609.15,WellsFargo2,36,4
37,16609.15,191.04,89.69,101.35,16507.8,WellsFargo2,36,4
38,16507.8,191.04,89.14,101.9,16405.9,WellsFargo2,36,4
39,16405.9,191.04,88.59,102.45,16303.45,WellsFargo2,36,4
40,16303.45,191.04,88.04,103.0,16200.45,WellsFargo2,36,4
41,16200.45,191.04,87.48,103.56,16096.89,WellsFargo2,36,4
42,16096.89,191.04,86.92,104.12,15992.77,WellsFargo2,36,4
43,15992.77,191.04,86.36,104.68,15888.09,WellsFargo2,36,4
44,15888.09,191.04,85.8,105.24,15782.85,WellsFargo2,36,4
45,15782.85,191.04,85.23,105.81,15677.04,WellsFargo2,36,4
46,15677.04,191.04,84.66,106.38,15570.66,WellsFargo2,36,4
47,15570.66,191.04,84.08,106.96,15463.7,WellsFargo2,36,4
48,15463.7,191.04,83.5,107.54,15356.16,WellsFargo2,36,4
49,15356.16,191.04,82.92,108.12,15248.04,WellsFargo2,36,4
50,15248.04,191.04,82.34,108.7,15139.34,WellsFargo2,36,4
51,15139.34,191.04,81.75,109.29,15030.05,WellsFargo2,36,4
52,15030.05,191.04,81.16,109.88,14920.17,WellsFargo2,36,4
53,14920.17,191.04,80.57,110.47,14809.7,WellsFargo2,36,4
54,14809.7,191.04,79.97,111.07,14698.63,WellsFargo2,36,4
55,14698.63,191.04,79.37,111.67,14586.96,WellsFargo2,36,4
56,14586.96,191.04,78.77,112.27,14474.69,WellsFargo2,36,4
57,14474.69,191.04,78.16,112.88,14361.81,WellsFargo2,36,4
58,14361.81,191.04,77.55,113.49,14248.32,WellsFargo2,36,4
59,14248.32,191.04,76.94,114.1,14134.22,WellsFargo2,36,4
60,14134.22,191.04,76.32,114.72,14019.5,WellsFargo2,36,4
61,14019.5,191.04,75.71,115.33,13904.17,WellsFargo2,36,4
62,13904.17,191.04,75.08,115.96,13788.21,WellsFargo2,36,4
63,13788.21,191.04,74.46,116.58,13671.63,WellsFargo2,36,4
64,13671.63,191.04,73.83,117.21,13554.42,WellsFargo2,36,4
65,13554.42,191.04,73.19,117.85,13436.57,WellsFargo2,36,4
66,13436.57,191.04,72.56,118.48,13318.09,WellsFargo2,36,4
67,13318.09,191.04,71.92,119.12,13198.97,WellsFargo2,36,4
68,13198.97,191.04,71.27,119.77,13079.2,WellsFargo2,36,4
69,13079.2,191.04,70.63,120.41,12958.79,WellsFargo2,36,4
70,12958.79,191.04,69.98,121.06,12837.73,WellsFargo2,36,4
71,12837.73,191.04,69.32,121.72,12716.01,WellsFargo2,36,4
72,12716.01,191.04,68.67,122.37,12593.64,WellsFargo2,36,4
73,12593.64,191.04,68.01,123.03,12470.61,WellsFargo2,36,4
74,12470.61,191.04,67.34,123.7,12346.91,WellsFargo2,36,4
75,12346.91,191.04,66.67,124.37,12222.54,WellsFargo2,36,4
76,12222.54,191.04,66.0,125.04,12097.5,WellsFargo2,36,4
77,12097.5,191.04,65.33,125.71,11971.79,WellsFargo2,36,4
78,11971.79,191.04,64.65,126.39,11845.4,WellsFargo2,36,4
79,11845.4,191.04,63.97,127.07,11718.33,WellsFargo2,36,4
80,11718.33,2320.98,63.28,2257.7,9460.63,WellsFargo2,36,4
81,9460.63,2940.1,51.09,2889.01,6571.62,WellsFargo2,36,4
82,6571.62,2940.1,35.49,2904.61,3667.01,WellsFargo2,36,4
83,3667.01,2940.1,19.8,2920.3,746.71,WellsFargo2,36,4
84,746.71,2940.1,4.03,2936.07,-2189.36,WellsFargo2,36,4
0,4000.0,70.0,16.0,54.0,3946.0,testing,36,5
1,3946.0,70.0,15.78,54.22,3891.78,testing,36,5
2,3891.78,70.0,15.57,54.43,3837.35,testing,36,5
3,3837.35,70.0,15.35,54.65,3782.7,testing,36,5
4,3782.7,70.0,15.13,54.87,3727.83,testing,36,5
5,3727.83,70.0,14.91,55.09,3672.74,testing,36,5
6,3672.74,70.0,14.69,55.31,3617.43,testing,36,5
7,3617.43,70.0,14.47,55.53,3561.9,testing,36,5
8,3561.9,70.0,14.25,55.75,3506.15,testing,36,5
9,3506.15,70.0,14.02,55.98,3450.17,testing,36,5
10,3450.17,70.0,13.8,56.2,3393.97,testing,36,5
11,3393.97,70.0,13.58,56.42,3337.55,testing,36,5
12,3337.55,70.0,13.35,56.65,3280.9,testing,36,5
13,3280.9,70.0,13.12,56.88,3224.02,testing,36,5
14,3224.02,70.0,12.9,57.1,3166.92,testing,36,5
15,3166.92,70.0,12.67,57.33,3109.59,testing,36,5
16,3109.59,70.0,12.44,57.56,3052.03,testing,36,5
17,3052.03,70.0,12.21,57.79,2994.24,testing,36,5
18,2994.24,70.0,11.98,58.02,2936.22,testing,36,5
19,2936.22,70.0,11.74,58.26,2877.96,testing,36,5
20,2877.96,70.0,11.51,58.49,2819.47,testing,36,5
21,2819.47,70.0,11.28,58.72,2760.75,testing,36,5
22,2760.75,70.0,11.04,58.96,2701.79,testing,36,5
23,2701.79,70.0,10.81,59.19,2642.6,testing,36,5
24,2642.6,70.0,10.57,59.43,2583.17,testing,36,5
25,2583.17,70.0,10.33,59.67,2523.5,testing,36,5
26,2523.5,70.0,10.09,59.91,2463.59,testing,36,5
27,2463.59,70.0,9.85,60.15,2403.44,testing,36,5
28,2403.44,70.0,9.61,60.39,2343.05,testing,36,5
29,2343.05,70.0,9.37,60.63,2282.42,testing,36,5
30,2282.42,70.0,9.13,60.87,2221.55,testing,36,5
31,2221.55,70.0,8.89,61.11,2160.44,testing,36,5
32,2160.44,70.0,8.64,61.36,2099.08,testing,36,5
33,2099.08,70.0,8.4,61.6,2037.48,testing,36,5
34,2037.48,70.0,8.15,61.85,1975.63,testing,36,5
35,1975.63,70.0,7.9,62.1,1913.53,testing,36,5
36,1913.53,70.0,7.65,62.35,1851.18,testing,36,5
37,1851.18,70.0,7.4,62.6,1788.58,testing,36,5
38,1788.58,70.0,7.15,62.85,1725.73,testing,36,5
39,1725.73,70.0,6.9,63.1,1662.63,testing,36,5
40,1662.63,70.0,6.65,63.35,1599.28,testing,36,5
41,1599.28,70.0,6.4,63.6,1535.68,testing,36,5
42,1535.68,70.0,6.14,63.86,1471.82,testing,36,5
43,1471.82,70.0,5.89,64.11,1407.71,testing,36,5
44,1407.71,70.0,5.63,64.37,1343.34,testing,36,5
45,1343.34,70.0,5.37,64.63,1278.71,testing,36,5
46,1278.71,70.0,5.11,64.89,1213.82,testing,36,5
47,1213.82,70.0,4.86,65.14,1148.68,testing,36,5
48,1148.68,70.0,4.59,65.41,1083.27,testing,36,5
49,1083.27,70.0,4.33,65.67,1017.6,testing,36,5
50,1017.6,70.0,4.07,65.93,951.67,testing,36,5
51,951.67,70.0,3.81,66.19,885.48,testing,36,5
52,885.48,70.0,3.54,66.46,819.02,testing,36,5
53,819.02,70.0,3.28,66.72,752.3,testing,36,5
54,752.3,70.0,3.01,66.99,685.31,testing,36,5
55,685.31,70.0,2.74,67.26,618.05,testing,36,5
56,618.05,70.0,2.47,67.53,550.52,testing,36,5
57,550.52,70.0,2.2,67.8,482.72,testing,36,5
58,482.72,70.0,1.93,68.07,414.65,testing,36,5
59,414.65,70.0,1.66,68.34,346.31,testing,36,5
60,346.31,70.0,1.39,68.61,277.7,testing,36,5
61,277.7,70.0,1.11,68.89,208.81,testing,36,5
62,208.81,70.0,0.84,69.16,139.65,testing,36,5
63,139.65,70.0,0.56,69.44,70.21,testing,36,5
64,70.21,70.0,0.28,69.72,0.49,testing,36,5
65,0.49,70.0,0.0,70.0,-69.51,testing,36,5
0,5000.0,1333.0,36.0,1297.0,3703.0,Car,37,1
1,3703.0,1333.0,26.66,1306.34,2396.66,Car,37,1
2,2396.66,1333.0,17.26,1315.74,1080.92,Car,37,1
3,1080.92,1333.0,7.78,1325.22,-244.3,Car,37,1
0,20000.0,191.04,108.0,83.04,19916.96,WellsFargo2,37,2
1,19916.96,191.04,107.55,83.49,19833.47,WellsFargo2,37,2
2,19833.47,191.04,107.1,83.94,19749.53,WellsFargo2,37,2
3,19749.53,435.34,106.65,328.69,19420.84,WellsFargo2,37,2
4,19420.84,1524.04,104.87,1419.17,18001.67,WellsFargo2,37,2
5,18001.67,1524.04,97.21,1426.83,16574.84,WellsFargo2,37,2
6,16574.84,1524.04,89.5,1434.54,15140.3,WellsFargo2,37,2
7,15140.3,1524.04,81.76,1442.28,13698.02,WellsFargo2,37,2
8,13698.02,1524.04,73.97,1450.07,12247.95,WellsFargo2,37,2
9,12247.95,1524.04,66.14,1457.9,10790.05,WellsFargo2,37,2
10,10790.05,1524.04,58.27,1465.77,9324.28,WellsFargo2,37,2
11,9324.28,1524.04,50.35,1473.69,7850.59,WellsFargo2,37,2
12,7850.59,1524.04,42.39,1481.65,6368.94,WellsFargo2,37,2
13,6368.94,1524.04,34.39,1489.65,4879.29,WellsFargo2,37,2
14,4879.29,1524.04,26.35,1497.69,3381.6,WellsFargo2,37,2
15,3381.6,1524.04,18.26,1505.78,1875.82,WellsFargo2,37,2
16,1875.82,1524.04,10.13,1513.91,361.91,WellsFargo2,37,2
17,361.91,1524.04,1.95,1522.09,-1160.18,WellsFargo2,37,2
0,4000.0,70.0,16.0,54.0,3946.0,testing,37,3
1,3946.0,70.0,15.78,54.22,3891.78,testing,37,3
2,3891.78,70.0,15.57,54.43,3837.35,testing,37,3
3,3837.35,70.0,15.35,54.65,3782.7,testing,37,3
4,3782.7,70.0,15.13,54.87,3727.83,testing,37,3
5,3727.83,70.0,14.91,55.09,3672.74,testing,37,3
6,3672.74,70.0,14.69,55.31,3617.43,testing,37,3
7,3617.43,70.0,14.47,55.53,3561.9,testing,37,3
8,3561.9,70.0,14.25,55.75,3506.15,testing,37,3
9,3506.15,70.0,14.02,55.98,3450.17,testing,37,3
10,3450.17,70.0,13.8,56.2,3393.97,testing,37,3
11,3393.97,70.0,13.58,56.42,3337.55,testing,37,3
12,3337.55,70.0,13.35,56.65,3280.9,testing,37,3
13,3280.9,70.0,13.12,56.88,3224.02,testing,37,3
14,3224.02,70.0,12.9,57.1,3166.92,testing,37,3
15,3166.92,70.0,12.67,57.33,3109.59,testing,37,3
16,3109.59,70.0,12.44,57.56,3052.03,testing,37,3
17,3052.03,1230.18,12.21,1217.97,1834.06,testing,37,3
18,1834.06,1594.04,7.34,1586.7,247.36,testing,37,3
19,247.36,1594.04,0.99,1593.05,-1345.69,testing,37,3
0,8250.57,84.62,53.63,30.99,8219.58,WellsFargo1,37,4
1,8219.58,84.62,53.43,31.19,8188.39,WellsFargo1,37,4
2,8188.39,84.62,53.22,31.4,8156.99,WellsFargo1,37,4
3,8156.99,84.62,53.02,31.6,8125.39,WellsFargo1,37,4
4,8125.39,84.62,52.82,31.8,8093.59,WellsFargo1,37,4
5,8093.59,84.62,52.61,32.01,8061.58,WellsFargo1,37,4
6,8061.58,84.62,52.4,32.22,8029.36,WellsFargo1,37,4
7,8029.36,84.62,52.19,32.43,7996.93,WellsFargo1,37,4
8,7996.93,84.62,51.98,32.64,7964.29,WellsFargo1,37,4
9,7964.29,84.62,51.77,32.85,7931.44,WellsFargo1,37,4
10,7931.44,84.62,51.55,33.07,7898.37,WellsFargo1,37,4
11,7898.37,84.62,51.34,33.28,7865.09,WellsFargo1,37,4
12,7865.09,84.62,51.12,33.5,7831.59,WellsFargo1,37,4
13,7831.59,84.62,50.91,33.71,7797.88,WellsFargo1,37,4
14,7797.88,84.62,50.69,33.93,7763.95,WellsFargo1,37,4
15,7763.95,84.62,50.47,34.15,7729.8,WellsFargo1,37,4
16,7729.8,84.62,50.24,34.38,7695.42,WellsFargo1,37,4
17,7695.42,84.62,50.02,34.6,7660.82,WellsFargo1,37,4
18,7660.82,84.62,49.8,34.82,7626.0,WellsFargo1,37,4
19,7626.0,1430.31,49.57,1380.74,6245.26,WellsFargo1,37,4
20,6245.26,1678.66,40.59,1638.07,4607.19,WellsFargo1,37,4
21,4607.19,1678.66,29.95,1648.71,2958.48,WellsFargo1,37,4
22,2958.48,1678.66,19.23,1659.43,1299.05,WellsFargo1,37,4
23,1299.05,1678.66,8.44,1670.22,-371.17,WellsFargo1,37,4
0,180000.0,1331.44,594.0,737.44,179262.56,mortgage,37,5
1,179262.56,1331.44,591.57,739.87,178522.69,mortgage,37,5
2,178522.69,1331.44,589.12,742.32,177780.37,mortgage,37,5
3,177780.37,1331.44,586.68,744.76,177035.61,mortgage,37,5
4,177035.61,1331.44,584.22,747.22,176288.39,mortgage,37,5
5,176288.39,1331.44,581.75,749.69,175538.7,mortgage,37,5
6,175538.7,1331.44,579.28,752.16,174786.54,mortgage,37,5
7,174786.54,1331.44,576.8,754.64,174031.9,mortgage,37,5
8,174031.9,1331.44,574.31,757.13,173274.77,mortgage,37,5
9,173274.77,1331.44,571.81,759.63,172515.14,mortgage,37,5
10,172515.14,1331.44,569.3,762.14,171753.0,mortgage,37,5
11,171753.0,1331.44,566.78,764.66,170988.34,mortgage,37,5
12,170988.34,1331.44,564.26,767.18,170221.16,mortgage,37,5
13,170221.16,1331.44,561.73,769.71,169451.45,mortgage,37,5
14,169451.45,1331.44,559.19,772.25,168679.2,mortgage,37,5
15,168679.2,1331.44,556.64,774.8,167904.4,mortgage,37,5
16,167904.4,1331.44,554.08,777.36,167127.04,mortgage,37,5
17,167127.04,1331.44,551.52,779.92,166347.12,mortgage,37,5
18,166347.12,1331.44,548.95,782.49,165564.63,mortgage,37,5
19,165564.63,1331.44,546.36,785.08,164779.55,mortgage,37,5
20,164779.55,1331.44,543.77,787.67,163991.88,mortgage,37,5
21,163991.88,1331.44,541.17,790.27,163201.61,mortgage,37,5
22,163201.61,1331.44,538.57,792.87,162408.74,mortgage,37,5
23,162408.74,1702.61,535.95,1166.66,161242.08,mortgage,37,5
24,161242.08,3010.1,532.1,2478.0,158764.08,mortgage,37,5
25,158764.08,3010.1,523.92,2486.18,156277.9,mortgage,37,5
26,156277.9,3010.1,515.72,2494.38,153783.52,mortgage,37,5
27,153783.52,3010.1,507.49,2502.61,151280.91,mortgage,37,5
28,151280.91,3010.1,499.23,2510.87,148770.04,mortgage,37,5
29,148770.04,3010.1,490.94,2519.16,146250.88,mortgage,37,5
30,146250.88,3010.1,482.63,2527.47,143723.41,mortgage,37,5
31,143723.41,3010.1,474.29,2535.81,141187.6,mortgage,37,5
32,141187.6,3010.1,465.92,2544.18,138643.42,mortgage,37,5
33,138643.42,3010.1,457.52,2552.58,136090.84,mortgage,37,5
34,136090.84,3010.1,449.1,2561.0,133529.84,mortgage,37,5
35,133529.84,3010.1,440.65,2569.45,130960.39,mortgage,37,5
36,130960.39,3010.1,432.17,2577.93,128382.46,mortgage,37,5
37,128382.46,3010.1,423.66,2586.44,125796.02,mortgage,37,5
38,125796.02,3010.1,415.13,2594.97,123201.05,mortgage,37,5
39,123201.05,3010.1,406.56,2603.54,120597.51,mortgage,37,5
40,120597.51,3010.1,397.97,2612.13,117985.38,mortgage,37,5
41,117985.38,3010.1,389.35,2620.75,115364.63,mortgage,37,5
42,115364.63,3010.1,380.7,2629.4,112735.23,mortgage,37,5
43,112735.23,3010.1,372.03,2638.07,110097.16,mortgage,37,5
44,110097.16,3010.1,363.32,2646.78,107450.38,mortgage,37,5
45,107450.38,3010.1,354.59,2655.51,104794.87,mortgage,37,5
46,104794.87,3010.1,345.82,2664.28,102130.59,mortgage,37,5
47,102130.59,3010.1,337.03,2673.07,99457.52,mortgage,37,5
48,99457.52,3010.1,328.21,2681.89,96775.63,mortgage,37,5
49,96775.63,3010.1,319.36,2690.74,94084.89,mortgage,37,5
50,94084.89,3010.1,310.48,2699.62,91385.27,mortgage,37,5
51,91385.27,3010.1,301.57,2708.53,88676.74,mortgage,37,5
52,88676.74,3010.1,292.63,2717.47,85959.27,mortgage,37,5
53,85959.27,3010.1,283.67,2726.43,83232.84,mortgage,37,5
54,83232.84,3010.1,274.67,2735.43,80497.41,mortgage,37,5
55,80497.41,3010.1,265.64,2744.46,77752.95,mortgage,37,5
56,77752.95,3010.1,256.58,2753.52,74999.43,mortgage,37,5
57,74999.43,3010.1,247.5,2762.6,72236.83,mortgage,37,5
58,72236.83,3010.1,238.38,2771.72,69465.11,mortgage,37,5
59,69465.11,3010.1,229.23,2780.87,66684.24,mortgage,37,5
60,66684.24,3010.1,220.06,2790.04,63894.2,mortgage,37,5
61,63894.2,3010.1,210.85,2799.25,61094.95,mortgage,37,5
62,61094.95,3010.1,201.61,2808.49,58286.46,mortgage,37,5
63,58286.46,3010.1,192.35,2817.75,55468.71,mortgage,37,5
64,55468.71,3010.1,183.05,2827.05,52641.66,mortgage,37,5
65,52641.66,3010.1,173.72,2836.38,49805.28,mortgage,37,5
66,49805.28,3010.1,164.36,2845.74,46959.54,mortgage,37,5
67,46959.54,3010.1,154.97,2855.13,44104.41,mortgage,37,5
68,44104.41,3010.1,145.54,2864.56,41239.85,mortgage,37,5
69,41239.85,3010.1,136.09,2874.01,38365.84,mortgage,37,5
70,38365.84,3010.1,126.61,2883.49,35482.35,mortgage,37,5
71,35482.35,3010.1,117.09,2893.01,32589.34,mortgage,37,5
72,32589.34,3010.1,107.54,2902.56,29686.78,mortgage,37,5
73,29686.78,3010.1,97.97,2912.13,26774.65,mortgage,37,5
74,26774.65,3010.1,88.36,2921.74,23852.91,mortgage,37,5
75,23852.91,3010.1,78.71,2931.39,20921.52,mortgage,37,5
76,20921.52,3010.1,69.04,2941.06,17980.46,mortgage,37,5
77,17980.46,3010.1,59.34,2950.76,15029.7,mortgage,37,5
78,15029.7,3010.1,49.6,2960.5,12069.2,mortgage,37,5
79,12069.2,3010.1,39.83,2970.27,9098.93,mortgage,37,5
80,9098.93,3010.1,30.03,2980.07,6118.86,mortgage,37,5
81,6118.86,3010.1,20.19,2989.91,3128.95,mortgage,37,5
82,3128.95,3010.1,10.33,2999.77,129.18,mortgage,37,5
83,129.18,3010.1,0.43,3009.67,-2880.49,mortgage,37,5
0,5000.0,1333.0,36.0,1297.0,3703.0,Car,38,1
1,3703.0,1333.0,26.66,1306.34,2396.66,Car,38,1
2,2396.66,1333.0,17.26,1315.74,1080.92,Car,38,1
3,1080.92,1333.0,7.78,1325.22,-244.3,Car,38,1
0,20000.0,191.04,108.0,83.04,19916.96,WellsFargo2,38,2
1,19916.96,191.04,107.55,83.49,19833.47,WellsFargo2,38,2
2,19833.47,191.04,107.1,83.94,19749.53,WellsFargo2,38,2
3,19749.53,435.34,106.65,328.69,19420.84,WellsFargo2,38,2
4,19420.84,1524.04,104.87,1419.17,18001.67,WellsFargo2,38,2
5,18001.67,1524.04,97.21,1426.83,16574.84,WellsFargo2,38,2
6,16574.84,1524.04,89.5,1434.54,15140.3,WellsFargo2,38,2
7,15140.3,1524.04,81.76,1442.28,13698.02,WellsFargo2,38,2
8,13698.02,1524.04,73.97,1450.07,12247.95,WellsFargo2,38,2
9,12247.95,1524.04,66.14,1457.9,10790.05,WellsFargo2,38,2
10,10790.05,1524.04,58.27,1465.77,9324.28,WellsFargo2,38,2
11,9324.28,1524.04,50.35,1473.69,7850.59,WellsFargo2,38,2
12,7850.59,1524.04,42.39,1481.65,6368.94,WellsFargo2,38,2
13,6368.94,1524.04,34.39,1489.65,4879.29,WellsFargo2,38,2
14,4879.29,1524.04,26.35,1497.69,3381.6,WellsFargo2,38,2
15,3381.6,1524.04,18.26,1505.78,1875.82,WellsFargo2,38,2
16,1875.82,1524.04,10.13,1513.91,361.91,WellsFargo2,38,2
17,361.91,1524.04,1.95,1522.09,-1160.18,WellsFargo2,38,2
0,4000.0,70.0,16.0,54.0,3946.0,testing,38,3
1,3946.0,70.0,15.78,54.22,3891.78,testing,38,3
2,3891.78,70.0,15.57,54.43,3837.35,testing,38,3
3,3837.35,70.0,15.35,54.65,3782.7,testing,38,3
4,3782.7,70.0,15.13,54.87,3727.83,testing,38,3
5,3727.83,70.0,14.91,55.09,3672.74,testing,38,3
6,3672.74,70.0,14.69,55.31,3617.43,testing,38,3
7,3617.43,70.0,14.47,55.53,3561.9,testing,38,3
8,3561.9,70.0,14.25,55.75,3506.15,testing,38,3
9,3506.15,70.0,14.02,55.98,3450.17,testing,38,3
10,3450.17,70.0,13.8,56.2,3393.97,testing,38,3
11,3393.97,70.0,13.58,56.42,3337.55,testing,38,3
12,3337.55,70.0,13.35,56.65,3280.9,testing,38,3
13,3280.9,70.0,13.12,56.88,3224.02,testing,38,3
14,3224.02,70.0,12.9,57.1,3166.92,testing,38,3
15,3166.92,70.0,12.67,57.33,3109.59,testing,38,3
16,3109.59,70.0,12.44,57.56,3052.03,testing,38,3
17,3052.03,1230.18,12.21,1217.97,1834.06,testing,38,3
18,1834.06,1594.04,7.34,1586.7,247.36,testing,38,3
19,247.36,1594.04,0.99,1593.05,-1345.69,testing,38,3
0,180000.0,1331.44,594.0,737.44,179262.56,mortgage,38,4
1,179262.56,1331.44,591.57,739.87,178522.69,mortgage,38,4
2,178522.69,1331.44,589.12,742.32,177780.37,mortgage,38,4
3,177780.37,1331.44,586.68,744.76,177035.61,mortgage,38,4
4,177035.61,1331.44,584.22,747.22,176288.39,mortgage,38,4
5,176288.39,1331.44,581.75,749.69,175538.7,mortgage,38,4
6,175538.7,1331.44,579.28,752.16,174786.54,mortgage,38,4
7,174786.54,1331.44,576.8,754.64,174031.9,mortgage,38,4
8,174031.9,1331.44,574.31,757.13,173274.77,mortgage,38,4
9,173274.77,1331.44,571.81,759.63,172515.14,mortgage,38,4
10,172515.14,1331.44,569.3,762.14,171753.0,mortgage,38,4
11,171753.0,1331.44,566.78,764.66,170988.34,mortgage,38,4
12,170988.34,1331.44,564.26,767.18,170221.16,mortgage,38,4
13,170221.16,1331.44,561.73,769.71,169451.45,mortgage,38,4
14,169451.45,1331.44,559.19,772.25,168679.2,mortgage,38,4
15,168679.2,1331.44,556.64,774.8,167904.4,mortgage,38,4
16,167904.4,1331.44,554.08,777.36,167127.04,mortgage,38,4
17,167127.04,1331.44,551.52,779.92,166347.12,mortgage,38,4
18,166347.12,1331.44,548.95,782.49,165564.63,mortgage,38,4
19,165564.63,2677.13,546.36,2130.77,163433.86,mortgage,38,4
20,163433.86,2925.48,539.33,2386.15,161047.71,mortgage,38,4
21,161047.71,2925.48,531.46,2394.02,158653.69,mortgage,38,4
22,158653.69,2925.48,523.56,2401.92,156251.77,mortgage,38,4
23,156251.77,2925.48,515.63,2409.85,153841.92,mortgage,38,4
24,153841.92,2925.48,507.68,2417.8,151424.12,mortgage,38,4
25,151424.12,2925.48,499.7,2425.78,148998.34,mortgage,38,4
26,148998.34,2925.48,491.69,2433.79,146564.55,mortgage,38,4
27,146564.55,2925.48,483.66,2441.82,144122.73,mortgage,38,4
28,144122.73,2925.48,475.61,2449.87,141672.86,mortgage,38,4
29,141672.86,2925.48,467.52,2457.96,139214.9,mortgage,38,4
30,139214.9,2925.48,459.41,2466.07,136748.83,mortgage,38,4
31,136748.83,2925.48,451.27,2474.21,134274.62,mortgage,38,4
32,134274.62,2925.48,443.11,2482.37,131792.25,mortgage,38,4
33,131792.25,2925.48,434.91,2490.57,129301.68,mortgage,38,4
34,129301.68,2925.48,426.7,2498.78,126802.9,mortgage,38,4
35,126802.9,2925.48,418.45,2507.03,124295.87,mortgage,38,4
36,124295.87,2925.48,410.18,2515.3,121780.57,mortgage,38,4
37,121780.57,2925.48,401.88,2523.6,119256.97,mortgage,38,4
38,119256.97,2925.48,393.55,2531.93,116725.04,mortgage,38,4
39,116725.04,2925.48,385.19,2540.29,114184.75,mortgage,38,4
40,114184.75,2925.48,376.81,2548.67,111636.08,mortgage,38,4
41,111636.08,2925.48,368.4,2557.08,109079.0,mortgage,38,4
42,109079.0,2925.48,359.96,2565.52,106513.48,mortgage,38,4
43,106513.48,2925.48,351.49,2573.99,103939.49,mortgage,38,4
44,103939.49,2925.48,343.0,2582.48,101357.01,mortgage,38,4
45,101357.01,2925.48,334.48,2591.0,98766.01,mortgage,38,4
46,98766.01,2925.48,325.93,2599.55,96166.46,mortgage,38,4
47,96166.46,2925.48,317.35,2608.13,93558.33,mortgage,38,4
48,93558.33,2925.48,308.74,2616.74,90941.59,mortgage,38,4
49,90941.59,2925.48,300.11,2625.37,88316.22,mortgage,38,4
50,88316.22,2925.48,291.44,2634.04,85682.18,mortgage,38,4
51,85682.18,2925.48,282.75,2642.73,83039.45,mortgage,38,4
52,83039.45,2925.48,274.03,2651.45,80388.0,mortgage,38,4
53,80388.0,2925.48,265.28,2660.2,77727.8,mortgage,38,4
54,77727.8,2925.48,256.5,2668.98,75058.82,mortgage,38,4
55,75058.82,2925.48,247.69,2677.79,72381.03,mortgage,38,4
56,72381.03,2925.48,238.86,2686.62,69694.41,mortgage,38,4
57,69694.41,2925.48,229.99,2695.49,66998.92,mortgage,38,4
58,66998.92,2925.48,221.1,2704.38,64294.54,mortgage,38,4
59,64294.54,2925.48,212.17,2713.31,61581.23,mortgage,38,4
60,61581.23,2925.48,203.22,2722.26,58858.97,mortgage,38,4
61,58858.97,2925.48,194.23,2731.25,56127.72,mortgage,38,4
62,56127.72,2925.48,185.22,2740.26,53387.46,mortgage,38,4
63,53387.46,2925.48,176.18,2749.3,50638.16,mortgage,38,4
64,50638.16,2925.48,167.11,2758.37,47879.79,mortgage,38,4
65,47879.79,2925.48,158.0,2767.48,45112.31,mortgage,38,4
66,45112.31,2925.48,148.87,2776.61,42335.7,mortgage,38,4
67,42335.7,2925.48,139.71,2785.77,39549.93,mortgage,38,4
68,39549.93,2925.48,130.51,2794.97,36754.96,mortgage,38,4
69,36754.96,2925.48,121.29,2804.19,33950.77,mortgage,38,4
70,33950.77,2925.48,112.04,2813.44,31137.33,mortgage,38,4
71,31137.33,2925.48,102.75,2822.73,28314.6,mortgage,38,4
72,28314.6,2925.48,93.44,2832.04,25482.56,mortgage,38,4
73,25482.56,2925.48,84.09,2841.39,22641.17,mortgage,38,4
74,22641.17,2925.48,74.72,2850.76,19790.41,mortgage,38,4
75,19790.41,2925.48,65.31,2860.17,16930.24,mortgage,38,4
76,16930.24,2925.48,55.87,2869.61,14060.63,mortgage,38,4
77,14060.63,2925.48,46.4,2879.08,11181.55,mortgage,38,4
78,11181.55,2925.48,36.9,2888.58,8292.97,mortgage,38,4
79,8292.97,2925.48,27.37,2898.11,5394.86,mortgage,38,4
80,5394.86,2925.48,17.8,2907.68,2487.18,mortgage,38,4
81,2487.18,2925.48,8.21,2917.27,-430.09,mortgage,38,4
0,8250.57,84.62,53.63,30.99,8219.58,WellsFargo1,38,5
1,8219.58,84.62,53.43,31.19,8188.39,WellsFargo1,38,5
2,8188.39,84.62,53.22,31.4,8156.99,WellsFargo1,38,5
3,8156.99,84.62,53.02,31.6,8125.39,WellsFargo1,38,5
4,8125.39,84.62,52.82,31.8,8093.59,WellsFargo1,38,5
5,8093.59,84.62,52.61,32.01,8061.58,WellsFargo1,38,5
6,8061.58,84.62,52.4,32.22,8029.36,WellsFargo1,38,5
7,8029.36,84.62,52.19,32.43,7996.93,WellsFargo1,38,5
8,7996.93,84.62,51.98,32.64,7964.29,WellsFargo1,38,5
9,7964.29,84.62,51.77,32.85,7931.44,WellsFargo1,38,5
10,7931.44,84.62,51.55,33.07,7898.37,WellsFargo1,38,5
11,7898.37,84.62,51.34,33.28,7865.09,WellsFargo1,38,5
12,7865.09,84.62,51.12,33.5,7831.59,WellsFargo1,38,5
13,7831.59,84.62,50.91,33.71,7797.88,WellsFargo1,38,5
14,7797.88,84.62,50.69,33.93,7763.95,WellsFargo1,38,5
15,7763.95,84.62,50.47,34.15,7729.8,WellsFargo1,38,5
16,7729.8,84.62,50.24,34.38,7695.42,WellsFargo1,38,5
17,7695.42,84.62,50.02,34.6,7660.82,WellsFargo1,38,5
18,7660.82,84.62,49.8,34.82,7626.0,WellsFargo1,38,5
19,7626.0,84.62,49.57,35.05,7590.95,WellsFargo1,38,5
20,7590.95,84.62,49.34,35.28,7555.67,WellsFargo1,38,5
21,7555.67,84.62,49.11,35.51,7520.16,WellsFargo1,38,5
22,7520.16,84.62,48.88,35.74,7484.42,WellsFargo1,38,5
23,7484.42,84.62,48.65,35.97,7448.45,WellsFargo1,38,5
24,7448.45,84.62,48.41,36.21,7412.24,WellsFargo1,38,5
25,7412.24,84.62,48.18,36.44,7375.8,WellsFargo1,38,5
26,7375.8,84.62,47.94,36.68,7339.12,WellsFargo1,38,5
27,7339.12,84.62,47.7,36.92,7302.2,WellsFargo1,38,5
28,7302.2,84.62,47.46,37.16,7265.04,WellsFargo1,38,5
29,7265.04,84.62,47.22,37.4,7227.64,WellsFargo1,38,5
30,7227.64,84.62,46.98,37.64,7190.0,WellsFargo1,38,5
31,7190.0,84.62,46.73,37.89,7152.11,WellsFargo1,38,5
32,7152.11,84.62,46.49,38.13,7113.98,WellsFargo1,38,5
33,7113.98,84.62,46.24,38.38,7075.6,WellsFargo1,38,5
34,7075.6,84.62,45.99,38.63,7036.97,WellsFargo1,38,5
35,7036.97,84.62,45.74,38.88,6998.09,WellsFargo1,38,5
36,6998.09,84.62,45.49,39.13,6958.96,WellsFargo1,38,5
37,6958.96,84.62,45.23,39.39,6919.57,WellsFargo1,38,5
38,6919.57,84.62,44.98,39.64,6879.93,WellsFargo1,38,5
39,6879.93,84.62,44.72,39.9,6840.03,WellsFargo1,38,5
40,6840.03,84.62,44.46,40.16,6799.87,WellsFargo1,38,5
41,6799.87,84.62,44.2,40.42,6759.45,WellsFargo1,38,5
42,6759.45,84.62,43.94,40.68,6718.77,WellsFargo1,38,5
43,6718.77,84.62,43.67,40.95,6677.82,WellsFargo1,38,5
44,6677.82,84.62,43.41,41.21,6636.61,WellsFargo1,38,5
45,6636.61,84.62,43.14,41.48,6595.13,WellsFargo1,38,5
46,6595.13,84.62,42.87,41.75,6553.38,WellsFargo1,38,5
47,6553.38,84.62,42.6,42.02,6511.36,WellsFargo1,38,5
48,6511.36,84.62,42.32,42.3,6469.06,WellsFargo1,38,5
49,6469.06,84.62,42.05,42.57,6426.49,WellsFargo1,38,5
50,6426.49,84.62,41.77,42.85,6383.64,WellsFargo1,38,5
51,6383.64,84.62,41.49,43.13,6340.51,WellsFargo1,38,5
52,6340.51,84.62,41.21,43.41,6297.1,WellsFargo1,38,5
53,6297.1,84.62,40.93,43.69,6253.41,WellsFargo1,38,5
54,6253.41,84.62,40.65,43.97,6209.44,WellsFargo1,38,5
55,6209.44,84.62,40.36,44.26,6165.18,WellsFargo1,38,5
56,6165.18,84.62,40.07,44.55,6120.63,WellsFargo1,38,5
57,6120.63,84.62,39.78,44.84,6075.79,WellsFargo1,38,5
58,6075.79,84.62,39.49,45.13,6030.66,WellsFargo1,38,5
59,6030.66,84.62,39.2,45.42,5985.24,WellsFargo1,38,5
60,5985.24,84.62,38.9,45.72,5939.52,WellsFargo1,38,5
61,5939.52,84.62,38.61,46.01,5893.51,WellsFargo1,38,5
62,5893.51,84.62,38.31,46.31,5847.2,WellsFargo1,38,5
63,5847.2,84.62,38.01,46.61,5800.59,WellsFargo1,38,5
64,5800.59,84.62,37.7,46.92,5753.67,WellsFargo1,38,5
65,5753.67,84.62,37.4,47.22,5706.45,WellsFargo1,38,5
66,5706.45,84.62,37.09,47.53,5658.92,WellsFargo1,38,5
67,5658.92,84.62,36.78,47.84,5611.08,WellsFargo1,38,5
68,5611.08,84.62,36.47,48.15,5562.93,WellsFargo1,38,5
69,5562.93,84.62,36.16,48.46,5514.47,WellsFargo1,38,5
70,5514.47,84.62,35.84,48.78,5465.69,WellsFargo1,38,5
71,5465.69,84.62,35.53,49.09,5416.6,WellsFargo1,38,5
72,5416.6,84.62,35.21,49.41,5367.19,WellsFargo1,38,5
73,5367.19,84.62,34.89,49.73,5317.46,WellsFargo1,38,5
74,5317.46,84.62,34.56,50.06,5267.4,WellsFargo1,38,5
75,5267.4,84.62,34.24,50.38,5217.02,WellsFargo1,38,5
76,5217.02,84.62,33.91,50.71,5166.31,WellsFargo1,38,5
77,5166.31,84.62,33.58,51.04,5115.27,WellsFargo1,38,5
78,5115.27,84.62,33.25,51.37,5063.9,WellsFargo1,38,5
79,5063.9,84.62,32.92,51.7,5012.2,WellsFargo1,38,5
80,5012.2,84.62,32.58,52.04,4960.16,WellsFargo1,38,5
81,4960.16,514.71,32.24,482.47,4477.69,WellsFargo1,38,5
82,4477.69,3010.1,29.1,2981.0,1496.69,WellsFargo1,38,5
83,1496.69,3010.1,9.73,3000.37,-1503.68,WellsFargo1,38,5
0,5000.0,1333.0,36.0,1297.0,3703.0,Car,39,1
1,3703.0,1333.0,26.66,1306.34,2396.66,Car,39,1
2,2396.66,1333.0,17.26,1315.74,1080.92,Car,39,1
3,1080.92,1333.0,7.78,1325.22,-244.3,Car,39,1
0,20000.0,191.04,108.0,83.04,19916.96,WellsFargo2,39,2
1,19916.96,191.04,107.55,83.49,19833.47,WellsFargo2,39,2
2,19833.47,191.04,107.1,83.94,19749.53,WellsFargo2,39,2
3,19749.53,435.34,106.65,328.69,19420.84,WellsFargo2,39,2
4,19420.84,1524.04,104.87,1419.17,18001.67,WellsFargo2,39,2
5,18001.67,1524.04,97.21,1426.83,16574.84,WellsFargo2,39,2
6,16574.84,1524.04,89.5,1434.54,15140.3,WellsFargo2,39,2
7,15140.3,1524.04,81.76,1442.28,13698.02,WellsFargo2,39,2
8,13698.02,1524.04,73.97,1450.07,12247.95,WellsFargo2,39,2
9,12247.95,1524.04,66.14,1457.9,10790.05,WellsFargo2,39,2
10,10790.05,1524.04,58.27,1465.77,9324.28,WellsFargo2,39,2
11,9324.28,1524.04,50.35,1473.69,7850.59,WellsFargo2,39,2
12,7850.59,1524.04,42.39,1481.65,6368.94,WellsFargo2,39,2
13,6368.94,1524.04,34.39,1489.65,4879.29,WellsFargo2,39,2
14,4879.29,1524.04,26.35,1497.69,3381.6,WellsFargo2,39,2
15,3381.6,1524.04,18.26,1505.78,1875.82,WellsFargo2,39,2
16,1875.82,1524.04,10.13,1513.91,361.91,WellsFargo2,39,2
17,361.91,1524.04,1.95,1522.09,-1160.18,WellsFargo2,39,2
0,8250.57,84.62,53.63,30.99,8219.58,WellsFargo1,39,3
1,8219.58,84.62,53.43,31.19,8188.39,WellsFargo1,39,3
2,8188.39,84.62,53.22,31.4,8156.99,WellsFargo1,39,3
3,8156.99,84.62,53.02,31.6,8125.39,WellsFargo1,39,3
4,8125.39,84.62,52.82,31.8,8093.59,WellsFargo1,39,3
5,8093.59,84.62,52.61,32.01,8061.58,WellsFargo1,39,3
6,8061.58,84.62,52.4,32.22,8029.36,WellsFargo1,39,3
7,8029.36,84.62,52.19,32.43,7996.93,WellsFargo1,39,3
8,7996.93,84.62,51.98,32.64,7964.29,WellsFargo1,39,3
9,7964.29,84.62,51.77,32.85,7931.44,WellsFargo1,39,3
10,7931.44,84.62,51.55,33.07,7898.37,WellsFargo1,39,3
11,7898.37,84.62,51.34,33.28,7865.09,WellsFargo1,39,3
12,7865.09,84.62,51.12,33.5,7831.59,WellsFargo1,39,3
13,7831.59,84.62,50.91,33.71,7797.88,WellsFargo1,39,3
14,7797.88,84.62,50.69,33.93,7763.95,WellsFargo1,39,3
15,7763.95,84.62,50.47,34.15,7729.8,WellsFargo1,39,3
16,7729.8,84.62,50.24,34.38,7695.42,WellsFargo1,39,3
17,7695.42,1244.8,50.02,1194.78,6500.64,WellsFargo1,39,3
18,6500.64,1608.66,42.25,1566.41,4934.23,WellsFargo1,39,3
19,4934.23,1608.66,32.07,1576.59,3357.64,WellsFargo1,39,3
20,3357.64,1608.66,21.82,1586.84,1770.8,WellsFargo1,39,3
21,1770.8,1608.66,11.51,1597.15,173.65,WellsFargo1,39,3
22,173.65,1608.66,1.13,1607.53,-1433.88,WellsFargo1,39,3
0,4000.0,70.0,16.0,54.0,3946.0,testing,39,4
1,3946.0,70.0,15.78,54.22,3891.78,testing,39,4
2,3891.78,70.0,15.57,54.43,3837.35,testing,39,4
3,3837.35,70.0,15.35,54.65,3782.7,testing,39,4
4,3782.7,70.0,15.13,54.87,3727.83,testing,39,4
5,3727.83,70.0,14.91,55.09,3672.74,testing,39,4
6,3672.74,70.0,14.69,55.31,3617.43,testing,39,4
7,3617.43,70.0,14.47,55.53,3561.9,testing,39,4
8,3561.9,70.0,14.25,55.75,3506.15,testing,39,4
9,3506.15,70.0,14.02,55.98,3450.17,testing,39,4
10,3450.17,70.0,13.8,56.2,3393.97,testing,39,4
11,3393.97,70.0,13.58,56.42,3337.55,testing,39,4
12,3337.55,70.0,13.35,56.65,3280.9,testing,39,4
13,3280.9,70.0,13.12,56.88,3224.02,testing,39,4
14,3224.02,70.0,12.9,57.1,3166.92,testing,39,4
15,3166.92,70.0,12.67,57.33,3109.59,testing,39,4
16,3109.59,70.0,12.44,57.56,3052.03,testing,39,4
17,3052.03,70.0,12.21,57.79,2994.24,testing,39,4
18,2994.24,70.0,11.98,58.02,2936.22,testing,39,4
19,2936.22,70.0,11.74,58.26,2877.96,testing,39,4
20,2877.96,70.0,11.51,58.49,2819.47,testing,39,4
21,2819.47,70.0,11.28,58.72,2760.75,testing,39,4
22,2760.75,1503.88,11.04,1492.84,1267.91,testing,39,4
23,1267.91,1678.66,5.07,1673.59,-405.68,testing,39,4
0,180000.0,1331.44,594.0,737.44,179262.56,mortgage,39,5
1,179262.56,1331.44,591.57,739.87,178522.69,mortgage,39,5
2,178522.69,1331.44,589.12,742.32,177780.37,mortgage,39,5
3,177780.37,1331.44,586.68,744.76,177035.61,mortgage,39,5
4,177035.61,1331.44,584.22,747.22,176288.39,mortgage,39,5
5,176288.39,1331.44,581.75,749.69,175538.7,mortgage,39,5
6,175538.7,1331.44,579.28,752.16,174786.54,mortgage,39,5
7,174786.54,1331.44,576.8,754.64,174031.9,mortgage,39,5
8,174031.9,1331.44,574.31,757.13,173274.77,mortgage,39,5
9,173274.77,1331.44,571.81,759.63,172515.14,mortgage,39,5
10,172515.14,1331.44,569.3,762.14,171753.0,mortgage,39,5
11,171753.0,1331.44,566.78,764.66,170988.34,mortgage,39,5
12,170988.34,1331.44,564.26,767.18,170221.16,mortgage,39,5
13,170221.16,1331.44,561.73,769.71,169451.45,mortgage,39,5
14,169451.45,1331.44,559.19,772.25,168679.2,mortgage,39,5
15,168679.2,1331.44,556.64,774.8,167904.4,mortgage,39,5
16,167904.4,1331.44,554.08,777.36,167127.04,mortgage,39,5
17,167127.04,1331.44,551.52,779.92,166347.12,mortgage,39,5
18,166347.12,1331.44,548.95,782.49,165564.63,mortgage,39,5
19,165564.63,1331.44,546.36,785.08,164779.55,mortgage,39,5
20,164779.55,1331.44,543.77,787.67,163991.88,mortgage,39,5
21,163991.88,1331.44,541.17,790.27,163201.61,mortgage,39,5
22,163201.61,1331.44,538.57,792.87,162408.74,mortgage,39,5
23,162408.74,1737.12,535.95,1201.17,161207.57,mortgage,39,5
24,161207.57,3010.1,531.98,2478.12,158729.45,mortgage,39,5
25,158729.45,3010.1,523.81,2486.29,156243.16,mortgage,39,5
26,156243.16,3010.1,515.6,2494.5,153748.66,mortgage,39,5
27,153748.66,3010.1,507.37,2502.73,151245.93,mortgage,39,5
28,151245.93,3010.1,499.11,2510.99,148734.94,mortgage,39,5
29,148734.94,3010.1,490.83,2519.27,146215.67,mortgage,39,5
30,146215.67,3010.1,482.51,2527.59,143688.08,mortgage,39,5
31,143688.08,3010.1,474.17,2535.93,141152.15,mortgage,39,5
32,141152.15,3010.1,465.8,2544.3,138607.85,mortgage,39,5
33,138607.85,3010.1,457.41,2552.69,136055.16,mortgage,39,5
34,136055.16,3010.1,448.98,2561.12,133494.04,mortgage,39,5
35,133494.04,3010.1,440.53,2569.57,130924.47,mortgage,39,5
36,130924.47,3010.1,432.05,2578.05,128346.42,mortgage,39,5
37,128346.42,3010.1,423.54,2586.56,125759.86,mortgage,39,5
38,125759.86,3010.1,415.01,2595.09,123164.77,mortgage,39,5
39,123164.77,3010.1,406.44,2603.66,120561.11,mortgage,39,5
40,120561.11,3010.1,397.85,2612.25,117948.86,mortgage,39,5
41,117948.86,3010.1,389.23,2620.87,115327.99,mortgage,39,5
42,115327.99,3010.1,380.58,2629.52,112698.47,mortgage,39,5
43,112698.47,3010.1,371.9,2638.2,110060.27,mortgage,39,5
44,110060.27,3010.1,363.2,2646.9,107413.37,mortgage,39,5
45,107413.37,3010.1,354.46,2655.64,104757.73,mortgage,39,5
46,104757.73,3010.1,345.7,2664.4,102093.33,mortgage,39,5
47,102093.33,3010.1,336.91,2673.19,99420.14,mortgage,39,5
48,99420.14,3010.1,328.09,2682.01,96738.13,mortgage,39,5
49,96738.13,3010.1,319.24,2690.86,94047.27,mortgage,39,5
50,94047.27,3010.1,310.36,2699.74,91347.53,mortgage,39,5
51,91347.53,3010.1,301.45,2708.65,88638.88,mortgage,39,5
52,88638.88,3010.1,292.51,2717.59,85921.29,mortgage,39,5
53,85921.29,3010.1,283.54,2726.56,83194.73,mortgage,39,5
54,83194.73,3010.1,274.54,2735.56,80459.17,mortgage,39,5
55,80459.17,3010.1,265.52,2744.58,77714.59,mortgage,39,5
56,77714.59,3010.1,256.46,2753.64,74960.95,mortgage,39,5
57,74960.95,3010.1,247.37,2762.73,72198.22,mortgage,39,5
58,72198.22,3010.1,238.25,2771.85,69426.37,mortgage,39,5
59,69426.37,3010.1,229.11,2780.99,66645.38,mortgage,39,5
60,66645.38,3010.1,219.93,2790.17,63855.21,mortgage,39,5
61,63855.21,3010.1,210.72,2799.38,61055.83,mortgage,39,5
62,61055.83,3010.1,201.48,2808.62,58247.21,mortgage,39,5
63,58247.21,3010.1,192.22,2817.88,55429.33,mortgage,39,5
64,55429.33,3010.1,182.92,2827.18,52602.15,mortgage,39,5
65,52602.15,3010.1,173.59,2836.51,49765.64,mortgage,39,5
66,49765.64,3010.1,164.23,2845.87,46919.77,mortgage,39,5
67,46919.77,3010.1,154.84,2855.26,44064.51,mortgage,39,5
68,44064.51,3010.1,145.41,2864.69,41199.82,mortgage,39,5
69,41199.82,3010.1,135.96,2874.14,38325.68,mortgage,39,5
70,38325.68,3010.1,126.47,2883.63,35442.05,mortgage,39,5
71,35442.05,3010.1,116.96,2893.14,32548.91,mortgage,39,5
72,32548.91,3010.1,107.41,2902.69,29646.22,mortgage,39,5
73,29646.22,3010.1,97.83,2912.27,26733.95,mortgage,39,5
74,26733.95,3010.1,88.22,2921.88,23812.07,mortgage,39,5
75,23812.07,3010.1,78.58,2931.52,20880.55,mortgage,39,5
76,20880.55,3010.1,68.91,2941.19,17939.36,mortgage,39,5
77,17939.36,3010.1,59.2,2950.9,14988.46,mortgage,39,5
78,14988.46,3010.1,49.46,2960.64,12027.82,mortgage,39,5
79,12027.82,3010.1,39.69,2970.41,9057.41,mortgage,39,5
80,9057.41,3010.1,29.89,2980.21,6077.2,mortgage,39,5
81,6077.2,3010.1,20.05,2990.05,3087.15,mortgage,39,5
82,3087.15,3010.1,10.19,2999.91,87.24,mortgage,39,5
83,87.24,3010.1,0.29,3009.81,-2922.57,mortgage,39,5
0,5000.0,1333.0,36.0,1297.0,3703.0,Car,40,1
1,3703.0,1333.0,26.66,1306.34,2396.66,Car,40,1
2,2396.66,1333.0,17.26,1315.74,1080.92,Car,40,1
3,1080.92,1333.0,7.78,1325.22,-244.3,Car,40,1
0,20000.0,191.04,108.0,83.04,19916.96,WellsFargo2,40,2
1,19916.96,191.04,107.55,83.49,19833.47,WellsFargo2,40,2
2,19833.47,191.04,107.1,83.94,19749.53,WellsFargo2,40,2
3,19749.53,435.34,106.65,328.69,19420.84,WellsFargo2,40,2
4,19420.84,1524.04,104.87,1419.17,18001.67,WellsFargo2,40,2
5,18001.67,1524.04,97.21,1426.83,16574.84,WellsFargo2,40,2
6,16574.84,1524.04,89.5,1434.54,15140.3,WellsFargo2,40,2
7,15140.3,1524.04,81.76,1442.28,13698.02,WellsFargo2,40,2
8,13698.02,1524.04,73.97,1450.07,12247.95,WellsFargo2,40,2
9,12247.95,1524.04,66.14,1457.9,10790.05,WellsFargo2,40,2
10,10790.05,1524.04,58.27,1465.77,9324.28,WellsFargo2,40,2
11,9324.28,1524.04,50.35,1473.69,7850.59,WellsFargo2,40,2
12,7850.59,1524.04,42.39,1481.65,6368.94,WellsFargo2,40,2
13,6368.94,1524.04,34.39,1489.65,4879.29,WellsFargo2,40,2
14,4879.29,1524.04,26.35,1497.69,3381.6,WellsFargo2,40,2
15,3381.6,1524.04,18.26,1505.78,1875.82,WellsFargo2,40,2
16,1875.82,1524.04,10.13,1513.91,361.91,WellsFargo2,40,2
17,361.91,1524.04,1.95,1522.09,-1160.18,WellsFargo2,40,2
0,8250.57,84.62,53.63,30.99,8219.58,WellsFargo1,40,3
1,8219.58,84.62,53.43,31.19,8188.39,WellsFargo1,40,3
2,8188.39,84.62,53.22,31.4,8156.99,WellsFargo1,40,3
3,8156.99,84.62,53.02,31.6,8125.39,WellsFargo1,40,3
4,8125.39,84.62,52.82,31.8,8093.59,WellsFargo1,40,3
5,8093.59,84.62,52.61,32.01,8061.58,WellsFargo1,40,3
6,8061.58,84.62,52.4,32.22,8029.36,WellsFargo1,40,3
7,8029.36,84.62,52.19,32.43,7996.93,WellsFargo1,40,3
8,7996.93,84.62,51.98,32.64,7964.29,WellsFargo1,40,3
9,7964.29,84.62,51.77,32.85,7931.44,WellsFargo1,40,3
10,7931.44,84.62,51.55,33.07,7898.37,WellsFargo1,40,3
11,7898.37,84.62,51.34,33.28,7865.09,WellsFargo1,40,3
12,7865.09,84.62,51.12,33.5,7831.59,WellsFargo1,40,3
13,7831.59,84.62,50.91,33.71,7797.88,WellsFargo1,40,3
14,7797.88,84.62,50.69,33.93,7763.95,WellsFargo1,40,3
15,7763.95,84.62,50.47,34.15,7729.8,WellsFargo1,40,3
16,7729.8,84.62,50.24,34.38,7695.42,WellsFargo1,40,3
17,7695.42,1244.8,50.02,1194.78,6500.64,WellsFargo1,40,3
18,6500.64,1608.66,42.25,1566.41,4934.23,WellsFargo1,40,3
19,4934.23,1608.66,32.07,1576.59,3357.64,WellsFargo1,40,3
20,3357.64,1608.66,21.82,1586.84,1770.8,WellsFargo1,40,3
21,1770.8,1608.66,11.51,1597.15,173.65,WellsFargo1,40,3
22,173.65,1608.66,1.13,1607.53,-1433.88,WellsFargo1,40,3
0,180000.0,1331.44,594.0,737.44,179262.56,mortgage,40,4
1,179262.56,1331.44,591.57,739.87,178522.69,mortgage,40,4
2,178522.69,1331.44,589.12,742.32,177780.37,mortgage,40,4
3,177780.37,1331.44,586.68,744.76,177035.61,mortgage,40,4
4,177035.61,1331.44,584.22,747.22,176288.39,mortgage,40,4
5,176288.39,1331.44,581.75,749.69,175538.7,mortgage,40,4
6,175538.7,1331.44,579.28,752.16,174786.54,mortgage,40,4
7,174786.54,1331.44,576.8,754.64,174031.9,mortgage,40,4
8,174031.9,1331.44,574.31,757.13,173274.77,mortgage,40,4
9,173274.77,1331.44,571.81,759.63,172515.14,mortgage,40,4
10,172515.14,1331.44,569.3,762.14,171753.0,mortgage,40,4
11,171753.0,1331.44,566.78,764.66,170988.34,mortgage,40,4
12,170988.34,1331.44,564.26,767.18,170221.16,mortgage,40,4
13,170221.16,1331.44,561.73,769.71,169451.45,mortgage,40,4
14,169451.45,1331.44,559.19,772.25,168679.2,mortgage,40,4
15,168679.2,1331.44,556.64,774.8,167904.4,mortgage,40,4
16,167904.4,1331.44,554.08,777.36,167127.04,mortgage,40,4
17,167127.04,1331.44,551.52,779.92,166347.12,mortgage,40,4
18,166347.12,1331.44,548.95,782.49,165564.63,mortgage,40,4
19,165564.63,1331.44,546.36,785.08,164779.55,mortgage,40,4
20,164779.55,1331.44,543.77,787.67,163991.88,mortgage,40,4
21,163991.88,1331.44,541.17,790.27,163201.61,mortgage,40,4
22,163201.61,2765.32,538.57,2226.75,160974.86,mortgage,40,4
23,160974.86,2940.1,531.22,2408.88,158565.98,mortgage,40,4
24,158565.98,2940.1,523.27,2416.83,156149.15,mortgage,40,4
25,156149.15,2940.1,515.29,2424.81,153724.34,mortgage,40,4
26,153724.34,2940.1,507.29,2432.81,151291.53,mortgage,40,4
27,151291.53,2940.1,499.26,2440.84,148850.69,mortgage,40,4
28,148850.69,2940.1,491.21,2448.89,146401.8,mortgage,40,4
29,146401.8,2940.1,483.13,2456.97,143944.83,mortgage,40,4
30,143944.83,2940.1,475.02,2465.08,141479.75,mortgage,40,4
31,141479.75,2940.1,466.88,2473.22,139006.53,mortgage,40,4
32,139006.53,2940.1,458.72,2481.38,136525.15,mortgage,40,4
33,136525.15,2940.1,450.53,2489.57,134035.58,mortgage,40,4
34,134035.58,2940.1,442.32,2497.78,131537.8,mortgage,40,4
35,131537.8,2940.1,434.07,2506.03,129031.77,mortgage,40,4
36,129031.77,2940.1,425.8,2514.3,126517.47,mortgage,40,4
37,126517.47,2940.1,417.51,2522.59,123994.88,mortgage,40,4
38,123994.88,2940.1,409.18,2530.92,121463.96,mortgage,40,4
39,121463.96,2940.1,400.83,2539.27,118924.69,mortgage,40,4
40,118924.69,2940.1,392.45,2547.65,116377.04,mortgage,40,4
41,116377.04,2940.1,384.04,2556.06,113820.98,mortgage,40,4
42,113820.98,2940.1,375.61,2564.49,111256.49,mortgage,40,4
43,111256.49,2940.1,367.15,2572.95,108683.54,mortgage,40,4
44,108683.54,2940.1,358.66,2581.44,106102.1,mortgage,40,4
45,106102.1,2940.1,350.14,2589.96,103512.14,mortgage,40,4
46,103512.14,2940.1,341.59,2598.51,100913.63,mortgage,40,4
47,100913.63,2940.1,333.01,2607.09,98306.54,mortgage,40,4
48,98306.54,2940.1,324.41,2615.69,95690.85,mortgage,40,4
49,95690.85,2940.1,315.78,2624.32,93066.53,mortgage,40,4
50,93066.53,2940.1,307.12,2632.98,90433.55,mortgage,40,4
51,90433.55,2940.1,298.43,2641.67,87791.88,mortgage,40,4
52,87791.88,2940.1,289.71,2650.39,85141.49,mortgage,40,4
53,85141.49,2940.1,280.97,2659.13,82482.36,mortgage,40,4
54,82482.36,2940.1,272.19,2667.91,79814.45,mortgage,40,4
55,79814.45,2940.1,263.39,2676.71,77137.74,mortgage,40,4
56,77137.74,2940.1,254.55,2685.55,74452.19,mortgage,40,4
57,74452.19,2940.1,245.69,2694.41,71757.78,mortgage,40,4
58,71757.78,2940.1,236.8,2703.3,69054.48,mortgage,40,4
59,69054.48,2940.1,227.88,2712.22,66342.26,mortgage,40,4
60,66342.26,2940.1,218.93,2721.17,63621.09,mortgage,40,4
61,63621.09,2940.1,209.95,2730.15,60890.94,mortgage,40,4
62,60890.94,2940.1,200.94,2739.16,58151.78,mortgage,40,4
63,58151.78,2940.1,191.9,2748.2,55403.58,mortgage,40,4
64,55403.58,2940.1,182.83,2757.27,52646.31,mortgage,40,4
65,52646.31,2940.1,173.73,2766.37,49879.94,mortgage,40,4
66,49879.94,2940.1,164.6,2775.5,47104.44,mortgage,40,4
67,47104.44,2940.1,155.44,2784.66,44319.78,mortgage,40,4
68,44319.78,2940.1,146.26,2793.84,41525.94,mortgage,40,4
69,41525.94,2940.1,137.04,2803.06,38722.88,mortgage,40,4
70,38722.88,2940.1,127.79,2812.31,35910.57,mortgage,40,4
71,35910.57,2940.1,118.5,2821.6,33088.97,mortgage,40,4
72,33088.97,2940.1,109.19,2830.91,30258.06,mortgage,40,4
73,30258.06,2940.1,99.85,2840.25,27417.81,mortgage,40,4
74,27417.81,2940.1,90.48,2849.62,24568.19,mortgage,40,4
75,24568.19,2940.1,81.08,2859.02,21709.17,mortgage,40,4
76,21709.17,2940.1,71.64,2868.46,18840.71,mortgage,40,4
77,18840.71,2940.1,62.17,2877.93,15962.78,mortgage,40,4
78,15962.78,2940.1,52.68,2887.42,13075.36,mortgage,40,4
79,13075.36,2940.1,43.15,2896.95,10178.41,mortgage,40,4
80,10178.41,2940.1,33.59,2906.51,7271.9,mortgage,40,4
81,7271.9,2940.1,24.0,2916.1,4355.8,mortgage,40,4
82,4355.8,2940.1,14.37,2925.73,1430.07,mortgage,40,4
83,1430.07,2940.1,4.72,2935.38,-1505.31,mortgage,40,4
0,4000.0,70.0,16.0,54.0,3946.0,testing,40,5
1,3946.0,70.0,15.78,54.22,3891.78,testing,40,5
2,3891.78,70.0,15.57,54.43,3837.35,testing,40,5
3,3837.35,70.0,15.35,54.65,3782.7,testing,40,5
4,3782.7,70.0,15.13,54.87,3727.83,testing,40,5
5,3727.83,70.0,14.91,55.09,3672.74,testing,40,5
6,3672.74,70.0,14.69,55.31,3617.43,testing,40,5
7,3617.43,70.0,14.47,55.53,3561.9,testing,40,5
8,3561.9,70.0,14.25,55.75,3506.15,testing,40,5
9,3506.15,70.0,14.02,55.98,3450.17,testing,40,5
10,3450.17,70.0,13.8,56.2,3393.97,testing,40,5
11,3393.97,70.0,13.58,56.42,3337.55,testing,40,5
12,3337.55,70.0,13.35,56.65,3280.9,testing,40,5
13,3280.9,70.0,13.12,56.88,3224.02,testing,40,5
14,3224.02,70.0,12.9,57.1,3166.92,testing,40,5
15,3166.92,70.0,12.67,57.33,3109.59,testing,40,5
16,3109.59,70.0,12.44,57.56,3052.03,testing,40,5
17,3052.03,70.0,12.21,57.79,2994.24,testing,40,5
18,2994.24,70.0,11.98,58.02,2936.22,testing,40,5
19,2936.22,70.0,11.74,58.26,2877.96,testing,40,5
20,2877.96,70.0,11.51,58.49,2819.47,testing,40,5
21,2819.47,70.0,11.28,58.72,2760.75,testing,40,5
22,2760.75,70.0,11.04,58.96,2701.79,testing,40,5
23,2701.79,70.0,10.81,59.19,2642.6,testing,40,5
24,2642.6,70.0,10.57,59.43,2583.17,testing,40,5
25,2583.17,70.0,10.33,59.67,2523.5,testing,40,5
26,2523.5,70.0,10.09,59.91,2463.59,testing,40,5
27,2463.59,70.0,9.85,60.15,2403.44,testing,40,5
28,2403.44,70.0,9.61,60.39,2343.05,testing,40,5
29,2343.05,70.0,9.37,60.63,2282.42,testing,40,5
30,2282.42,70.0,9.13,60.87,2221.55,testing,40,5
31,2221.55,70.0,8.89,61.11,2160.44,testing,40,5
32,2160.44,70.0,8.64,61.36,2099.08,testing,40,5
33,2099.08,70.0,8.4,61.6,2037.48,testing,40,5
34,2037.48,70.0,8.15,61.85,1975.63,testing,40,5
35,1975.63,70.0,7.9,62.1,1913.53,testing,40,5
36,1913.53,70.0,7.65,62.35,1851.18,testing,40,5
37,1851.18,70.0,7.4,62.6,1788.58,testing,40,5
38,1788.58,70.0,7.15,62.85,1725.73,testing,40,5
39,1725.73,70.0,6.9,63.1,1662.63,testing,40,5
40,1662.63,70.0,6.65,63.35,1599.28,testing,40,5
41,1599.28,70.0,6.4,63.6,1535.68,testing,40,5
42,1535.68,70.0,6.14,63.86,1471.82,testing,40,5
43,1471.82,70.0,5.89,64.11,1407.71,testing,40,5
44,1407.71,70.0,5.63,64.37,1343.34,testing,40,5
45,1343.34,70.0,5.37,64.63,1278.71,testing,40,5
46,1278.71,70.0,5.11,64.89,1213.82,testing,40,5
47,1213.82,70.0,4.86,65.14,1148.68,testing,40,5
48,1148.68,70.0,4.59,65.41,1083.27,testing,40,5
49,1083.27,70.0,4.33,65.67,1017.6,testing,40,5
50,1017.6,70.0,4.07,65.93,951.67,testing,40,5
51,951.67,70.0,3.81,66.19,885.48,testing,40,5
52,885.48,70.0,3.54,66.46,819.02,testing,40,5
53,819.02,70.0,3.28,66.72,752.3,testing,40,5
54,752.3,70.0,3.01,66.99,685.31,testing,40,5
55,685.31,70.0,2.74,67.26,618.05,testing,40,5
56,618.05,70.0,2.47,67.53,550.52,testing,40,5
57,550.52,70.0,2.2,67.8,482.72,testing,40,5
58,482.72,70.0,1.93,68.07,414.65,testing,40,5
59,414.65,70.0,1.66,68.34,346.31,testing,40,5
60,346.31,70.0,1.39,68.61,277.7,testing,40,5
61,277.7,70.0,1.11,68.89,208.81,testing,40,5
62,208.81,70.0,0.84,69.16,139.65,testing,40,5
63,139.65,70.0,0.56,69.44,70.21,testing,40,5
64,70.21,70.0,0.28,69.72,0.49,testing,40,5
65,0.49,70.0,0.0,70.0,-69.51,testing,40,5
0,5000.0,1333.0,36.0,1297.0,3703.0,Car,41,1
1,3703.0,1333.0,26.66,1306.34,2396.66,Car,41,1
2,2396.66,1333.0,17.26,1315.74,1080.92,Car,41,1
3,1080.92,1333.0,7.78,1325.22,-244.3,Car,41,1
0,20000.0,191.04,108.0,83.04,19916.96,WellsFargo2,41,2
1,19916.96,191.04,107.55,83.49,19833.47,WellsFargo2,41,2
2,19833.47,191.04,107.1,83.94,19749.53,WellsFargo2,41,2
3,19749.53,435.34,106.65,328.69,19420.84,WellsFargo2,41,2
4,19420.84,1524.04,104.87,1419.17,18001.67,WellsFargo2,41,2
5,18001.67,1524.04,97.21,1426.83,16574.84,WellsFargo2,41,2
6,16574.84,1524.04,89.5,1434.54,15140.3,WellsFargo2,41,2
7,15140.3,1524.04,81.76,1442.28,13698.02,WellsFargo2,41,2
8,13698.02,1524.04,73.97,1450.07,12247.95,WellsFargo2,41,2
9,12247.95,1524.04,66.14,1457.9,10790.05,WellsFargo2,41,2
10,10790.05,1524.04,58.27,1465.77,9324.28,WellsFargo2,41,2
11,9324.28,1524.04,50.35,1473.69,7850.59,WellsFargo2,41,2
12,7850.59,1524.04,42.39,1481.65,6368.94,WellsFargo2,41,2
13,6368.94,1524.04,34.39,1489.65,4879.29,WellsFargo2,41,2
14,4879.29,1524.04,26.35,1497.69,3381.6,WellsFargo2,41,2
15,3381.6,1524.04,18.26,1505.78,1875.82,WellsFargo2,41,2
16,1875.82,1524.04,10.13,1513.91,361.91,WellsFargo2,41,2
17,361.91,1524.04,1.95,1522.09,-1160.18,WellsFargo2,41,2
0,180000.0,1331.44,594.0,737.44,179262.56,mortgage,41,3
1,179262.56,1331.44,591.57,739.87,178522.69,mortgage,41,3
2,178522.69,1331.44,589.12,742.32,177780.37,mortgage,41,3
3,177780.37,1331.44,586.68,744.76,177035.61,mortgage,41,3
4,177035.61,1331.44,584.22,747.22,176288.39,mortgage,41,3
5,176288.39,1331.44,581.75,749.69,175538.7,mortgage,41,3
6,175538.7,1331.44,579.28,752.16,174786.54,mortgage,41,3
7,174786.54,1331.44,576.8,754.64,174031.9,mortgage,41,3
8,174031.9,1331.44,574.31,757.13,173274.77,mortgage,41,3
9,173274.77,1331.44,571.81,759.63,172515.14,mortgage,41,3
10,172515.14,1331.44,569.3,762.14,171753.0,mortgage,41,3
11,171753.0,1331.44,566.78,764.66,170988.34,mortgage,41,3
12,170988.34,1331.44,564.26,767.18,170221.16,mortgage,41,3
13,170221.16,1331.44,561.73,769.71,169451.45,mortgage,41,3
14,169451.45,1331.44,559.19,772.25,168679.2,mortgage,41,3
15,168679.2,1331.44,556.64,774.8,167904.4,mortgage,41,3
16,167904.4,1331.44,554.08,777.36,167127.04,mortgage,41,3
17,167127.04,2491.62,551.52,1940.1,165186.94,mortgage,41,3
18,165186.94,2855.48,545.12,2310.36,162876.58,mortgage,41,3
19,162876.58,2855.48,537.49,2317.99,160558.59,mortgage,41,3
20,160558.59,2855.48,529.84,2325.64,158232.95,mortgage,41,3
21,158232.95,2855.48,522.17,2333.31,155899.64,mortgage,41,3
22,155899.64,2855.48,514.47,2341.01,153558.63,mortgage,41,3
23,153558.63,2855.48,506.74,2348.74,151209.89,mortgage,41,3
24,151209.89,2855.48,498.99,2356.49,148853.4,mortgage,41,3
25,148853.4,2855.48,491.22,2364.26,146489.14,mortgage,41,3
26,146489.14,2855.48,483.41,2372.07,144117.07,mortgage,41,3
27,144117.07,2855.48,475.59,2379.89,141737.18,mortgage,41,3
28,141737.18,2855.48,467.73,2387.75,139349.43,mortgage,41,3
29,139349.43,2855.48,459.85,2395.63,136953.8,mortgage,41,3
30,136953.8,2855.48,451.95,2403.53,134550.27,mortgage,41,3
31,134550.27,2855.48,444.02,2411.46,132138.81,mortgage,41,3
32,132138.81,2855.48,436.06,2419.42,129719.39,mortgage,41,3
33,129719.39,2855.48,428.07,2427.41,127291.98,mortgage,41,3
34,127291.98,2855.48,420.06,2435.42,124856.56,mortgage,41,3
35,124856.56,2855.48,412.03,2443.45,122413.11,mortgage,41,3
36,122413.11,2855.48,403.96,2451.52,119961.59,mortgage,41,3
37,119961.59,2855.48,395.87,2459.61,117501.98,mortgage,41,3
38,117501.98,2855.48,387.76,2467.72,115034.26,mortgage,41,3
39,115034.26,2855.48,379.61,2475.87,112558.39,mortgage,41,3
40,112558.39,2855.48,371.44,2484.04,110074.35,mortgage,41,3
41,110074.35,2855.48,363.25,2492.23,107582.12,mortgage,41,3
42,107582.12,2855.48,355.02,2500.46,105081.66,mortgage,41,3
43,105081.66,2855.48,346.77,2508.71,102572.95,mortgage,41,3
44,102572.95,2855.48,338.49,2516.99,100055.96,mortgage,41,3
45,100055.96,2855.48,330.18,2525.3,97530.66,mortgage,41,3
46,97530.66,2855.48,321.85,2533.63,94997.03,mortgage,41,3
47,94997.03,2855.48,313.49,2541.99,92455.04,mortgage,41,3
48,92455.04,2855.48,305.1,2550.38,89904.66,mortgage,41,3
49,89904.66,2855.48,296.69,2558.79,87345.87,mortgage,41,3
50,87345.87,2855.48,288.24,2567.24,84778.63,mortgage,41,3
51,84778.63,2855.48,279.77,2575.71,82202.92,mortgage,41,3
52,82202.92,2855.48,271.27,2584.21,79618.71,mortgage,41,3
53,79618.71,2855.48,262.74,2592.74,77025.97,mortgage,41,3
54,77025.97,2855.48,254.19,2601.29,74424.68,mortgage,41,3
55,74424.68,2855.48,245.6,2609.88,71814.8,mortgage,41,3
56,71814.8,2855.48,236.99,2618.49,69196.31,mortgage,41,3
57,69196.31,2855.48,228.35,2627.13,66569.18,mortgage,41,3
58,66569.18,2855.48,219.68,2635.8,63933.38,mortgage,41,3
59,63933.38,2855.48,210.98,2644.5,61288.88,mortgage,41,3
60,61288.88,2855.48,202.25,2653.23,58635.65,mortgage,41,3
61,58635.65,2855.48,193.5,2661.98,55973.67,mortgage,41,3
62,55973.67,2855.48,184.71,2670.77,53302.9,mortgage,41,3
63,53302.9,2855.48,175.9,2679.58,50623.32,mortgage,41,3
64,50623.32,2855.48,167.06,2688.42,47934.9,mortgage,41,3
65,47934.9,2855.48,158.19,2697.29,45237.61,mortgage,41,3
66,45237.61,2855.48,149.28,2706.2,42531.41,mortgage,41,3
67,42531.41,2855.48,140.35,2715.13,39816.28,mortgage,41,3
68,39816.28,2855.48,131.39,2724.09,37092.19,mortgage,41,3
69,37092.19,2855.48,122.4,2733.08,34359.11,mortgage,41,3
70,34359.11,2855.48,113.39,2742.09,31617.02,mortgage,41,3
71,31617.02,2855.48,104.34,2751.14,28865.88,mortgage,41,3
72,28865.88,2855.48,95.26,2760.22,26105.66,mortgage,41,3
73,26105.66,2855.48,86.15,2769.33,23336.33,mortgage,41,3
74,23336.33,2855.48,77.01,2778.47,20557.86,mortgage,41,3
75,20557.86,2855.48,67.84,2787.64,17770.22,mortgage,41,3
76,17770.22,2855.48,58.64,2796.84,14973.38,mortgage,41,3
77,14973.38,2855.48,49.41,2806.07,12167.31,mortgage,41,3
78,12167.31,2855.48,40.15,2815.33,9351.98,mortgage,41,3
79,9351.98,2855.48,30.86,2824.62,6527.36,mortgage,41,3
80,6527.36,2855.48,21.54,2833.94,3693.42,mortgage,41,3
81,3693.42,2855.48,12.19,2843.29,850.13,mortgage,41,3
82,850.13,2855.48,2.81,2852.67,-2002.54,mortgage,41,3
0,4000.0,70.0,16.0,54.0,3946.0,testing,41,4
1,3946.0,70.0,15.78,54.22,3891.78,testing,41,4
2,3891.78,70.0,15.57,54.43,3837.35,testing,41,4
3,3837.35,70.0,15.35,54.65,3782.7,testing,41,4
4,3782.7,70.0,15.13,54.87,3727.83,testing,41,4
5,3727.83,70.0,14.91,55.09,3672.74,testing,41,4
6,3672.74,70.0,14.69,55.31,3617.43,testing,41,4
7,3617.43,70.0,14.47,55.53,3561.9,testing,41,4
8,3561.9,70.0,14.25,55.75,3506.15,testing,41,4
9,3506.15,70.0,14.02,55.98,3450.17,testing,41,4
10,3450.17,70.0,13.8,56.2,3393.97,testing,41,4
11,3393.97,70.0,13.58,56.42,3337.55,testing,41,4
12,3337.55,70.0,13.35,56.65,3280.9,testing,41,4
13,3280.9,70.0,13.12,56.88,3224.02,testing,41,4
14,3224.02,70.0,12.9,57.1,3166.92,testing,41,4
15,3166.92,70.0,12.67,57.33,3109.59,testing,41,4
16,3109.59,70.0,12.44,57.56,3052.03,testing,41,4
17,3052.03,70.0,12.21,57.79,2994.24,testing,41,4
18,2994.24,70.0,11.98,58.02,2936.22,testing,41,4
19,2936.22,70.0,11.74,58.26,2877.96,testing,41,4
20,2877.96,70.0,11.51,58.49,2819.47,testing,41,4
21,2819.47,70.0,11.28,58.72,2760.75,testing,41,4
22,2760.75,70.0,11.04,58.96,2701.79,testing,41,4
23,2701.79,70.0,10.81,59.19,2642.6,testing,41,4
24,2642.6,70.0,10.57,59.43,2583.17,testing,41,4
25,2583.17,70.0,10.33,59.67,2523.5,testing,41,4
26,2523.5,70.0,10.09,59.91,2463.59,testing,41,4
27,2463.59,70.0,9.85,60.15,2403.44,testing,41,4
28,2403.44,70.0,9.61,60.39,2343.05,testing,41,4
29,2343.05,70.0,9.37,60.63,2282.42,testing,41,4
30,2282.42,70.0,9.13,60.87,2221.55,testing,41,4
31,2221.55,70.0,8.89,61.11,2160.44,testing,41,4
32,2160.44,70.0,8.64,61.36,2099.08,testing,41,4
33,2099.08,70.0,8.4,61.6,2037.48,testing,41,4
34,2037.48,70.0,8.15,61.85,1975.63,testing,41,4
35,1975.63,70.0,7.9,62.1,1913.53,testing,41,4
36,1913.53,70.0,7.65,62.35,1851.18,testing,41,4
37,1851.18,70.0,7.4,62.6,1788.58,testing,41,4
38,1788.58,70.0,7.15,62.85,1725.73,testing,41,4
39,1725.73,70.0,6.9,63.1,1662.63,testing,41,4
40,1662.63,70.0,6.65,63.35,1599.28,testing,41,4
41,1599.28,70.0,6.4,63.6,1535.68,testing,41,4
42,1535.68,70.0,6.14,63.86,1471.82,testing,41,4
43,1471.82,70.0,5.89,64.11,1407.71,testing,41,4
44,1407.71,70.0,5.63,64.37,1343.34,testing,41,4
45,1343.34,70.0,5.37,64.63,1278.71,testing,41,4
46,1278.71,70.0,5.11,64.89,1213.82,testing,41,4
47,1213.82,70.0,4.86,65.14,1148.68,testing,41,4
48,1148.68,70.0,4.59,65.41,1083.27,testing,41,4
49,1083.27,70.0,4.33,65.67,1017.6,testing,41,4
50,1017.6,70.0,4.07,65.93,951.67,testing,41,4
51,951.67,70.0,3.81,66.19,885.48,testing,41,4
52,885.48,70.0,3.54,66.46,819.02,testing,41,4
53,819.02,70.0,3.28,66.72,752.3,testing,41,4
54,752.3,70.0,3.01,66.99,685.31,testing,41,4
55,685.31,70.0,2.74,67.26,618.05,testing,41,4
56,618.05,70.0,2.47,67.53,550.52,testing,41,4
57,550.52,70.0,2.2,67.8,482.72,testing,41,4
58,482.72,70.0,1.93,68.07,414.65,testing,41,4
59,414.65,70.0,1.66,68.34,346.31,testing,41,4
60,346.31,70.0,1.39,68.61,277.7,testing,41,4
61,277.7,70.0,1.11,68.89,208.81,testing,41,4
62,208.81,70.0,0.84,69.16,139.65,testing,41,4
63,139.65,70.0,0.56,69.44,70.21,testing,41,4
64,70.21,70.0,0.28,69.72,0.49,testing,41,4
65,0.49,70.0,0.0,70.0,-69.51,testing,41,4
0,8250.57,84.62,53.63,30.99,8219.58,WellsFargo1,41,5
1,8219.58,84.62,53.43,31.19,8188.39,WellsFargo1,41,5
2,8188.39,84.62,53.22,31.4,8156.99,WellsFargo1,41,5
3,8156.99,84.62,53.02,31.6,8125.39,WellsFargo1,41,5
4,8125.39,84.62,52.82,31.8,8093.59,WellsFargo1,41,5
5,8093.59,84.62,52.61,32.01,8061.58,WellsFargo1,41,5
6,8061.58,84.62,52.4,32.22,8029.36,WellsFargo1,41,5
7,8029.36,84.62,52.19,32.43,7996.93,WellsFargo1,41,5
8,7996.93,84.62,51.98,32.64,7964.29,WellsFargo1,41,5
9,7964.29,84.62,51.77,32.85,7931.44,WellsFargo1,41,5
10,7931.44,84.62,51.55,33.07,7898.37,WellsFargo1,41,5
11,7898.37,84.62,51.34,33.28,7865.09,WellsFargo1,41,5
12,7865.09,84.62,51.12,33.5,7831.59,WellsFargo1,41,5
13,7831.59,84.62,50.91,33.71,7797.88,WellsFargo1,41,5
14,7797.88,84.62,50.69,33.93,7763.95,WellsFargo1,41,5
15,7763.95,84.62,50.47,34.15,7729.8,WellsFargo1,41,5
16,7729.8,84.62,50.24,34.38,7695.42,WellsFargo1,41,5
17,7695.42,84.62,50.02,34.6,7660.82,WellsFargo1,41,5
18,7660.82,84.62,49.8,34.82,7626.0,WellsFargo1,41,5
19,7626.0,84.62,49.57,35.05,7590.95,WellsFargo1,41,5
20,7590.95,84.62,49.34,35.28,7555.67,WellsFargo1,41,5
21,7555.67,84.62,49.11,35.51,7520.16,WellsFargo1,41,5
22,7520.16,84.62,48.88,35.74,7484.42,WellsFargo1,41,5
23,7484.42,84.62,48.65,35.97,7448.45,WellsFargo1,41,5
24,7448.45,84.62,48.41,36.21,7412.24,WellsFargo1,41,5
25,7412.24,84.62,48.18,36.44,7375.8,WellsFargo1,41,5
26,7375.8,84.62,47.94,36.68,7339.12,WellsFargo1,41,5
27,7339.12,84.62,47.7,36.92,7302.2,WellsFargo1,41,5
28,7302.2,84.62,47.46,37.16,7265.04,WellsFargo1,41,5
29,7265.04,84.62,47.22,37.4,7227.64,WellsFargo1,41,5
30,7227.64,84.62,46.98,37.64,7190.0,WellsFargo1,41,5
31,7190.0,84.62,46.73,37.89,7152.11,WellsFargo1,41,5
32,7152.11,84.62,46.49,38.13,7113.98,WellsFargo1,41,5
33,7113.98,84.62,46.24,38.38,7075.6,WellsFargo1,41,5
34,7075.6,84.62,45.99,38.63,7036.97,WellsFargo1,41,5
35,7036.97,84.62,45.74,38.88,6998.09,WellsFargo1,41,5
36,6998.09,84.62,45.49,39.13,6958.96,WellsFargo1,41,5
37,6958.96,84.62,45.23,39.39,6919.57,WellsFargo1,41,5
38,6919.57,84.62,44.98,39.64,6879.93,WellsFargo1,41,5
39,6879.93,84.62,44.72,39.9,6840.03,WellsFargo1,41,5
40,6840.03,84.62,44.46,40.16,6799.87,WellsFargo1,41,5
41,6799.87,84.62,44.2,40.42,6759.45,WellsFargo1,41,5
42,6759.45,84.62,43.94,40.68,6718.77,WellsFargo1,41,5
43,6718.77,84.62,43.67,40.95,6677.82,WellsFargo1,41,5
44,6677.82,84.62,43.41,41.21,6636.61,WellsFargo1,41,5
45,6636.61,84.62,43.14,41.48,6595.13,WellsFargo1,41,5
46,6595.13,84.62,42.87,41.75,6553.38,WellsFargo1,41,5
47,6553.38,84.62,42.6,42.02,6511.36,WellsFargo1,41,5
48,6511.36,84.62,42.32,42.3,6469.06,WellsFargo1,41,5
49,6469.06,84.62,42.05,42.57,6426.49,WellsFargo1,41,5
50,6426.49,84.62,41.77,42.85,6383.64,WellsFargo1,41,5
51,6383.64,84.62,41.49,43.13,6340.51,WellsFargo1,41,5
52,6340.51,84.62,41.21,43.41,6297.1,WellsFargo1,41,5
53,6297.1,84.62,40.93,43.69,6253.41,WellsFargo1,41,5
54,6253.41,84.62,40.65,43.97,6209.44,WellsFargo1,41,5
55,6209.44,84.62,40.36,44.26,6165.18,WellsFargo1,41,5
56,6165.18,84.62,40.07,44.55,6120.63,WellsFargo1,41,5
57,6120.63,84.62,39.78,44.84,6075.79,WellsFargo1,41,5
58,6075.79,84.62,39.49,45.13,6030.66,WellsFargo1,41,5
59,6030.66,84.62,39.2,45.42,5985.24,WellsFargo1,41,5
60,5985.24,84.62,38.9,45.72,5939.52,WellsFargo1,41,5
61,5939.52,84.62,38.61,46.01,5893.51,WellsFargo1,41,5
62,5893.51,84.62,38.31,46.31,5847.2,WellsFargo1,41,5
63,5847.2,84.62,38.01,46.61,5800.59,WellsFargo1,41,5
64,5800.59,84.62,37.7,46.92,5753.67,WellsFargo1,41,5
65,5753.67,154.13,37.4,116.73,5636.94,WellsFargo1,41,5
66,5636.94,3010.1,36.64,2973.46,2663.48,WellsFargo1,41,5
67,2663.48,3010.1,17.31,2992.79,-329.31,WellsFargo1,41,5
0,5000.0,1333.0,36.0,1297.0,3703.0,Car,42,1
1,3703.0,1333.0,26.66,1306.34,2396.66,Car,42,1
2,2396.66,1333.0,17.26,1315.74,1080.92,Car,42,1
3,1080.92,1333.0,7.78,1325.22,-244.3,Car,42,1
0,20000.0,191.04,108.0,83.04,19916.96,WellsFargo2,42,2
1,19916.96,191.04,107.55,83.49,19833.47,WellsFargo2,42,2
2,19833.47,191.04,107.1,83.94,19749.53,WellsFargo2,42,2
3,19749.53,435.34,106.65,328.69,19420.84,WellsFargo2,42,2
4,19420.84,1524.04,104.87,1419.17,18001.67,WellsFargo2,42,2
5,18001.67,1524.04,97.21,1426.83,16574.84,WellsFargo2,42,2
6,16574.84,1524.04,89.5,1434.54,15140.3,WellsFargo2,42,2
7,15140.3,1524.04,81.76,1442.28,13698.02,WellsFargo2,42,2
8,13698.02,1524.04,73.97,1450.07,12247.95,WellsFargo2,42,2
9,12247.95,1524.04,66.14,1457.9,10790.05,WellsFargo2,42,2
10,10790.05,1524.04,58.27,1465.77,9324.28,WellsFargo2,42,2
11,9324.28,1524.04,50.35,1473.69,7850.59,WellsFargo2,42,2
12,7850.59,1524.04,42.39,1481.65,6368.94,WellsFargo2,42,2
13,6368.94,1524.04,34.39,1489.65,4879.29,WellsFargo2,42,2
14,4879.29,1524.04,26.35,1497.69,3381.6,WellsFargo2,42,2
15,3381.6,1524.04,18.26,1505.78,1875.82,WellsFargo2,42,2
16,1875.82,1524.04,10.13,1513.91,361.91,WellsFargo2,42,2
17,361.91,1524.04,1.95,1522.09,-1160.18,WellsFargo2,42,2
0,180000.0,1331.44,594.0,737.44,179262.56,mortgage,42,3
1,179262.56,1331.44,591.57,739.87,178522.69,mortgage,42,3
2,178522.69,1331.44,589.12,742.32,177780.37,mortgage,42,3
3,177780.37,1331.44,586.68,744.76,177035.61,mortgage,42,3
4,177035.61,1331.44,584.22,747.22,176288.39,mortgage,42,3
5,176288.39,1331.44,581.75,749.69,175538.7,mortgage,42,3
6,175538.7,1331.44,579.28,752.16,174786.54,mortgage,42,3
7,174786.54,1331.44,576.8,754.64,174031.9,mortgage,42,3
8,174031.9,1331.44,574.31,757.13,173274.77,mortgage,42,3
9,173274.77,1331.44,571.81,759.63,172515.14,mortgage,42,3
10,172515.14,1331.44,569.3,762.14,171753.0,mortgage,42,3
11,171753.0,1331.44,566.78,764.66,170988.34,mortgage,42,3
12,170988.34,1331.44,564.26,767.18,170221.16,mortgage,42,3
13,170221.16,1331.44,561.73,769.71,169451.45,mortgage,42,3
14,169451.45,1331.44,559.19,772.25,168679.2,mortgage,42,3
15,168679.2,1331.44,556.64,774.8,167904.4,mortgage,42,3
16,167904.4,1331.44,554.08,777.36,167127.04,mortgage,42,3
17,167127.04,2491.62,551.52,1940.1,165186.94,mortgage,42,3
18,165186.94,2855.48,545.12,2310.36,162876.58,mortgage,42,3
19,162876.58,2855.48,537.49,2317.99,160558.59,mortgage,42,3
20,160558.59,2855.48,529.84,2325.64,158232.95,mortgage,42,3
21,158232.95,2855.48,522.17,2333.31,155899.64,mortgage,42,3
22,155899.64,2855.48,514.47,2341.01,153558.63,mortgage,42,3
23,153558.63,2855.48,506.74,2348.74,151209.89,mortgage,42,3
24,151209.89,2855.48,498.99,2356.49,148853.4,mortgage,42,3
25,148853.4,2855.48,491.22,2364.26,146489.14,mortgage,42,3
26,146489.14,2855.48,483.41,2372.07,144117.07,mortgage,42,3
27,144117.07,2855.48,475.59,2379.89,141737.18,mortgage,42,3
28,141737.18,2855.48,467.73,2387.75,139349.43,mortgage,42,3
29,139349.43,2855.48,459.85,2395.63,136953.8,mortgage,42,3
30,136953.8,2855.48,451.95,2403.53,134550.27,mortgage,42,3
31,134550.27,2855.48,444.02,2411.46,132138.81,mortgage,42,3
32,132138.81,2855.48,436.06,2419.42,129719.39,mortgage,42,3
33,129719.39,2855.48,428.07,2427.41,127291.98,mortgage,42,3
34,127291.98,2855.48,420.06,2435.42,124856.56,mortgage,42,3
35,124856.56,2855.48,412.03,2443.45,122413.11,mortgage,42,3
36,122413.11,2855.48,403.96,2451.52,119961.59,mortgage,42,3
37,119961.59,2855.48,395.87,2459.61,117501.98,mortgage,42,3
38,117501.98,2855.48,387.76,2467.72,115034.26,mortgage,42,3
39,115034.26,2855.48,379.61,2475.87,112558.39,mortgage,42,3
40,112558.39,2855.48,371.44,2484.04,110074.35,mortgage,42,3
41,110074.35,2855.48,363.25,2492.23,107582.12,mortgage,42,3
42,107582.12,2855.48,355.02,2500.46,105081.66,mortgage,42,3
43,105081.66,2855.48,346.77,2508.71,102572.95,mortgage,42,3
44,102572.95,2855.48,338.49,2516.99,100055.96,mortgage,42,3
45,100055.96,2855.48,330.18,2525.3,97530.66,mortgage,42,3
46,97530.66,2855.48,321.85,2533.63,94997.03,mortgage,42,3
47,94997.03,2855.48,313.49,2541.99,92455.04,mortgage,42,3
48,92455.04,2855.48,305.1,2550.38,89904.66,mortgage,42,3
49,89904.66,2855.48,296.69,2558.79,87345.87,mortgage,42,3
50,87345.87,2855.48,288.24,2567.24,84778.63,mortgage,42,3
51,84778.63,2855.48,279.77,2575.71,82202.92,mortgage,42,3
52,82202.92,2855.48,271.27,2584.21,79618.71,mortgage,42,3
53,79618.71,2855.48,262.74,2592.74,77025.97,mortgage,42,3
54,77025.97,2855.48,254.19,2601.29,74424.68,mortgage,42,3
55,74424.68,2855.48,245.6,2609.88,71814.8,mortgage,42,3
56,71814.8,2855.48,236.99,2618.49,69196.31,mortgage,42,3
57,69196.31,2855.48,228.35,2627.13,66569.18,mortgage,42,3
58,66569.18,2855.48,219.68,2635.8,63933.38,mortgage,42,3
59,63933.38,2855.48,210.98,2644.5,61288.88,mortgage,42,3
60,61288.88,2855.48,202.25,2653.23,58635.65,mortgage,42,3
61,58635.65,2855.48,193.5,2661.98,55973.67,mortgage,42,3
62,55973.67,2855.48,184.71,2670.77,53302.9,mortgage,42,3
63,53302.9,2855.48,175.9,2679.58,50623.32,mortgage,42,3
64,50623.32,2855.48,167.06,2688.42,47934.9,mortgage,42,3
65,47934.9,2855.48,158.19,2697.29,45237.61,mortgage,42,3
66,45237.61,2855.48,149.28,2706.2,42531.41,mortgage,42,3
67,42531.41,2855.48,140.35,2715.13,39816.28,mortgage,42,3
68,39816.28,2855.48,131.39,2724.09,37092.19,mortgage,42,3
69,37092.19,2855.48,122.4,2733.08,34359.11,mortgage,42,3
70,34359.11,2855.48,113.39,2742.09,31617.02,mortgage,42,3
71,31617.02,2855.48,104.34,2751.14,28865.88,mortgage,42,3
72,28865.88,2855.48,95.26,2760.22,26105.66,mortgage,42,3
73,26105.66,2855.48,86.15,2769.33,23336.33,mortgage,42,3
74,23336.33,2855.48,77.01,2778.47,20557.86,mortgage,42,3
75,20557.86,2855.48,67.84,2787.64,17770.22,mortgage,42,3
76,17770.22,2855.48,58.64,2796.84,14973.38,mortgage,42,3
77,14973.38,2855.48,49.41,2806.07,12167.31,mortgage,42,3
78,12167.31,2855.48,40.15,2815.33,9351.98,mortgage,42,3
79,9351.98,2855.48,30.86,2824.62,6527.36,mortgage,42,3
80,6527.36,2855.48,21.54,2833.94,3693.42,mortgage,42,3
81,3693.42,2855.48,12.19,2843.29,850.13,mortgage,42,3
82,850.13,2855.48,2.81,2852.67,-2002.54,mortgage,42,3
0,8250.57,84.62,53.63,30.99,8219.58,WellsFargo1,42,4
1,8219.58,84.62,53.43,31.19,8188.39,WellsFargo1,42,4
2,8188.39,84.62,53.22,31.4,8156.99,WellsFargo1,42,4
3,8156.99,84.62,53.02,31.6,8125.39,WellsFargo1,42,4
4,8125.39,84.62,52.82,31.8,8093.59,WellsFargo1,42,4
5,8093.59,84.62,52.61,32.01,8061.58,WellsFargo1,42,4
6,8061.58,84.62,52.4,32.22,8029.36,WellsFargo1,42,4
7,8029.36,84.62,52.19,32.43,7996.93,WellsFargo1,42,4
8,7996.93,84.62,51.98,32.64,7964.29,WellsFargo1,42,4
9,7964.29,84.62,51.77,32.85,7931.44,WellsFargo1,42,4
10,7931.44,84.62,51.55,33.07,7898.37,WellsFargo1,42,4
11,7898.37,84.62,51.34,33.28,7865.09,WellsFargo1,42,4
12,7865.09,84.62,51.12,33.5,7831.59,WellsFargo1,42,4
13,7831.59,84.62,50.91,33.71,7797.88,WellsFargo1,42,4
14,7797.88,84.62,50.69,33.93,7763.95,WellsFargo1,42,4
15,7763.95,84.62,50.47,34.15,7729.8,WellsFargo1,42,4
16,7729.8,84.62,50.24,34.38,7695.42,WellsFargo1,42,4
17,7695.42,84.62,50.02,34.6,7660.82,WellsFargo1,42,4
18,7660.82,84.62,49.8,34.82,7626.0,WellsFargo1,42,4
19,7626.0,84.62,49.57,35.05,7590.95,WellsFargo1,42,4
20,7590.95,84.62,49.34,35.28,7555.67,WellsFargo1,42,4
21,7555.67,84.62,49.11,35.51,7520.16,WellsFargo1,42,4
22,7520.16,84.62,48.88,35.74,7484.42,WellsFargo1,42,4
23,7484.42,84.62,48.65,35.97,7448.45,WellsFargo1,42,4
24,7448.45,84.62,48.41,36.21,7412.24,WellsFargo1,42,4
25,7412.24,84.62,48.18,36.44,7375.8,WellsFargo1,42,4
26,7375.8,84.62,47.94,36.68,7339.12,WellsFargo1,42,4
27,7339.12,84.62,47.7,36.92,7302.2,WellsFargo1,42,4
28,7302.2,84.62,47.46,37.16,7265.04,WellsFargo1,42,4
29,7265.04,84.62,47.22,37.4,7227.64,WellsFargo1,42,4
30,7227.64,84.62,46.98,37.64,7190.0,WellsFargo1,42,4
31,7190.0,84.62,46.73,37.89,7152.11,WellsFargo1,42,4
32,7152.11,84.62,46.49,38.13,7113.98,WellsFargo1,42,4
33,7113.98,84.62,46.24,38.38,7075.6,WellsFargo1,42,4
34,7075.6,84.62,45.99,38.63,7036.97,WellsFargo1,42,4
35,7036.97,84.62,45.74,38.88,6998.09,WellsFargo1,42,4
36,6998.09,84.62,45.49,39.13,6958.96,WellsFargo1,42,4
37,6958.96,84.62,45.23,39.39,6919.57,WellsFargo1,42,4
38,6919.57,84.62,44.98,39.64,6879.93,WellsFargo1,42,4
39,6879.93,84.62,44.72,39.9,6840.03,WellsFargo1,42,4
40,6840.03,84.62,44.46,40.16,6799.87,WellsFargo1,42,4
41,6799.87,84.62,44.2,40.42,6759.45,WellsFargo1,42,4
42,6759.45,84.62,43.94,40.68,6718.77,WellsFargo1,42,4
43,6718.77,84.62,43.67,40.95,6677.82,WellsFargo1,42,4
44,6677.82,84.62,43.41,41.21,6636.61,WellsFargo1,42,4
45,6636.61,84.62,43.14,41.48,6595.13,WellsFargo1,42,4
46,6595.13,84.62,42.87,41.75,6553.38,WellsFargo1,42,4
47,6553.38,84.62,42.6,42.02,6511.36,WellsFargo1,42,4
48,6511.36,84.62,42.32,42.3,6469.06,WellsFargo1,42,4
49,6469.06,84.62,42.05,42.57,6426.49,WellsFargo1,42,4
50,6426.49,84.62,41.77,42.85,6383.64,WellsFargo1,42,4
51,6383.64,84.62,41.49,43.13,6340.51,WellsFargo1,42,4
52,6340.51,84.62,41.21,43.41,6297.1,WellsFargo1,42,4
53,6297.1,84.62,40.93,43.69,6253.41,WellsFargo1,42,4
54,6253.41,84.62,40.65,43.97,6209.44,WellsFargo1,42,4
55,6209.44,84.62,40.36,44.26,6165.18,WellsFargo1,42,4
56,6165.18,84.62,40.07,44.55,6120.63,WellsFargo1,42,4
57,6120.63,84.62,39.78,44.84,6075.79,WellsFargo1,42,4
58,6075.79,84.62,39.49,45.13,6030.66,WellsFargo1,42,4
59,6030.66,84.62,39.2,45.42,5985.24,WellsFargo1,42,4
60,5985.24,84.62,38.9,45.72,5939.52,WellsFargo1,42,4
61,5939.52,84.62,38.61,46.01,5893.51,WellsFargo1,42,4
62,5893.51,84.62,38.31,46.31,5847.2,WellsFargo1,42,4
63,5847.2,84.62,38.01,46.61,5800.59,WellsFargo1,42,4
64,5800.59,84.62,37.7,46.92,5753.67,WellsFargo1,42,4
65,5753.67,84.62,37.4,47.22,5706.45,WellsFargo1,42,4
66,5706.45,84.62,37.09,47.53,5658.92,WellsFargo1,42,4
67,5658.92,84.62,36.78,47.84,5611.08,WellsFargo1,42,4
68,5611.08,84.62,36.47,48.15,5562.93,WellsFargo1,42,4
69,5562.93,84.62,36.16,48.46,5514.47,WellsFargo1,42,4
70,5514.47,84.62,35.84,48.78,5465.69,WellsFargo1,42,4
71,5465.69,84.62,35.53,49.09,5416.6,WellsFargo1,42,4
72,5416.6,84.62,35.21,49.41,5367.19,WellsFargo1,42,4
73,5367.19,84.62,34.89,49.73,5317.46,WellsFargo1,42,4
74,5317.46,84.62,34.56,50.06,5267.4,WellsFargo1,42,4
75,5267.4,84.62,34.24,50.38,5217.02,WellsFargo1,42,4
76,5217.02,84.62,33.91,50.71,5166.31,WellsFargo1,42,4
77,5166.31,84.62,33.58,51.04,5115.27,WellsFargo1,42,4
78,5115.27,84.62,33.25,51.37,5063.9,WellsFargo1,42,4
79,5063.9,84.62,32.92,51.7,5012.2,WellsFargo1,42,4
80,5012.2,84.62,32.58,52.04,4960.16,WellsFargo1,42,4
81,4960.16,84.62,32.24,52.38,4907.78,WellsFargo1,42,4
82,4907.78,2087.16,31.9,2055.26,2852.52,WellsFargo1,42,4
83,2852.52,2940.1,18.54,2921.56,-69.04,WellsFargo1,42,4
0,4000.0,70.0,16.0,54.0,3946.0,testing,42,5
1,3946.0,70.0,15.78,54.22,3891.78,testing,42,5
2,3891.78,70.0,15.57,54.43,3837.35,testing,42,5
3,3837.35,70.0,15.35,54.65,3782.7,testing,42,5
4,3782.7,70.0,15.13,54.87,3727.83,testing,42,5
5,3727.83,70.0,14.91,55.09,3672.74,testing,42,5
6,3672.74,70.0,14.69,55.31,3617.43,testing,42,5
7,3617.43,70.0,14.47,55.53,3561.9,testing,42,5
8,3561.9,70.0,14.25,55.75,3506.15,testing,42,5
9,3506.15,70.0,14.02,55.98,3450.17,testing,42,5
10,3450.17,70.0,13.8,56.2,3393.97,testing,42,5
11,3393.97,70.0,13.58,56.42,3337.55,testing,42,5
12,3337.55,70.0,13.35,56.65,3280.9,testing,42,5
13,3280.9,70.0,13.12,56.88,3224.02,testing,42,5
14,3224.02,70.0,12.9,57.1,3166.92,testing,42,5
15,3166.92,70.0,12.67,57.33,3109.59,testing,42,5
16,3109.59,70.0,12.44,57.56,3052.03,testing,42,5
17,3052.03,70.0,12.21,57.79,2994.24,testing,42,5
18,2994.24,70.0,11.98,58.02,2936.22,testing,42,5
19,2936.22,70.0,11.74,58.26,2877.96,testing,42,5
20,2877.96,70.0,11.51,58.49,2819.47,testing,42,5
21,2819.47,70.0,11.28,58.72,2760.75,testing,42,5
22,2760.75,70.0,11.04,58.96,2701.79,testing,42,5
23,2701.79,70.0,10.81,59.19,2642.6,testing,42,5
24,2642.6,70.0,10.57,59.43,2583.17,testing,42,5
25,2583.17,70.0,10.33,59.67,2523.5,testing,42,5
26,2523.5,70.0,10.09,59.91,2463.59,testing,42,5
27,2463.59,70.0,9.85,60.15,2403.44,testing,42,5
28,2403.44,70.0,9.61,60.39,2343.05,testing,42,5
29,2343.05,70.0,9.37,60.63,2282.42,testing,42,5
30,2282.42,70.0,9.13,60.87,2221.55,testing,42,5
31,2221.55,70.0,8.89,61.11,2160.44,testing,42,5
32,2160.44,70.0,8.64,61.36,2099.08,testing,42,5
33,2099.08,70.0,8.4,61.6,2037.48,testing,42,5
34,2037.48,70.0,8.15,61.85,1975.63,testing,42,5
35,1975.63,70.0,7.9,62.1,1913.53,testing,42,5
36,1913.53,70.0,7.65,62.35,1851.18,testing,42,5
37,1851.18,70.0,7.4,62.6,1788.58,testing,42,5
38,1788.58,70.0,7.15,62.85,1725.73,testing,42,5
39,1725.73,70.0,6.9,63.1,1662.63,testing,42,5
40,1662.63,70.0,6.65,63.35,1599.28,testing,42,5
41,1599.28,70.0,6.4,63.6,1535.68,testing,42,5
42,1535.68,70.0,6.14,63.86,1471.82,testing,42,5
43,1471.82,70.0,5.89,64.11,1407.71,testing,42,5
44,1407.71,70.0,5.63,64.37,1343.34,testing,42,5
45,1343.34,70.0,5.37,64.63,1278.71,testing,42,5
46,1278.71,70.0,5.11,64.89,1213.82,testing,42,5
47,1213.82,70.0,4.86,65.14,1148.68,testing,42,5
48,1148.68,70.0,4.59,65.41,1083.27,testing,42,5
49,1083.27,70.0,4.33,65.67,1017.6,testing,42,5
50,1017.6,70.0,4.07,65.93,951.67,testing,42,5
51,951.67,70.0,3.81,66.19,885.48,testing,42,5
52,885.48,70.0,3.54,66.46,819.02,testing,42,5
53,819.02,70.0,3.28,66.72,752.3,testing,42,5
54,752.3,70.0,3.01,66.99,685.31,testing,42,5
55,685.31,70.0,2.74,67.26,618.05,testing,42,5
56,618.05,70.0,2.47,67.53,550.52,testing,42,5
57,550.52,70.0,2.2,67.8,482.72,testing,42,5
58,482.72,70.0,1.93,68.07,414.65,testing,42,5
59,414.65,70.0,1.66,68.34,346.31,testing,42,5
60,346.31,70.0,1.39,68.61,277.7,testing,42,5
61,277.7,70.0,1.11,68.89,208.81,testing,42,5
62,208.81,70.0,0.84,69.16,139.65,testing,42,5
63,139.65,70.0,0.56,69.44,70.21,testing,42,5
64,70.21,70.0,0.28,69.72,0.49,testing,42,5
65,0.49,70.0,0.0,70.0,-69.51,testing,42,5
0,5000.0,1333.0,36.0,1297.0,3703.0,Car,43,1
1,3703.0,1333.0,26.66,1306.34,2396.66,Car,43,1
2,2396.66,1333.0,17.26,1315.74,1080.92,Car,43,1
3,1080.92,1333.0,7.78,1325.22,-244.3,Car,43,1
0,180000.0,1331.44,594.0,737.44,179262.56,mortgage,43,2
1,179262.56,1331.44,591.57,739.87,178522.69,mortgage,43,2
2,178522.69,1331.44,589.12,742.32,177780.37,mortgage,43,2
3,177780.37,1575.74,586.68,989.06,176791.31,mortgage,43,2
4,176791.31,2664.44,583.41,2081.03,174710.28,mortgage,43,2
5,174710.28,2664.44,576.54,2087.9,172622.38,mortgage,43,2
6,172622.38,2664.44,569.65,2094.79,170527.59,mortgage,43,2
7,170527.59,2664.44,562.74,2101.7,168425.89,mortgage,43,2
8,168425.89,2664.44,555.81,2108.63,166317.26,mortgage,43,2
9,166317.26,2664.44,548.85,2115.59,164201.67,mortgage,43,2
10,164201.67,2664.44,541.87,2122.57,162079.1,mortgage,43,2
11,162079.1,2664.44,534.86,2129.58,159949.52,mortgage,43,2
12,159949.52,2664.44,527.83,2136.61,157812.91,mortgage,43,2
13,157812.91,2664.44,520.78,2143.66,155669.25,mortgage,43,2
14,155669.25,2664.44,513.71,2150.73,153518.52,mortgage,43,2
15,153518.52,2664.44,506.61,2157.83,151360.69,mortgage,43,2
16,151360.69,2664.44,499.49,2164.95,149195.74,mortgage,43,2
17,149195.74,2664.44,492.35,2172.09,147023.65,mortgage,43,2
18,147023.65,2664.44,485.18,2179.26,144844.39,mortgage,43,2
19,144844.39,2664.44,477.99,2186.45,142657.94,mortgage,43,2
20,142657.94,2664.44,470.77,2193.67,140464.27,mortgage,43,2
21,140464.27,2664.44,463.53,2200.91,138263.36,mortgage,43,2
22,138263.36,2664.44,456.27,2208.17,136055.19,mortgage,43,2
23,136055.19,2664.44,448.98,2215.46,133839.73,mortgage,43,2
24,133839.73,2664.44,441.67,2222.77,131616.96,mortgage,43,2
25,131616.96,2664.44,434.34,2230.1,129386.86,mortgage,43,2
26,129386.86,2664.44,426.98,2237.46,127149.4,mortgage,43,2
27,127149.4,2664.44,419.59,2244.85,124904.55,mortgage,43,2
28,124904.55,2664.44,412.19,2252.25,122652.3,mortgage,43,2
29,122652.3,2664.44,404.75,2259.69,120392.61,mortgage,43,2
30,120392.61,2664.44,397.3,2267.14,118125.47,mortgage,43,2
31,118125.47,2664.44,389.81,2274.63,115850.84,mortgage,43,2
32,115850.84,2664.44,382.31,2282.13,113568.71,mortgage,43,2
33,113568.71,2664.44,374.78,2289.66,111279.05,mortgage,43,2
34,111279.05,2664.44,367.22,2297.22,108981.83,mortgage,43,2
35,108981.83,2664.44,359.64,2304.8,106677.03,mortgage,43,2
36,106677.03,2664.44,352.03,2312.41,104364.62,mortgage,43,2
37,104364.62,2664.44,344.4,2320.04,102044.58,mortgage,43,2
38,102044.58,2664.44,336.75,2327.69,99716.89,mortgage,43,2
39,99716.89,2664.44,329.07,2335.37,97381.52,mortgage,43,2
40,97381.52,2664.44,321.36,2343.08,95038.44,mortgage,43,2
41,95038.44,2664.44,313.63,2350.81,92687.63,mortgage,43,2
42,92687.63,2664.44,305.87,2358.57,90329.06,mortgage,43,2
43,90329.06,2664.44,298.09,2366.35,87962.71,mortgage,43,2
44,87962.71,2664.44,290.28,2374.16,85588.55,mortgage,43,2
45,85588.55,2664.44,282.44,2382.0,83206.55,mortgage,43,2
46,83206.55,2664.44,274.58,2389.86,80816.69,mortgage,43,2
47,80816.69,2664.44,266.7,2397.74,78418.95,mortgage,43,2
48,78418.95,2664.44,258.78,2405.66,76013.29,mortgage,43,2
49,76013.29,2664.44,250.84,2413.6,73599.69,mortgage,43,2
50,73599.69,2664.44,242.88,2421.56,71178.13,mortgage,43,2
51,71178.13,2664.44,234.89,2429.55,68748.58,mortgage,43,2
52,68748.58,2664.44,226.87,2437.57,66311.01,mortgage,43,2
53,66311.01,2664.44,218.83,2445.61,63865.4,mortgage,43,2
54,63865.4,2664.44,210.76,2453.68,61411.72,mortgage,43,2
55,61411.72,2664.44,202.66,2461.78,58949.94,mortgage,43,2
56,58949.94,2664.44,194.53,2469.91,56480.03,mortgage,43,2
57,56480.03,2664.44,186.38,2478.06,54001.97,mortgage,43,2
58,54001.97,2664.44,178.21,2486.23,51515.74,mortgage,43,2
59,51515.74,2664.44,170.0,2494.44,49021.3,mortgage,43,2
60,49021.3,2664.44,161.77,2502.67,46518.63,mortgage,43,2
61,46518.63,2664.44,153.51,2510.93,44007.7,mortgage,43,2
62,44007.7,2664.44,145.23,2519.21,41488.49,mortgage,43,2
63,41488.49,2664.44,136.91,2527.53,38960.96,mortgage,43,2
64,38960.96,2664.44,128.57,2535.87,36425.09,mortgage,43,2
65,36425.09,2664.44,120.2,2544.24,33880.85,mortgage,43,2
66,33880.85,2664.44,111.81,2552.63,31328.22,mortgage,43,2
67,31328.22,2664.44,103.38,2561.06,28767.16,mortgage,43,2
68,28767.16,2664.44,94.93,2569.51,26197.65,mortgage,43,2
69,26197.65,2664.44,86.45,2577.99,23619.66,mortgage,43,2
70,23619.66,2664.44,77.94,2586.5,21033.16,mortgage,43,2
71,21033.16,2664.44,69.41,2595.03,18438.13,mortgage,43,2
72,18438.13,2664.44,60.85,2603.59,15834.54,mortgage,43,2
73,15834.54,2664.44,52.25,2612.19,13222.35,mortgage,43,2
74,13222.35,2664.44,43.63,2620.81,10601.54,mortgage,43,2
75,10601.54,2664.44,34.99,2629.45,7972.09,mortgage,43,2
76,7972.09,2664.44,26.31,2638.13,5333.96,mortgage,43,2
77,5333.96,2664.44,17.6,2646.84,2687.12,mortgage,43,2
78,2687.12,2664.44,8.87,2655.57,31.55,mortgage,43,2
79,31.55,2664.44,0.1,2664.34,-2632.79,mortgage,43,2
0,4000.0,70.0,16.0,54.0,3946.0,testing,43,3
1,3946.0,70.0,15.78,54.22,3891.78,testing,43,3
2,3891.78,70.0,15.57,54.43,3837.35,testing,43,3
3,3837.35,70.0,15.35,54.65,3782.7,testing,43,3
4,3782.7,70.0,15.13,54.87,3727.83,testing,43,3
5,3727.83,70.0,14.91,55.09,3672.74,testing,43,3
6,3672.74,70.0,14.69,55.31,3617.43,testing,43,3
7,3617.43,70.0,14.47,55.53,3561.9,testing,43,3
8,3561.9,70.0,14.25,55.75,3506.15,testing,43,3
9,3506.15,70.0,14.02,55.98,3450.17,testing,43,3
10,3450.17,70.0,13.8,56.2,3393.97,testing,43,3
11,3393.97,70.0,13.58,56.42,3337.55,testing,43,3
12,3337.55,70.0,13.35,56.65,3280.9,testing,43,3
13,3280.9,70.0,13.12,56.88,3224.02,testing,43,3
14,3224.02,70.0,12.9,57.1,3166.92,testing,43,3
15,3166.92,70.0,12.67,57.33,3109.59,testing,43,3
16,3109.59,70.0,12.44,57.56,3052.03,testing,43,3
17,3052.03,70.0,12.21,57.79,2994.24,testing,43,3
18,2994.24,70.0,11.98,58.02,2936.22,testing,43,3
19,2936.22,70.0,11.74,58.26,2877.96,testing,43,3
20,2877.96,70.0,11.51,58.49,2819.47,testing,43,3
21,2819.47,70.0,11.28,58.72,2760.75,testing,43,3
22,2760.75,70.0,11.04,58.96,2701.79,testing,43,3
23,2701.79,70.0,10.81,59.19,2642.6,testing,43,3
24,2642.6,70.0,10.57,59.43,2583.17,testing,43,3
25,2583.17,70.0,10.33,59.67,2523.5,testing,43,3
26,2523.5,70.0,10.09,59.91,2463.59,testing,43,3
27,2463.59,70.0,9.85,60.15,2403.44,testing,43,3
28,2403.44,70.0,9.61,60.39,2343.05,testing,43,3
29,2343.05,70.0,9.37,60.63,2282.42,testing,43,3
30,2282.42,70.0,9.13,60.87,2221.55,testing,43,3
31,2221.55,70.0,8.89,61.11,2160.44,testing,43,3
32,2160.44,70.0,8.64,61.36,2099.08,testing,43,3
33,2099.08,70.0,8.4,61.6,2037.48,testing,43,3
34,2037.48,70.0,8.15,61.85,1975.63,testing,43,3
35,1975.63,70.0,7.9,62.1,1913.53,testing,43,3
36,1913.53,70.0,7.65,62.35,1851.18,testing,43,3
37,1851.18,70.0,7.4,62.6,1788.58,testing,43,3
38,1788.58,70.0,7.15,62.85,1725.73,testing,43,3
39,1725.73,70.0,6.9,63.1,1662.63,testing,43,3
40,1662.63,70.0,6.65,63.35,1599.28,testing,43,3
41,1599.28,70.0,6.4,63.6,1535.68,testing,43,3
42,1535.68,70.0,6.14,63.86,1471.82,testing,43,3
43,1471.82,70.0,5.89,64.11,1407.71,testing,43,3
44,1407.71,70.0,5.63,64.37,1343.34,testing,43,3
45,1343.34,70.0,5.37,64.63,1278.71,testing,43,3
46,1278.71,70.0,5.11,64.89,1213.82,testing,43,3
47,1213.82,70.0,4.86,65.14,1148.68,testing,43,3
48,1148.68,70.0,4.59,65.41,1083.27,testing,43,3
49,1083.27,70.0,4.33,65.67,1017.6,testing,43,3
50,1017.6,70.0,4.07,65.93,951.67,testing,43,3
51,951.67,70.0,3.81,66.19,885.48,testing,43,3
52,885.48,70.0,3.54,66.46,819.02,testing,43,3
53,819.02,70.0,3.28,66.72,752.3,testing,43,3
54,752.3,70.0,3.01,66.99,685.31,testing,43,3
55,685.31,70.0,2.74,67.26,618.05,testing,43,3
56,618.05,70.0,2.47,67.53,550.52,testing,43,3
57,550.52,70.0,2.2,67.8,482.72,testing,43,3
58,482.72,70.0,1.93,68.07,414.65,testing,43,3
59,414.65,70.0,1.66,68.34,346.31,testing,43,3
60,346.31,70.0,1.39,68.61,277.7,testing,43,3
61,277.7,70.0,1.11,68.89,208.81,testing,43,3
62,208.81,70.0,0.84,69.16,139.65,testing,43,3
63,139.65,70.0,0.56,69.44,70.21,testing,43,3
64,70.21,70.0,0.28,69.72,0.49,testing,43,3
65,0.49,70.0,0.0,70.0,-69.51,testing,43,3
0,8250.57,84.62,53.63,30.99,8219.58,WellsFargo1,43,4
1,8219.58,84.62,53.43,31.19,8188.39,WellsFargo1,43,4
2,8188.39,84.62,53.22,31.4,8156.99,WellsFargo1,43,4
3,8156.99,84.62,53.02,31.6,8125.39,WellsFargo1,43,4
4,8125.39,84.62,52.82,31.8,8093.59,WellsFargo1,43,4
5,8093.59,84.62,52.61,32.01,8061.58,WellsFargo1,43,4
6,8061.58,84.62,52.4,32.22,8029.36,WellsFargo1,43,4
7,8029.36,84.62,52.19,32.43,7996.93,WellsFargo1,43,4
8,7996.93,84.62,51.98,32.64,7964.29,WellsFargo1,43,4
9,7964.29,84.62,51.77,32.85,7931.44,WellsFargo1,43,4
10,7931.44,84.62,51.55,33.07,7898.37,WellsFargo1,43,4
11,7898.37,84.62,51.34,33.28,7865.09,WellsFargo1,43,4
12,7865.09,84.62,51.12,33.5,7831.59,WellsFargo1,43,4
13,7831.59,84.62,50.91,33.71,7797.88,WellsFargo1,43,4
14,7797.88,84.62,50.69,33.93,7763.95,WellsFargo1,43,4
15,7763.95,84.62,50.47,34.15,7729.8,WellsFargo1,43,4
16,7729.8,84.62,50.24,34.38,7695.42,WellsFargo1,43,4
17,7695.42,84.62,50.02,34.6,7660.82,WellsFargo1,43,4
18,7660.82,84.62,49.8,34.82,7626.0,WellsFargo1,43,4
19,7626.0,84.62,49.57,35.05,7590.95,WellsFargo1,43,4
20,7590.95,84.62,49.34,35.28,7555.67,WellsFargo1,43,4
21,7555.67,84.62,49.11,35.51,7520.16,WellsFargo1,43,4
22,7520.16,84.62,48.88,35.74,7484.42,WellsFargo1,43,4
23,7484.42,84.62,48.65,35.97,7448.45,WellsFargo1,43,4
24,7448.45,84.62,48.41,36.21,7412.24,WellsFargo1,43,4
25,7412.24,84.62,48.18,36.44,7375.8,WellsFargo1,43,4
26,7375.8,84.62,47.94,36.68,7339.12,WellsFargo1,43,4
27,7339.12,84.62,47.7,36.92,7302.2,WellsFargo1,43,4
28,7302.2,84.62,47.46,37.16,7265.04,WellsFargo1,43,4
29,7265.04,84.62,47.22,37.4,7227.64,WellsFargo1,43,4
30,7227.64,84.62,46.98,37.64,7190.0,WellsFargo1,43,4
31,7190.0,84.62,46.73,37.89,7152.11,WellsFargo1,43,4
32,7152.11,84.62,46.49,38.13,7113.98,WellsFargo1,43,4
33,7113.98,84.62,46.24,38.38,7075.6,WellsFargo1,43,4
34,7075.6,84.62,45.99,38.63,7036.97,WellsFargo1,43,4
35,7036.97,84.62,45.74,38.88,6998.09,WellsFargo1,43,4
36,6998.09,84.62,45.49,39.13,6958.96,WellsFargo1,43,4
37,6958.96,84.62,45.23,39.39,6919.57,WellsFargo1,43,4
38,6919.57,84.62,44.98,39.64,6879.93,WellsFargo1,43,4
39,6879.93,84.62,44.72,39.9,6840.03,WellsFargo1,43,4
40,6840.03,84.62,44.46,40.16,6799.87,WellsFargo1,43,4
41,6799.87,84.62,44.2,40.42,6759.45,WellsFargo1,43,4
42,6759.45,84.62,43.94,40.68,6718.77,WellsFargo1,43,4
43,6718.77,84.62,43.67,40.95,6677.82,WellsFargo1,43,4
44,6677.82,84.62,43.41,41.21,6636.61,WellsFargo1,43,4
45,6636.61,84.62,43.14,41.48,6595.13,WellsFargo1,43,4
46,6595.13,84.62,42.87,41.75,6553.38,WellsFargo1,43,4
47,6553.38,84.62,42.6,42.02,6511.36,WellsFargo1,43,4
48,6511.36,84.62,42.32,42.3,6469.06,WellsFargo1,43,4
49,6469.06,84.62,42.05,42.57,6426.49,WellsFargo1,43,4
50,6426.49,84.62,41.77,42.85,6383.64,WellsFargo1,43,4
51,6383.64,84.62,41.49,43.13,6340.51,WellsFargo1,43,4
52,6340.51,84.62,41.21,43.41,6297.1,WellsFargo1,43,4
53,6297.1,84.62,40.93,43.69,6253.41,WellsFargo1,43,4
54,6253.41,84.62,40.65,43.97,6209.44,WellsFargo1,43,4
55,6209.44,84.62,40.36,44.26,6165.18,WellsFargo1,43,4
56,6165.18,84.62,40.07,44.55,6120.63,WellsFargo1,43,4
57,6120.63,84.62,39.78,44.84,6075.79,WellsFargo1,43,4
58,6075.79,84.62,39.49,45.13,6030.66,WellsFargo1,43,4
59,6030.66,84.62,39.2,45.42,5985.24,WellsFargo1,43,4
60,5985.24,84.62,38.9,45.72,5939.52,WellsFargo1,43,4
61,5939.52,84.62,38.61,46.01,5893.51,WellsFargo1,43,4
62,5893.51,84.62,38.31,46.31,5847.2,WellsFargo1,43,4
63,5847.2,84.62,38.01,46.61,5800.59,WellsFargo1,43,4
64,5800.59,84.62,37.7,46.92,5753.67,WellsFargo1,43,4
65,5753.67,154.13,37.4,116.73,5636.94,WellsFargo1,43,4
66,5636.94,2819.06,36.64,2782.42,2854.52,WellsFargo1,43,4
67,2854.52,2819.06,18.55,2800.51,54.01,WellsFargo1,43,4
68,54.01,2819.06,0.35,2818.71,-2764.7,WellsFargo1,43,4
0,20000.0,191.04,108.0,83.04,19916.96,WellsFargo2,43,5
1,19916.96,191.04,107.55,83.49,19833.47,WellsFargo2,43,5
2,19833.47,191.04,107.1,83.94,19749.53,WellsFargo2,43,5
3,19749.53,191.04,106.65,84.39,19665.14,WellsFargo2,43,5
4,19665.14,191.04,106.19,84.85,19580.29,WellsFargo2,43,5
5,19580.29,191.04,105.73,85.31,19494.98,WellsFargo2,43,5
6,19494.98,191.04,105.27,85.77,19409.21,WellsFargo2,43,5
7,19409.21,191.04,104.81,86.23,19322.98,WellsFargo2,43,5
8,19322.98,191.04,104.34,86.7,19236.28,WellsFargo2,43,5
9,19236.28,191.04,103.88,87.16,19149.12,WellsFargo2,43,5
10,19149.12,191.04,103.41,87.63,19061.49,WellsFargo2,43,5
11,19061.49,191.04,102.93,88.11,18973.38,WellsFargo2,43,5
12,18973.38,191.04,102.46,88.58,18884.8,WellsFargo2,43,5
13,18884.8,191.04,101.98,89.06,18795.74,WellsFargo2,43,5
14,18795.74,191.04,101.5,89.54,18706.2,WellsFargo2,43,5
15,18706.2,191.04,101.01,90.03,18616.17,WellsFargo2,43,5
16,18616.17,191.04,100.53,90.51,18525.66,WellsFargo2,43,5
17,18525.66,191.04,100.04,91.0,18434.66,WellsFargo2,43,5
18,18434.66,191.04,99.55,91.49,18343.17,WellsFargo2,43,5
19,18343.17,191.04,99.05,91.99,18251.18,WellsFargo2,43,5
20,18251.18,191.04,98.56,92.48,18158.7,WellsFargo2,43,5
21,18158.7,191.04,98.06,92.98,18065.72,WellsFargo2,43,5
22,18065.72,191.04,97.55,93.49,17972.23,WellsFargo2,43,5
23,17972.23,191.04,97.05,93.99,17878.24,WellsFargo2,43,5
24,17878.24,191.04,96.54,94.5,17783.74,WellsFargo2,43,5
25,17783.74,191.04,96.03,95.01,17688.73,WellsFargo2,43,5
26,17688.73,191.04,95.52,95.52,17593.21,WellsFargo2,43,5
27,17593.21,191.04,95.0,96.04,17497.17,WellsFargo2,43,5
28,17497.17,191.04,94.48,96.56,17400.61,WellsFargo2,43,5
29,17400.61,191.04,93.96,97.08,17303.53,WellsFargo2,43,5
30,17303.53,191.04,93.44,97.6,17205.93,WellsFargo2,43,5
31,17205.93,191.04,92.91,98.13,17107.8,WellsFargo2,43,5
32,17107.8,191.04,92.38,98.66,17009.14,WellsFargo2,43,5
33,17009.14,191.04,91.85,99.19,16909.95,WellsFargo2,43,5
34,16909.95,191.04,91.31,99.73,16810.22,WellsFargo2,43,5
35,16810.22,191.04,90.78,100.26,16709.96,WellsFargo2,43,5
36,16709.96,191.04,90.23,100.81,16609.15,WellsFargo2,43,5
37,16609.15,191.04,89.69,101.35,16507.8,WellsFargo2,43,5
38,16507.8,191.04,89.14,101.9,16405.9,WellsFargo2,43,5
39,16405.9,191.04,88.59,102.45,16303.45,WellsFargo2,43,5
40,16303.45,191.04,88.04,103.0,16200.45,WellsFargo2,43,5
41,16200.45,191.04,87.48,103.56,16096.89,WellsFargo2,43,5
42,16096.89,191.04,86.92,104.12,15992.77,WellsFargo2,43,5
43,15992.77,191.04,86.36,104.68,15888.09,WellsFargo2,43,5
44,15888.09,191.04,85.8,105.24,15782.85,WellsFargo2,43,5
45,15782.85,191.04,85.23,105.81,15677.04,WellsFargo2,43,5
46,15677.04,191.04,84.66,106.38,15570.66,WellsFargo2,43,5
47,15570.66,191.04,84.08,106.96,15463.7,WellsFargo2,43,5
48,15463.7,191.04,83.5,107.54,15356.16,WellsFargo2,43,5
49,15356.16,191.04,82.92,108.12,15248.04,WellsFargo2,43,5
50,15248.04,191.04,82.34,108.7,15139.34,WellsFargo2,43,5
51,15139.34,191.04,81.75,109.29,15030.05,WellsFargo2,43,5
52,15030.05,191.04,81.16,109.88,14920.17,WellsFargo2,43,5
53,14920.17,191.04,80.57,110.47,14809.7,WellsFargo2,43,5
54,14809.7,191.04,79.97,111.07,14698.63,WellsFargo2,43,5
55,14698.63,191.04,79.37,111.67,14586.96,WellsFargo2,43,5
56,14586.96,191.04,78.77,112.27,14474.69,WellsFargo2,43,5
57,14474.69,191.04,78.16,112.88,14361.81,WellsFargo2,43,5
58,14361.81,191.04,77.55,113.49,14248.32,WellsFargo2,43,5
59,14248.32,191.04,76.94,114.1,14134.22,WellsFargo2,43,5
60,14134.22,191.04,76.32,114.72,14019.5,WellsFargo2,43,5
61,14019.5,191.04,75.71,115.33,13904.17,WellsFargo2,43,5
62,13904.17,191.04,75.08,115.96,13788.21,WellsFargo2,43,5
63,13788.21,191.04,74.46,116.58,13671.63,WellsFargo2,43,5
64,13671.63,191.04,73.83,117.21,13554.42,WellsFargo2,43,5
65,13554.42,191.04,73.19,117.85,13436.57,WellsFargo2,43,5
66,13436.57,191.04,72.56,118.48,13318.09,WellsFargo2,43,5
67,13318.09,191.04,71.92,119.12,13198.97,WellsFargo2,43,5
68,13198.97,2955.74,71.27,2884.47,10314.5,WellsFargo2,43,5
69,10314.5,3010.1,55.7,2954.4,7360.1,WellsFargo2,43,5
70,7360.1,3010.1,39.74,2970.36,4389.74,WellsFargo2,43,5
71,4389.74,3010.1,23.7,2986.4,1403.34,WellsFargo2,43,5
72,1403.34,3010.1,7.58,3002.52,-1599.18,WellsFargo2,43,5
0,5000.0,1333.0,36.0,1297.0,3703.0,Car,44,1
1,3703.0,1333.0,26.66,1306.34,2396.66,Car,44,1
2,2396.66,1333.0,17.26,1315.74,1080.92,Car,44,1
3,1080.92,1333.0,7.78,1325.22,-244.3,Car,44,1
0,180000.0,1331.44,594.0,737.44,179262.56,mortgage,44,2
1,179262.56,1331.44,591.57,739.87,178522.69,mortgage,44,2
2,178522.69,1331.44,589.12,742.32,177780.37,mortgage,44,2
3,177780.37,1575.74,586.68,989.06,176791.31,mortgage,44,2
4,176791.31,2664.44,583.41,2081.03,174710.28,mortgage,44,2
5,174710.28,2664.44,576.54,2087.9,172622.38,mortgage,44,2
6,172622.38,2664.44,569.65,2094.79,170527.59,mortgage,44,2
7,170527.59,2664.44,562.74,2101.7,168425.89,mortgage,44,2
8,168425.89,2664.44,555.81,2108.63,166317.26,mortgage,44,2
9,166317.26,2664.44,548.85,2115.59,164201.67,mortgage,44,2
10,164201.67,2664.44,541.87,2122.57,162079.1,mortgage,44,2
11,162079.1,2664.44,534.86,2129.58,159949.52,mortgage,44,2
12,159949.52,2664.44,527.83,2136.61,157812.91,mortgage,44,2
13,157812.91,2664.44,520.78,2143.66,155669.25,mortgage,44,2
14,155669.25,2664.44,513.71,2150.73,153518.52,mortgage,44,2
15,153518.52,2664.44,506.61,2157.83,151360.69,mortgage,44,2
16,151360.69,2664.44,499.49,2164.95,149195.74,mortgage,44,2
17,149195.74,2664.44,492.35,2172.09,147023.65,mortgage,44,2
18,147023.65,2664.44,485.18,2179.26,144844.39,mortgage,44,2
19,144844.39,2664.44,477.99,2186.45,142657.94,mortgage,44,2
20,142657.94,2664.44,470.77,2193.67,140464.27,mortgage,44,2
21,140464.27,2664.44,463.53,2200.91,138263.36,mortgage,44,2
22,138263.36,2664.44,456.27,2208.17,136055.19,mortgage,44,2
23,136055.19,2664.44,448.98,2215.46,133839.73,mortgage,44,2
24,133839.73,2664.44,441.67,2222.77,131616.96,mortgage,44,2
25,131616.96,2664.44,434.34,2230.1,129386.86,mortgage,44,2
26,129386.86,2664.44,426.98,2237.46,127149.4,mortgage,44,2
27,127149.4,2664.44,419.59,2244.85,124904.55,mortgage,44,2
28,124904.55,2664.44,412.19,2252.25,122652.3,mortgage,44,2
29,122652.3,2664.44,404.75,2259.69,120392.61,mortgage,44,2
30,120392.61,2664.44,397.3,2267.14,118125.47,mortgage,44,2
31,118125.47,2664.44,389.81,2274.63,115850.84,mortgage,44,2
32,115850.84,2664.44,382.31,2282.13,113568.71,mortgage,44,2
33,113568.71,2664.44,374.78,2289.66,111279.05,mortgage,44,2
34,111279.05,2664.44,367.22,2297.22,108981.83,mortgage,44,2
35,108981.83,2664.44,359.64,2304.8,106677.03,mortgage,44,2
36,106677.03,2664.44,352.03,2312.41,104364.62,mortgage,44,2
37,104364.62,2664.44,344.4,2320.04,102044.58,mortgage,44,2
38,102044.58,2664.44,336.75,2327.69,99716.89,mortgage,44,2
39,99716.89,2664.44,329.07,2335.37,97381.52,mortgage,44,2
40,97381.52,2664.44,321.36,2343.08,95038.44,mortgage,44,2
41,95038.44,2664.44,313.63,2350.81,92687.63,mortgage,44,2
42,92687.63,2664.44,305.87,2358.57,90329.06,mortgage,44,2
43,90329.06,2664.44,298.09,2366.35,87962.71,mortgage,44,2
44,87962.71,2664.44,290.28,2374.16,85588.55,mortgage,44,2
45,85588.55,2664.44,282.44,2382.0,83206.55,mortgage,44,2
46,83206.55,2664.44,274.58,2389.86,80816.69,mortgage,44,2
47,80816.69,2664.44,266.7,2397.74,78418.95,mortgage,44,2
48,78418.95,2664.44,258.78,2405.66,76013.29,mortgage,44,2
49,76013.29,2664.44,250.84,2413.6,73599.69,mortgage,44,2
50,73599.69,2664.44,242.88,2421.56,71178.13,mortgage,44,2
51,71178.13,2664.44,234.89,2429.55,68748.58,mortgage,44,2
52,68748.58,2664.44,226.87,2437.57,66311.01,mortgage,44,2
53,66311.01,2664.44,218.83,2445.61,63865.4,mortgage,44,2
54,63865.4,2664.44,210.76,2453.68,61411.72,mortgage,44,2
55,61411.72,2664.44,202.66,2461.78,58949.94,mortgage,44,2
56,58949.94,2664.44,194.53,2469.91,56480.03,mortgage,44,2
57,56480.03,2664.44,186.38,2478.06,54001.97,mortgage,44,2
58,54001.97,2664.44,178.21,2486.23,51515.74,mortgage,44,2
59,51515.74,2664.44,170.0,2494.44,49021.3,mortgage,44,2
60,49021.3,2664.44,161.77,2502.67,46518.63,mortgage,44,2
61,46518.63,2664.44,153.51,2510.93,44007.7,mortgage,44,2
62,44007.7,2664.44,145.23,2519.21,41488.49,mortgage,44,2
63,41488.49,2664.44,136.91,2527.53,38960.96,mortgage,44,2
64,38960.96,2664.44,128.57,2535.87,36425.09,mortgage,44,2
65,36425.09,2664.44,120.2,2544.24,33880.85,mortgage,44,2
66,33880.85,2664.44,111.81,2552.63,31328.22,mortgage,44,2
67,31328.22,2664.44,103.38,2561.06,28767.16,mortgage,44,2
68,28767.16,2664.44,94.93,2569.51,26197.65,mortgage,44,2
69,26197.65,2664.44,86.45,2577.99,23619.66,mortgage,44,2
70,23619.66,2664.44,77.94,2586.5,21033.16,mortgage,44,2
71,21033.16,2664.44,69.41,2595.03,18438.13,mortgage,44,2
72,18438.13,2664.44,60.85,2603.59,15834.54,mortgage,44,2
73,15834.54,2664.44,52.25,2612.19,13222.35,mortgage,44,2
74,13222.35,2664.44,43.63,2620.81,10601.54,mortgage,44,2
75,10601.54,2664.44,34.99,2629.45,7972.09,mortgage,44,2
76,7972.09,2664.44,26.31,2638.13,5333.96,mortgage,44,2
77,5333.96,2664.44,17.6,2646.84,2687.12,mortgage,44,2
78,2687.12,2664.44,8.87,2655.57,31.55,mortgage,44,2
79,31.55,2664.44,0.1,2664.34,-2632.79,mortgage,44,2
0,4000.0,70.0,16.0,54.0,3946.0,testing,44,3
1,3946.0,70.0,15.78,54.22,3891.78,testing,44,3
2,3891.78,70.0,15.57,54.43,3837.35,testing,44,3
3,3837.35,70.0,15.35,54.65,3782.7,testing,44,3
4,3782.7,70.0,15.13,54.87,3727.83,testing,44,3
5,3727.83,70.0,14.91,55.09,3672.74,testing,44,3
6,3672.74,70.0,14.69,55.31,3617.43,testing,44,3
7,3617.43,70.0,14.47,55.53,3561.9,testing,44,3
8,3561.9,70.0,14.25,55.75,3506.15,testing,44,3
9,3506.15,70.0,14.02,55.98,3450.17,testing,44,3
10,3450.17,70.0,13.8,56.2,3393.97,testing,44,3
11,3393.97,70.0,13.58,56.42,3337.55,testing,44,3
12,3337.55,70.0,13.35,56.65,3280.9,testing,44,3
13,3280.9,70.0,13.12,56.88,3224.02,testing,44,3
14,3224.02,70.0,12.9,57.1,3166.92,testing,44,3
15,3166.92,70.0,12.67,57.33,3109.59,testing,44,3
16,3109.59,70.0,12.44,57.56,3052.03,testing,44,3
17,3052.03,70.0,12.21,57.79,2994.24,testing,44,3
18,2994.24,70.0,11.98,58.02,2936.22,testing,44,3
19,2936.22,70.0,11.74,58.26,2877.96,testing,44,3
20,2877.96,70.0,11.51,58.49,2819.47,testing,44,3
21,2819.47,70.0,11.28,58.72,2760.75,testing,44,3
22,2760.75,70.0,11.04,58.96,2701.79,testing,44,3
23,2701.79,70.0,10.81,59.19,2642.6,testing,44,3
24,2642.6,70.0,10.57,59.43,2583.17,testing,44,3
25,2583.17,70.0,10.33,59.67,2523.5,testing,44,3
26,2523.5,70.0,10.09,59.91,2463.59,testing,44,3
27,2463.59,70.0,9.85,60.15,2403.44,testing,44,3
28,2403.44,70.0,9.61,60.39,2343.05,testing,44,3
29,2343.05,70.0,9.37,60.63,2282.42,testing,44,3
30,2282.42,70.0,9.13,60.87,2221.55,testing,44,3
31,2221.55,70.0,8.89,61.11,2160.44,testing,44,3
32,2160.44,70.0,8.64,61.36,2099.08,testing,44,3
33,2099.08,70.0,8.4,61.6,2037.48,testing,44,3
34,2037.48,70.0,8.15,61.85,1975.63,testing,44,3
35,1975.63,70.0,7.9,62.1,1913.53,testing,44,3
36,1913.53,70.0,7.65,62.35,1851.18,testing,44,3
37,1851.18,70.0,7.4,62.6,1788.58,testing,44,3
38,1788.58,70.0,7.15,62.85,1725.73,testing,44,3
39,1725.73,70.0,6.9,63.1,1662.63,testing,44,3
40,1662.63,70.0,6.65,63.35,1599.28,testing,44,3
41,1599.28,70.0,6.4,63.6,1535.68,testing,44,3
42,1535.68,70.0,6.14,63.86,1471.82,testing,44,3
43,1471.82,70.0,5.89,64.11,1407.71,testing,44,3
44,1407.71,70.0,5.63,64.37,1343.34,testing,44,3
45,1343.34,70.0,5.37,64.63,1278.71,testing,44,3
46,1278.71,70.0,5.11,64.89,1213.82,testing,44,3
47,1213.82,70.0,4.86,65.14,1148.68,testing,44,3
48,1148.68,70.0,4.59,65.41,1083.27,testing,44,3
49,1083.27,70.0,4.33,65.67,1017.6,testing,44,3
50,1017.6,70.0,4.07,65.93,951.67,testing,44,3
51,951.67,70.0,3.81,66.19,885.48,testing,44,3
52,885.48,70.0,3.54,66.46,819.02,testing,44,3
53,819.02,70.0,3.28,66.72,752.3,testing,44,3
54,752.3,70.0,3.01,66.99,685.31,testing,44,3
55,685.31,70.0,2.74,67.26,618.05,testing,44,3
56,618.05,70.0,2.47,67.53,550.52,testing,44,3
57,550.52,70.0,2.2,67.8,482.72,testing,44,3
58,482.72,70.0,1.93,68.07,414.65,testing,44,3
59,414.65,70.0,1.66,68.34,346.31,testing,44,3
60,346.31,70.0,1.39,68.61,277.7,testing,44,3
61,277.7,70.0,1.11,68.89,208.81,testing,44,3
62,208.81,70.0,0.84,69.16,139.65,testing,44,3
63,139.65,70.0,0.56,69.44,70.21,testing,44,3
64,70.21,70.0,0.28,69.72,0.49,testing,44,3
65,0.49,70.0,0.0,70.0,-69.51,testing,44,3
0,20000.0,191.04,108.0,83.04,19916.96,WellsFargo2,44,4
1,19916.96,191.04,107.55,83.49,19833.47,WellsFargo2,44,4
2,19833.47,191.04,107.1,83.94,19749.53,WellsFargo2,44,4
3,19749.53,191.04,106.65,84.39,19665.14,WellsFargo2,44,4
4,19665.14,191.04,106.19,84.85,19580.29,WellsFargo2,44,4
5,19580.29,191.04,105.73,85.31,19494.98,WellsFargo2,44,4
6,19494.98,191.04,105.27,85.77,19409.21,WellsFargo2,44,4
7,19409.21,191.04,104.81,86.23,19322.98,WellsFargo2,44,4
8,19322.98,191.04,104.34,86.7,19236.28,WellsFargo2,44,4
9,19236.28,191.04,103.88,87.16,19149.12,WellsFargo2,44,4
10,19149.12,191.04,103.41,87.63,19061.49,WellsFargo2,44,4
11,19061.49,191.04,102.93,88.11,18973.38,WellsFargo2,44,4
12,18973.38,191.04,102.46,88.58,18884.8,WellsFargo2,44,4
13,18884.8,191.04,101.98,89.06,18795.74,WellsFargo2,44,4
14,18795.74,191.04,101.5,89.54,18706.2,WellsFargo2,44,4
15,18706.2,191.04,101.01,90.03,18616.17,WellsFargo2,44,4
16,18616.17,191.04,100.53,90.51,18525.66,WellsFargo2,44,4
17,18525.66,191.04,100.04,91.0,18434.66,WellsFargo2,44,4
18,18434.66,191.04,99.55,91.49,18343.17,WellsFargo2,44,4
19,18343.17,191.04,99.05,91.99,18251.18,WellsFargo2,44,4
20,18251.18,191.04,98.56,92.48,18158.7,WellsFargo2,44,4
21,18158.7,191.04,98.06,92.98,18065.72,WellsFargo2,44,4
22,18065.72,191.04,97.55,93.49,17972.23,WellsFargo2,44,4
23,17972.23,191.04,97.05,93.99,17878.24,WellsFargo2,44,4
24,17878.24,191.04,96.54,94.5,17783.74,WellsFargo2,44,4
25,17783.74,191.04,96.03,95.01,17688.73,WellsFargo2,44,4
26,17688.73,191.04,95.52,95.52,17593.21,WellsFargo2,44,4
27,17593.21,191.04,95.0,96.04,17497.17,WellsFargo2,44,4
28,17497.17,191.04,94.48,96.56,17400.61,WellsFargo2,44,4
29,17400.61,191.04,93.96,97.08,17303.53,WellsFargo2,44,4
30,17303.53,191.04,93.44,97.6,17205.93,WellsFargo2,44,4
31,17205.93,191.04,92.91,98.13,17107.8,WellsFargo2,44,4
32,17107.8,191.04,92.38,98.66,17009.14,WellsFargo2,44,4
33,17009.14,191.04,91.85,99.19,16909.95,WellsFargo2,44,4
34,16909.95,191.04,91.31,99.73,16810.22,WellsFargo2,44,4
35,16810.22,191.04,90.78,100.26,16709.96,WellsFargo2,44,4
36,16709.96,191.04,90.23,100.81,16609.15,WellsFargo2,44,4
37,16609.15,191.04,89.69,101.35,16507.8,WellsFargo2,44,4
38,16507.8,191.04,89.14,101.9,16405.9,WellsFargo2,44,4
39,16405.9,191.04,88.59,102.45,16303.45,WellsFargo2,44,4
40,16303.45,191.04,88.04,103.0,16200.45,WellsFargo2,44,4
41,16200.45,191.04,87.48,103.56,16096.89,WellsFargo2,44,4
42,16096.89,191.04,86.92,104.12,15992.77,WellsFargo2,44,4
43,15992.77,191.04,86.36,104.68,15888.09,WellsFargo2,44,4
44,15888.09,191.04,85.8,105.24,15782.85,WellsFargo2,44,4
45,15782.85,191.04,85.23,105.81,15677.04,WellsFargo2,44,4
46,15677.04,191.04,84.66,106.38,15570.66,WellsFargo2,44,4
47,15570.66,191.04,84.08,106.96,15463.7,WellsFargo2,44,4
48,15463.7,191.04,83.5,107.54,15356.16,WellsFargo2,44,4
49,15356.16,191.04,82.92,108.12,15248.04,WellsFargo2,44,4
50,15248.04,191.04,82.34,108.7,15139.34,WellsFargo2,44,4
51,15139.34,191.04,81.75,109.29,15030.05,WellsFargo2,44,4
52,15030.05,191.04,81.16,109.88,14920.17,WellsFargo2,44,4
53,14920.17,191.04,80.57,110.47,14809.7,WellsFargo2,44,4
54,14809.7,191.04,79.97,111.07,14698.63,WellsFargo2,44,4
55,14698.63,191.04,79.37,111.67,14586.96,WellsFargo2,44,4
56,14586.96,191.04,78.77,112.27,14474.69,WellsFargo2,44,4
57,14474.69,191.04,78.16,112.88,14361.81,WellsFargo2,44,4
58,14361.81,191.04,77.55,113.49,14248.32,WellsFargo2,44,4
59,14248.32,191.04,76.94,114.1,14134.22,WellsFargo2,44,4
60,14134.22,191.04,76.32,114.72,14019.5,WellsFargo2,44,4
61,14019.5,191.04,75.71,115.33,13904.17,WellsFargo2,44,4
62,13904.17,191.04,75.08,115.96,13788.21,WellsFargo2,44,4
63,13788.21,191.04,74.46,116.58,13671.63,WellsFargo2,44,4
64,13671.63,191.04,73.83,117.21,13554.42,WellsFargo2,44,4
65,13554.42,260.55,73.19,187.36,13367.06,WellsFargo2,44,4
66,13367.06,2925.48,72.18,2853.3,10513.76,WellsFargo2,44,4
67,10513.76,2925.48,56.77,2868.71,7645.05,WellsFargo2,44,4
68,7645.05,2925.48,41.28,2884.2,4760.85,WellsFargo2,44,4
69,4760.85,2925.48,25.71,2899.77,1861.08,WellsFargo2,44,4
70,1861.08,2925.48,10.05,2915.43,-1054.35,WellsFargo2,44,4
0,8250.57,84.62,53.63,30.99,8219.58,WellsFargo1,44,5
1,8219.58,84.62,53.43,31.19,8188.39,WellsFargo1,44,5
2,8188.39,84.62,53.22,31.4,8156.99,WellsFargo1,44,5
3,8156.99,84.62,53.02,31.6,8125.39,WellsFargo1,44,5
4,8125.39,84.62,52.82,31.8,8093.59,WellsFargo1,44,5
5,8093.59,84.62,52.61,32.01,8061.58,WellsFargo1,44,5
6,8061.58,84.62,52.4,32.22,8029.36,WellsFargo1,44,5
7,8029.36,84.62,52.19,32.43,7996.93,WellsFargo1,44,5
8,7996.93,84.62,51.98,32.64,7964.29,WellsFargo1,44,5
9,7964.29,84.62,51.77,32.85,7931.44,WellsFargo1,44,5
10,7931.44,84.62,51.55,33.07,7898.37,WellsFargo1,44,5
11,7898.37,84.62,51.34,33.28,7865.09,WellsFargo1,44,5
12,7865.09,84.62,51.12,33.5,7831.59,WellsFargo1,44,5
13,7831.59,84.62,50.91,33.71,7797.88,WellsFargo1,44,5
14,7797.88,84.62,50.69,33.93,7763.95,WellsFargo1,44,5
15,7763.95,84.62,50.47,34.15,7729.8,WellsFargo1,44,5
16,7729.8,84.62,50.24,34.38,7695.42,WellsFargo1,44,5
17,7695.42,84.62,50.02,34.6,7660.82,WellsFargo1,44,5
18,7660.82,84.62,49.8,34.82,7626.0,WellsFargo1,44,5
19,7626.0,84.62,49.57,35.05,7590.95,WellsFargo1,44,5
20,7590.95,84.62,49.34,35.28,7555.67,WellsFargo1,44,5
21,7555.67,84.62,49.11,35.51,7520.16,WellsFargo1,44,5
22,7520.16,84.62,48.88,35.74,7484.42,WellsFargo1,44,5
23,7484.42,84.62,48.65,35.97,7448.45,WellsFargo1,44,5
24,7448.45,84.62,48.41,36.21,7412.24,WellsFargo1,44,5
25,7412.24,84.62,48.18,36.44,7375.8,WellsFargo1,44,5
26,7375.8,84.62,47.94,36.68,7339.12,WellsFargo1,44,5
27,7339.12,84.62,47.7,36.92,7302.2,WellsFargo1,44,5
28,7302.2,84.62,47.46,37.16,7265.04,WellsFargo1,44,5
29,7265.04,84.62,47.22,37.4,7227.64,WellsFargo1,44,5
30,7227.64,84.62,46.98,37.64,7190.0,WellsFargo1,44,5
31,7190.0,84.62,46.73,37.89,7152.11,WellsFargo1,44,5
32,7152.11,84.62,46.49,38.13,7113.98,WellsFargo1,44,5
33,7113.98,84.62,46.24,38.38,7075.6,WellsFargo1,44,5
34,7075.6,84.62,45.99,38.63,7036.97,WellsFargo1,44,5
35,7036.97,84.62,45.74,38.88,6998.09,WellsFargo1,44,5
36,6998.09,84.62,45.49,39.13,6958.96,WellsFargo1,44,5
37,6958.96,84.62,45.23,39.39,6919.57,WellsFargo1,44,5
38,6919.57,84.62,44.98,39.64,6879.93,WellsFargo1,44,5
39,6879.93,84.62,44.72,39.9,6840.03,WellsFargo1,44,5
40,6840.03,84.62,44.46,40.16,6799.87,WellsFargo1,44,5
41,6799.87,84.62,44.2,40.42,6759.45,WellsFargo1,44,5
42,6759.45,84.62,43.94,40.68,6718.77,WellsFargo1,44,5
43,6718.77,84.62,43.67,40.95,6677.82,WellsFargo1,44,5
44,6677.82,84.62,43.41,41.21,6636.61,WellsFargo1,44,5
45,6636.61,84.62,43.14,41.48,6595.13,WellsFargo1,44,5
46,6595.13,84.62,42.87,41.75,6553.38,WellsFargo1,44,5
47,6553.38,84.62,42.6,42.02,6511.36,WellsFargo1,44,5
48,6511.36,84.62,42.32,42.3,6469.06,WellsFargo1,44,5
49,6469.06,84.62,42.05,42.57,6426.49,WellsFargo1,44,5
50,6426.49,84.62,41.77,42.85,6383.64,WellsFargo1,44,5
51,6383.64,84.62,41.49,43.13,6340.51,WellsFargo1,44,5
52,6340.51,84.62,41.21,43.41,6297.1,WellsFargo1,44,5
53,6297.1,84.62,40.93,43.69,6253.41,WellsFargo1,44,5
54,6253.41,84.62,40.65,43.97,6209.44,WellsFargo1,44,5
55,6209.44,84.62,40.36,44.26,6165.18,WellsFargo1,44,5
56,6165.18,84.62,40.07,44.55,6120.63,WellsFargo1,44,5
57,6120.63,84.62,39.78,44.84,6075.79,WellsFargo1,44,5
58,6075.79,84.62,39.49,45.13,6030.66,WellsFargo1,44,5
59,6030.66,84.62,39.2,45.42,5985.24,WellsFargo1,44,5
60,5985.24,84.62,38.9,45.72,5939.52,WellsFargo1,44,5
61,5939.52,84.62,38.61,46.01,5893.51,WellsFargo1,44,5
62,5893.51,84.62,38.31,46.31,5847.2,WellsFargo1,44,5
63,5847.2,84.62,38.01,46.61,5800.59,WellsFargo1,44,5
64,5800.59,84.62,37.7,46.92,5753.67,WellsFargo1,44,5
65,5753.67,84.62,37.4,47.22,5706.45,WellsFargo1,44,5
66,5706.45,84.62,37.09,47.53,5658.92,WellsFargo1,44,5
67,5658.92,84.62,36.78,47.84,5611.08,WellsFargo1,44,5
68,5611.08,84.62,36.47,48.15,5562.93,WellsFargo1,44,5
69,5562.93,84.62,36.16,48.46,5514.47,WellsFargo1,44,5
70,5514.47,1138.97,35.84,1103.13,4411.34,WellsFargo1,44,5
71,4411.34,3010.1,28.67,2981.43,1429.91,WellsFargo1,44,5
72,1429.91,3010.1,9.29,3000.81,-1570.9,WellsFargo1,44,5
0,5000.0,1333.0,36.0,1297.0,3703.0,Car,45,1
1,3703.0,1333.0,26.66,1306.34,2396.66,Car,45,1
2,2396.66,1333.0,17.26,1315.74,1080.92,Car,45,1
3,1080.92,1333.0,7.78,1325.22,-244.3,Car,45,1
0,180000.0,1331.44,594.0,737.44,179262.56,mortgage,45,2
1,179262.56,1331.44,591.57,739.87,178522.69,mortgage,45,2
2,178522.69,1331.44,589.12,742.32,177780.37,mortgage,45,2
3,177780.37,1575.74,586.68,989.06,176791.31,mortgage,45,2
4,176791.31,2664.44,583.41,2081.03,174710.28,mortgage,45,2
5,174710.28,2664.44,576.54,2087.9,172622.38,mortgage,45,2
6,172622.38,2664.44,569.65,2094.79,170527.59,mortgage,45,2
7,170527.59,2664.44,562.74,2101.7,168425.89,mortgage,45,2
8,168425.89,2664.44,555.81,2108.63,166317.26,mortgage,45,2
9,166317.26,2664.44,548.85,2115.59,164201.67,mortgage,45,2
10,164201.67,2664.44,541.87,2122.57,162079.1,mortgage,45,2
11,162079.1,2664.44,534.86,2129.58,159949.52,mortgage,45,2
12,159949.52,2664.44,527.83,2136.61,157812.91,mortgage,45,2
13,157812.91,2664.44,520.78,2143.66,155669.25,mortgage,45,2
14,155669.25,2664.44,513.71,2150.73,153518.52,mortgage,45,2
15,153518.52,2664.44,506.61,2157.83,151360.69,mortgage,45,2
16,151360.69,2664.44,499.49,2164.95,149195.74,mortgage,45,2
17,149195.74,2664.44,492.35,2172.09,147023.65,mortgage,45,2
18,147023.65,2664.44,485.18,2179.26,144844.39,mortgage,45,2
19,144844.39,2664.44,477.99,2186.45,142657.94,mortgage,45,2
20,142657.94,2664.44,470.77,2193.67,140464.27,mortgage,45,2
21,140464.27,2664.44,463.53,2200.91,138263.36,mortgage,45,2
22,138263.36,2664.44,456.27,2208.17,136055.19,mortgage,45,2
23,136055.19,2664.44,448.98,2215.46,133839.73,mortgage,45,2
24,133839.73,2664.44,441.67,2222.77,131616.96,mortgage,45,2
25,131616.96,2664.44,434.34,2230.1,129386.86,mortgage,45,2
26,129386.86,2664.44,426.98,2237.46,127149.4,mortgage,45,2
27,127149.4,2664.44,419.59,2244.85,124904.55,mortgage,45,2
28,124904.55,2664.44,412.19,2252.25,122652.3,mortgage,45,2
29,122652.3,2664.44,404.75,2259.69,120392.61,mortgage,45,2
30,120392.61,2664.44,397.3,2267.14,118125.47,mortgage,45,2
31,118125.47,2664.44,389.81,2274.63,115850.84,mortgage,45,2
32,115850.84,2664.44,382.31,2282.13,113568.71,mortgage,45,2
33,113568.71,2664.44,374.78,2289.66,111279.05,mortgage,45,2
34,111279.05,2664.44,367.22,2297.22,108981.83,mortgage,45,2
35,108981.83,2664.44,359.64,2304.8,106677.03,mortgage,45,2
36,106677.03,2664.44,352.03,2312.41,104364.62,mortgage,45,2
37,104364.62,2664.44,344.4,2320.04,102044.58,mortgage,45,2
38,102044.58,2664.44,336.75,2327.69,99716.89,mortgage,45,2
39,99716.89,2664.44,329.07,2335.37,97381.52,mortgage,45,2
40,97381.52,2664.44,321.36,2343.08,95038.44,mortgage,45,2
41,95038.44,2664.44,313.63,2350.81,92687.63,mortgage,45,2
42,92687.63,2664.44,305.87,2358.57,90329.06,mortgage,45,2
43,90329.06,2664.44,298.09,2366.35,87962.71,mortgage,45,2
44,87962.71,2664.44,290.28,2374.16,85588.55,mortgage,45,2
45,85588.55,2664.44,282.44,2382.0,83206.55,mortgage,45,2
46,83206.55,2664.44,274.58,2389.86,80816.69,mortgage,45,2
47,80816.69,2664.44,266.7,2397.74,78418.95,mortgage,45,2
48,78418.95,2664.44,258.78,2405.66,76013.29,mortgage,45,2
49,76013.29,2664.44,250.84,2413.6,73599.69,mortgage,45,2
50,73599.69,2664.44,242.88,2421.56,71178.13,mortgage,45,2
51,71178.13,2664.44,234.89,2429.55,68748.58,mortgage,45,2
52,68748.58,2664.44,226.87,2437.57,66311.01,mortgage,45,2
53,66311.01,2664.44,218.83,2445.61,63865.4,mortgage,45,2
54,63865.4,2664.44,210.76,2453.68,61411.72,mortgage,45,2
55,61411.72,2664.44,202.66,2461.78,58949.94,mortgage,45,2
56,58949.94,2664.44,194.53,2469.91,56480.03,mortgage,45,2
57,56480.03,2664.44,186.38,2478.06,54001.97,mortgage,45,2
58,54001.97,2664.44,178.21,2486.23,51515.74,mortgage,45,2
59,51515.74,2664.44,170.0,2494.44,49021.3,mortgage,45,2
60,49021.3,2664.44,161.77,2502.67,46518.63,mortgage,45,2
61,46518.63,2664.44,153.51,2510.93,44007.7,mortgage,45,2
62,44007.7,2664.44,145.23,2519.21,41488.49,mortgage,45,2
63,41488.49,2664.44,136.91,2527.53,38960.96,mortgage,45,2
64,38960.96,2664.44,128.57,2535.87,36425.09,mortgage,45,2
65,36425.09,2664.44,120.2,2544.24,33880.85,mortgage,45,2
66,33880.85,2664.44,111.81,2552.63,31328.22,mortgage,45,2
67,31328.22,2664.44,103.38,2561.06,28767.16,mortgage,45,2
68,28767.16,2664.44,94.93,2569.51,26197.65,mortgage,45,2
69,26197.65,2664.44,86.45,2577.99,23619.66,mortgage,45,2
70,23619.66,2664.44,77.94,2586.5,21033.16,mortgage,45,2
71,21033.16,2664.44,69.41,2595.03,18438.13,mortgage,45,2
72,18438.13,2664.44,60.85,2603.59,15834.54,mortgage,45,2
73,15834.54,2664.44,52.25,2612.19,13222.35,mortgage,45,2
74,13222.35,2664.44,43.63,2620.81,10601.54,mortgage,45,2
75,10601.54,2664.44,34.99,2629.45,7972.09,mortgage,45,2
76,7972.09,2664.44,26.31,2638.13,5333.96,mortgage,45,2
77,5333.96,2664.44,17.6,2646.84,2687.12,mortgage,45,2
78,2687.12,2664.44,8.87,2655.57,31.55,mortgage,45,2
79,31.55,2664.44,0.1,2664.34,-2632.79,mortgage,45,2
0,8250.57,84.62,53.63,30.99,8219.58,WellsFargo1,45,3
1,8219.58,84.62,53.43,31.19,8188.39,WellsFargo1,45,3
2,8188.39,84.62,53.22,31.4,8156.99,WellsFargo1,45,3
3,8156.99,84.62,53.02,31.6,8125.39,WellsFargo1,45,3
4,8125.39,84.62,52.82,31.8,8093.59,WellsFargo1,45,3
5,8093.59,84.62,52.61,32.01,8061.58,WellsFargo1,45,3
6,8061.58,84.62,52.4,32.22,8029.36,WellsFargo1,45,3
7,8029.36,84.62,52.19,32.43,7996.93,WellsFargo1,45,3
8,7996.93,84.62,51.98,32.64,7964.29,WellsFargo1,45,3
9,7964.29,84.62,51.77,32.85,7931.44,WellsFargo1,45,3
10,7931.44,84.62,51.55,33.07,7898.37,WellsFargo1,45,3
11,7898.37,84.62,51.34,33.28,7865.09,WellsFargo1,45,3
12,7865.09,84.62,51.12,33.5,7831.59,WellsFargo1,45,3
13,7831.59,84.62,50.91,33.71,7797.88,WellsFargo1,45,3
14,7797.88,84.62,50.69,33.93,7763.95,WellsFargo1,45,3
15,7763.95,84.62,50.47,34.15,7729.8,WellsFargo1,45,3
16,7729.8,84.62,50.24,34.38,7695.42,WellsFargo1,45,3
17,7695.42,84.62,50.02,34.6,7660.82,WellsFargo1,45,3
18,7660.82,84.62,49.8,34.82,7626.0,WellsFargo1,45,3
19,7626.0,84.62,49.57,35.05,7590.95,WellsFargo1,45,3
20,7590.95,84.62,49.34,35.28,7555.67,WellsFargo1,45,3
21,7555.67,84.62,49.11,35.51,7520.16,WellsFargo1,45,3
22,7520.16,84.62,48.88,35.74,7484.42,WellsFargo1,45,3
23,7484.42,84.62,48.65,35.97,7448.45,WellsFargo1,45,3
24,7448.45,84.62,48.41,36.21,7412.24,WellsFargo1,45,3
25,7412.24,84.62,48.18,36.44,7375.8,WellsFargo1,45,3
26,7375.8,84.62,47.94,36.68,7339.12,WellsFargo1,45,3
27,7339.12,84.62,47.7,36.92,7302.2,WellsFargo1,45,3
28,7302.2,84.62,47.46,37.16,7265.04,WellsFargo1,45,3
29,7265.04,84.62,47.22,37.4,7227.64,WellsFargo1,45,3
30,7227.64,84.62,46.98,37.64,7190.0,WellsFargo1,45,3
31,7190.0,84.62,46.73,37.89,7152.11,WellsFargo1,45,3
32,7152.11,84.62,46.49,38.13,7113.98,WellsFargo1,45,3
33,7113.98,84.62,46.24,38.38,7075.6,WellsFargo1,45,3
34,7075.6,84.62,45.99,38.63,7036.97,WellsFargo1,45,3
35,7036.97,84.62,45.74,38.88,6998.09,WellsFargo1,45,3
36,6998.09,84.62,45.49,39.13,6958.96,WellsFargo1,45,3
37,6958.96,84.62,45.23,39.39,6919.57,WellsFargo1,45,3
38,6919.57,84.62,44.98,39.64,6879.93,WellsFargo1,45,3
39,6879.93,84.62,44.72,39.9,6840.03,WellsFargo1,45,3
40,6840.03,84.62,44.46,40.16,6799.87,WellsFargo1,45,3
41,6799.87,84.62,44.2,40.42,6759.45,WellsFargo1,45,3
42,6759.45,84.62,43.94,40.68,6718.77,WellsFargo1,45,3
43,6718.77,84.62,43.67,40.95,6677.82,WellsFargo1,45,3
44,6677.82,84.62,43.41,41.21,6636.61,WellsFargo1,45,3
45,6636.61,84.62,43.14,41.48,6595.13,WellsFargo1,45,3
46,6595.13,84.62,42.87,41.75,6553.38,WellsFargo1,45,3
47,6553.38,84.62,42.6,42.02,6511.36,WellsFargo1,45,3
48,6511.36,84.62,42.32,42.3,6469.06,WellsFargo1,45,3
49,6469.06,84.62,42.05,42.57,6426.49,WellsFargo1,45,3
50,6426.49,84.62,41.77,42.85,6383.64,WellsFargo1,45,3
51,6383.64,84.62,41.49,43.13,6340.51,WellsFargo1,45,3
52,6340.51,84.62,41.21,43.41,6297.1,WellsFargo1,45,3
53,6297.1,84.62,40.93,43.69,6253.41,WellsFargo1,45,3
54,6253.41,84.62,40.65,43.97,6209.44,WellsFargo1,45,3
55,6209.44,84.62,40.36,44.26,6165.18,WellsFargo1,45,3
56,6165.18,84.62,40.07,44.55,6120.63,WellsFargo1,45,3
57,6120.63,84.62,39.78,44.84,6075.79,WellsFargo1,45,3
58,6075.79,84.62,39.49,45.13,6030.66,WellsFargo1,45,3
59,6030.66,84.62,39.2,45.42,5985.24,WellsFargo1,45,3
60,5985.24,84.62,38.9,45.72,5939.52,WellsFargo1,45,3
61,5939.52,84.62,38.61,46.01,5893.51,WellsFargo1,45,3
62,5893.51,84.62,38.31,46.31,5847.2,WellsFargo1,45,3
63,5847.2,84.62,38.01,46.61,5800.59,WellsFargo1,45,3
64,5800.59,84.62,37.7,46.92,5753.67,WellsFargo1,45,3
65,5753.67,84.62,37.4,47.22,5706.45,WellsFargo1,45,3
66,5706.45,84.62,37.09,47.53,5658.92,WellsFargo1,45,3
67,5658.92,84.62,36.78,47.84,5611.08,WellsFargo1,45,3
68,5611.08,84.62,36.47,48.15,5562.93,WellsFargo1,45,3
69,5562.93,84.62,36.16,48.46,5514.47,WellsFargo1,45,3
70,5514.47,84.62,35.84,48.78,5465.69,WellsFargo1,45,3
71,5465.69,84.62,35.53,49.09,5416.6,WellsFargo1,45,3
72,5416.6,84.62,35.21,49.41,5367.19,WellsFargo1,45,3
73,5367.19,84.62,34.89,49.73,5317.46,WellsFargo1,45,3
74,5317.46,84.62,34.56,50.06,5267.4,WellsFargo1,45,3
75,5267.4,84.62,34.24,50.38,5217.02,WellsFargo1,45,3
76,5217.02,84.62,33.91,50.71,5166.31,WellsFargo1,45,3
77,5166.31,84.62,33.58,51.04,5115.27,WellsFargo1,45,3
78,5115.27,84.62,33.25,51.37,5063.9,WellsFargo1,45,3
79,5063.9,2717.41,32.92,2684.49,2379.41,WellsFargo1,45,3
80,2379.41,2749.06,15.47,2733.59,-354.18,WellsFargo1,45,3
0,4000.0,70.0,16.0,54.0,3946.0,testing,45,4
1,3946.0,70.0,15.78,54.22,3891.78,testing,45,4
2,3891.78,70.0,15.57,54.43,3837.35,testing,45,4
3,3837.35,70.0,15.35,54.65,3782.7,testing,45,4
4,3782.7,70.0,15.13,54.87,3727.83,testing,45,4
5,3727.83,70.0,14.91,55.09,3672.74,testing,45,4
6,3672.74,70.0,14.69,55.31,3617.43,testing,45,4
7,3617.43,70.0,14.47,55.53,3561.9,testing,45,4
8,3561.9,70.0,14.25,55.75,3506.15,testing,45,4
9,3506.15,70.0,14.02,55.98,3450.17,testing,45,4
10,3450.17,70.0,13.8,56.2,3393.97,testing,45,4
11,3393.97,70.0,13.58,56.42,3337.55,testing,45,4
12,3337.55,70.0,13.35,56.65,3280.9,testing,45,4
13,3280.9,70.0,13.12,56.88,3224.02,testing,45,4
14,3224.02,70.0,12.9,57.1,3166.92,testing,45,4
15,3166.92,70.0,12.67,57.33,3109.59,testing,45,4
16,3109.59,70.0,12.44,57.56,3052.03,testing,45,4
17,3052.03,70.0,12.21,57.79,2994.24,testing,45,4
18,2994.24,70.0,11.98,58.02,2936.22,testing,45,4
19,2936.22,70.0,11.74,58.26,2877.96,testing,45,4
20,2877.96,70.0,11.51,58.49,2819.47,testing,45,4
21,2819.47,70.0,11.28,58.72,2760.75,testing,45,4
22,2760.75,70.0,11.04,58.96,2701.79,testing,45,4
23,2701.79,70.0,10.81,59.19,2642.6,testing,45,4
24,2642.6,70.0,10.57,59.43,2583.17,testing,45,4
25,2583.17,70.0,10.33,59.67,2523.5,testing,45,4
26,2523.5,70.0,10.09,59.91,2463.59,testing,45,4
27,2463.59,70.0,9.85,60.15,2403.44,testing,45,4
28,2403.44,70.0,9.61,60.39,2343.05,testing,45,4
29,2343.05,70.0,9.37,60.63,2282.42,testing,45,4
30,2282.42,70.0,9.13,60.87,2221.55,testing,45,4
31,2221.55,70.0,8.89,61.11,2160.44,testing,45,4
32,2160.44,70.0,8.64,61.36,2099.08,testing,45,4
33,2099.08,70.0,8.4,61.6,2037.48,testing,45,4
34,2037.48,70.0,8.15,61.85,1975.63,testing,45,4
35,1975.63,70.0,7.9,62.1,1913.53,testing,45,4
36,1913.53,70.0,7.65,62.35,1851.18,testing,45,4
37,1851.18,70.0,7.4,62.6,1788.58,testing,45,4
38,1788.58,70.0,7.15,62.85,1725.73,testing,45,4
39,1725.73,70.0,6.9,63.1,1662.63,testing,45,4
40,1662.63,70.0,6.65,63.35,1599.28,testing,45,4
41,1599.28,70.0,6.4,63.6,1535.68,testing,45,4
42,1535.68,70.0,6.14,63.86,1471.82,testing,45,4
43,1471.82,70.0,5.89,64.11,1407.71,testing,45,4
44,1407.71,70.0,5.63,64.37,1343.34,testing,45,4
45,1343.34,70.0,5.37,64.63,1278.71,testing,45,4
46,1278.71,70.0,5.11,64.89,1213.82,testing,45,4
47,1213.82,70.0,4.86,65.14,1148.68,testing,45,4
48,1148.68,70.0,4.59,65.41,1083.27,testing,45,4
49,1083.27,70.0,4.33,65.67,1017.6,testing,45,4
50,1017.6,70.0,4.07,65.93,951.67,testing,45,4
51,951.67,70.0,3.81,66.19,885.48,testing,45,4
52,885.48,70.0,3.54,66.46,819.02,testing,45,4
53,819.02,70.0,3.28,66.72,752.3,testing,45,4
54,752.3,70.0,3.01,66.99,685.31,testing,45,4
55,685.31,70.0,2.74,67.26,618.05,testing,45,4
56,618.05,70.0,2.47,67.53,550.52,testing,45,4
57,550.52,70.0,2.2,67.8,482.72,testing,45,4
58,482.72,70.0,1.93,68.07,414.65,testing,45,4
59,414.65,70.0,1.66,68.34,346.31,testing,45,4
60,346.31,70.0,1.39,68.61,277.7,testing,45,4
61,277.7,70.0,1.11,68.89,208.81,testing,45,4
62,208.81,70.0,0.84,69.16,139.65,testing,45,4
63,139.65,70.0,0.56,69.44,70.21,testing,45,4
64,70.21,70.0,0.28,69.72,0.49,testing,45,4
65,0.49,70.0,0.0,70.0,-69.51,testing,45,4
0,20000.0,191.04,108.0,83.04,19916.96,WellsFargo2,45,5
1,19916.96,191.04,107.55,83.49,19833.47,WellsFargo2,45,5
2,19833.47,191.04,107.1,83.94,19749.53,WellsFargo2,45,5
3,19749.53,191.04,106.65,84.39,19665.14,WellsFargo2,45,5
4,19665.14,191.04,106.19,84.85,19580.29,WellsFargo2,45,5
5,19580.29,191.04,105.73,85.31,19494.98,WellsFargo2,45,5
6,19494.98,191.04,105.27,85.77,19409.21,WellsFargo2,45,5
7,19409.21,191.04,104.81,86.23,19322.98,WellsFargo2,45,5
8,19322.98,191.04,104.34,86.7,19236.28,WellsFargo2,45,5
9,19236.28,191.04,103.88,87.16,19149.12,WellsFargo2,45,5
10,19149.12,191.04,103.41,87.63,19061.49,WellsFargo2,45,5
11,19061.49,191.04,102.93,88.11,18973.38,WellsFargo2,45,5
12,18973.38,191.04,102.46,88.58,18884.8,WellsFargo2,45,5
13,18884.8,191.04,101.98,89.06,18795.74,WellsFargo2,45,5
14,18795.74,191.04,101.5,89.54,18706.2,WellsFargo2,45,5
15,18706.2,191.04,101.01,90.03,18616.17,WellsFargo2,45,5
16,18616.17,191.04,100.53,90.51,18525.66,WellsFargo2,45,5
17,18525.66,191.04,100.04,91.0,18434.66,WellsFargo2,45,5
18,18434.66,191.04,99.55,91.49,18343.17,WellsFargo2,45,5
19,18343.17,191.04,99.05,91.99,18251.18,WellsFargo2,45,5
20,18251.18,191.04,98.56,92.48,18158.7,WellsFargo2,45,5
21,18158.7,191.04,98.06,92.98,18065.72,WellsFargo2,45,5
22,18065.72,191.04,97.55,93.49,17972.23,WellsFargo2,45,5
23,17972.23,191.04,97.05,93.99,17878.24,WellsFargo2,45,5
24,17878.24,191.04,96.54,94.5,17783.74,WellsFargo2,45,5
25,17783.74,191.04,96.03,95.01,17688.73,WellsFargo2,45,5
26,17688.73,191.04,95.52,95.52,17593.21,WellsFargo2,45,5
27,17593.21,191.04,95.0,96.04,17497.17,WellsFargo2,45,5
28,17497.17,191.04,94.48,96.56,17400.61,WellsFargo2,45,5
29,17400.61,191.04,93.96,97.08,17303.53,WellsFargo2,45,5
30,17303.53,191.04,93.44,97.6,17205.93,WellsFargo2,45,5
31,17205.93,191.04,92.91,98.13,17107.8,WellsFargo2,45,5
32,17107.8,191.04,92.38,98.66,17009.14,WellsFargo2,45,5
33,17009.14,191.04,91.85,99.19,16909.95,WellsFargo2,45,5
34,16909.95,191.04,91.31,99.73,16810.22,WellsFargo2,45,5
35,16810.22,191.04,90.78,100.26,16709.96,WellsFargo2,45,5
36,16709.96,191.04,90.23,100.81,16609.15,WellsFargo2,45,5
37,16609.15,191.04,89.69,101.35,16507.8,WellsFargo2,45,5
38,16507.8,191.04,89.14,101.9,16405.9,WellsFargo2,45,5
39,16405.9,191.04,88.59,102.45,16303.45,WellsFargo2,45,5
40,16303.45,191.04,88.04,103.0,16200.45,WellsFargo2,45,5
41,16200.45,191.04,87.48,103.56,16096.89,WellsFargo2,45,5
42,16096.89,191.04,86.92,104.12,15992.77,WellsFargo2,45,5
43,15992.77,191.04,86.36,104.68,15888.09,WellsFargo2,45,5
44,15888.09,191.04,85.8,105.24,15782.85,WellsFargo2,45,5
45,15782.85,191.04,85.23,105.81,15677.04,WellsFargo2,45,5
46,15677.04,191.04,84.66,106.38,15570.66,WellsFargo2,45,5
47,15570.66,191.04,84.08,106.96,15463.7,WellsFargo2,45,5
48,15463.7,191.04,83.5,107.54,15356.16,WellsFargo2,45,5
49,15356.16,191.04,82.92,108.12,15248.04,WellsFargo2,45,5
50,15248.04,191.04,82.34,108.7,15139.34,WellsFargo2,45,5
51,15139.34,191.04,81.75,109.29,15030.05,WellsFargo2,45,5
52,15030.05,191.04,81.16,109.88,14920.17,WellsFargo2,45,5
53,14920.17,191.04,80.57,110.47,14809.7,WellsFargo2,45,5
54,14809.7,191.04,79.97,111.07,14698.63,WellsFargo2,45,5
55,14698.63,191.04,79.37,111.67,14586.96,WellsFargo2,45,5
56,14586.96,191.04,78.77,112.27,14474.69,WellsFargo2,45,5
57,14474.69,191.04,78.16,112.88,14361.81,WellsFargo2,45,5
58,14361.81,191.04,77.55,113.49,14248.32,WellsFargo2,45,5
59,14248.32,191.04,76.94,114.1,14134.22,WellsFargo2,45,5
60,14134.22,191.04,76.32,114.72,14019.5,WellsFargo2,45,5
61,14019.5,191.04,75.71,115.33,13904.17,WellsFargo2,45,5
62,13904.17,191.04,75.08,115.96,13788.21,WellsFargo2,45,5
63,13788.21,191.04,74.46,116.58,13671.63,WellsFargo2,45,5
64,13671.63,191.04,73.83,117.21,13554.42,WellsFargo2,45,5
65,13554.42,260.55,73.19,187.36,13367.06,WellsFargo2,45,5
66,13367.06,3010.1,72.18,2937.92,10429.14,WellsFargo2,45,5
67,10429.14,3010.1,56.32,2953.78,7475.36,WellsFargo2,45,5
68,7475.36,3010.1,40.37,2969.73,4505.63,WellsFargo2,45,5
69,4505.63,3010.1,24.33,2985.77,1519.86,WellsFargo2,45,5
70,1519.86,3010.1,8.21,3001.89,-1482.03,WellsFargo2,45,5
0,5000.0,1333.0,36.0,1297.0,3703.0,Car,46,1
1,3703.0,1333.0,26.66,1306.34,2396.66,Car,46,1
2,2396.66,1333.0,17.26,1315.74,1080.92,Car,46,1
3,1080.92,1333.0,7.78,1325.22,-244.3,Car,46,1
0,180000.0,1331.44,594.0,737.44,179262.56,mortgage,46,2
1,179262.56,1331.44,591.57,739.87,178522.69,mortgage,46,2
2,178522.69,1331.44,589.12,742.32,177780.37,mortgage,46,2
3,177780.37,1575.74,586.68,989.06,176791.31,mortgage,46,2
4,176791.31,2664.44,583.41,2081.03,174710.28,mortgage,46,2
5,174710.28,2664.44,576.54,2087.9,172622.38,mortgage,46,2
6,172622.38,2664.44,569.65,2094.79,170527.59,mortgage,46,2
7,170527.59,2664.44,562.74,2101.7,168425.89,mortgage,46,2
8,168425.89,2664.44,555.81,2108.63,166317.26,mortgage,46,2
9,166317.26,2664.44,548.85,2115.59,164201.67,mortgage,46,2
10,164201.67,2664.44,541.87,2122.57,162079.1,mortgage,46,2
11,162079.1,2664.44,534.86,2129.58,159949.52,mortgage,46,2
12,159949.52,2664.44,527.83,2136.61,157812.91,mortgage,46,2
13,157812.91,2664.44,520.78,2143.66,155669.25,mortgage,46,2
14,155669.25,2664.44,513.71,2150.73,153518.52,mortgage,46,2
15,153518.52,2664.44,506.61,2157.83,151360.69,mortgage,46,2
16,151360.69,2664.44,499.49,2164.95,149195.74,mortgage,46,2
17,149195.74,2664.44,492.35,2172.09,147023.65,mortgage,46,2
18,147023.65,2664.44,485.18,2179.26,144844.39,mortgage,46,2
19,144844.39,2664.44,477.99,2186.45,142657.94,mortgage,46,2
20,142657.94,2664.44,470.77,2193.67,140464.27,mortgage,46,2
21,140464.27,2664.44,463.53,2200.91,138263.36,mortgage,46,2
22,138263.36,2664.44,456.27,2208.17,136055.19,mortgage,46,2
23,136055.19,2664.44,448.98,2215.46,133839.73,mortgage,46,2
24,133839.73,2664.44,441.67,2222.77,131616.96,mortgage,46,2
25,131616.96,2664.44,434.34,2230.1,129386.86,mortgage,46,2
26,129386.86,2664.44,426.98,2237.46,127149.4,mortgage,46,2
27,127149.4,2664.44,419.59,2244.85,124904.55,mortgage,46,2
28,124904.55,2664.44,412.19,2252.25,122652.3,mortgage,46,2
29,122652.3,2664.44,404.75,2259.69,120392.61,mortgage,46,2
30,120392.61,2664.44,397.3,2267.14,118125.47,mortgage,46,2
31,118125.47,2664.44,389.81,2274.63,115850.84,mortgage,46,2
32,115850.84,2664.44,382.31,2282.13,113568.71,mortgage,46,2
33,113568.71,2664.44,374.78,2289.66,111279.05,mortgage,46,2
34,111279.05,2664.44,367.22,2297.22,108981.83,mortgage,46,2
35,108981.83,2664.44,359.64,2304.8,106677.03,mortgage,46,2
36,106677.03,2664.44,352.03,2312.41,104364.62,mortgage,46,2
37,104364.62,2664.44,344.4,2320.04,102044.58,mortgage,46,2
38,102044.58,2664.44,336.75,2327.69,99716.89,mortgage,46,2
39,99716.89,2664.44,329.07,2335.37,97381.52,mortgage,46,2
40,97381.52,2664.44,321.36,2343.08,95038.44,mortgage,46,2
41,95038.44,2664.44,313.63,2350.81,92687.63,mortgage,46,2
42,92687.63,2664.44,305.87,2358.57,90329.06,mortgage,46,2
43,90329.06,2664.44,298.09,2366.35,87962.71,mortgage,46,2
44,87962.71,2664.44,290.28,2374.16,85588.55,mortgage,46,2
45,85588.55,2664.44,282.44,2382.0,83206.55,mortgage,46,2
46,83206.55,2664.44,274.58,2389.86,80816.69,mortgage,46,2
47,80816.69,2664.44,266.7,2397.74,78418.95,mortgage,46,2
48,78418.95,2664.44,258.78,2405.66,76013.29,mortgage,46,2
49,76013.29,2664.44,250.84,2413.6,73599.69,mortgage,46,2
50,73599.69,2664.44,242.88,2421.56,71178.13,mortgage,46,2
51,71178.13,2664.44,234.89,2429.55,68748.58,mortgage,46,2
52,68748.58,2664.44,226.87,2437.57,66311.01,mortgage,46,2
53,66311.01,2664.44,218.83,2445.61,63865.4,mortgage,46,2
54,63865.4,2664.44,210.76,2453.68,61411.72,mortgage,46,2
55,61411.72,2664.44,202.66,2461.78,58949.94,mortgage,46,2
56,58949.94,2664.44,194.53,2469.91,56480.03,mortgage,46,2
57,56480.03,2664.44,186.38,2478.06,54001.97,mortgage,46,2
58,54001.97,2664.44,178.21,2486.23,51515.74,mortgage,46,2
59,51515.74,2664.44,170.0,2494.44,49021.3,mortgage,46,2
60,49021.3,2664.44,161.77,2502.67,46518.63,mortgage,46,2
61,46518.63,2664.44,153.51,2510.93,44007.7,mortgage,46,2
62,44007.7,2664.44,145.23,2519.21,41488.49,mortgage,46,2
63,41488.49,2664.44,136.91,2527.53,38960.96,mortgage,46,2
64,38960.96,2664.44,128.57,2535.87,36425.09,mortgage,46,2
65,36425.09,2664.44,120.2,2544.24,33880.85,mortgage,46,2
66,33880.85,2664.44,111.81,2552.63,31328.22,mortgage,46,2
67,31328.22,2664.44,103.38,2561.06,28767.16,mortgage,46,2
68,28767.16,2664.44,94.93,2569.51,26197.65,mortgage,46,2
69,26197.65,2664.44,86.45,2577.99,23619.66,mortgage,46,2
70,23619.66,2664.44,77.94,2586.5,21033.16,mortgage,46,2
71,21033.16,2664.44,69.41,2595.03,18438.13,mortgage,46,2
72,18438.13,2664.44,60.85,2603.59,15834.54,mortgage,46,2
73,15834.54,2664.44,52.25,2612.19,13222.35,mortgage,46,2
74,13222.35,2664.44,43.63,2620.81,10601.54,mortgage,46,2
75,10601.54,2664.44,34.99,2629.45,7972.09,mortgage,46,2
76,7972.09,2664.44,26.31,2638.13,5333.96,mortgage,46,2
77,5333.96,2664.44,17.6,2646.84,2687.12,mortgage,46,2
78,2687.12,2664.44,8.87,2655.57,31.55,mortgage,46,2
79,31.55,2664.44,0.1,2664.34,-2632.79,mortgage,46,2
0,8250.57,84.62,53.63,30.99,8219.58,WellsFargo1,46,3
1,8219.58,84.62,53.43,31.19,8188.39,WellsFargo1,46,3
2,8188.39,84.62,53.22,31.4,8156.99,WellsFargo1,46,3
3,8156.99,84.62,53.02,31.6,8125.39,WellsFargo1,46,3
4,8125.39,84.62,52.82,31.8,8093.59,WellsFargo1,46,3
5,8093.59,84.62,52.61,32.01,8061.58,WellsFargo1,46,3
6,8061.58,84.62,52.4,32.22,8029.36,WellsFargo1,46,3
7,8029.36,84.62,52.19,32.43,7996.93,WellsFargo1,46,3
8,7996.93,84.62,51.98,32.64,7964.29,WellsFargo1,46,3
9,7964.29,84.62,51.77,32.85,7931.44,WellsFargo1,46,3
10,7931.44,84.62,51.55,33.07,7898.37,WellsFargo1,46,3
11,7898.37,84.62,51.34,33.28,7865.09,WellsFargo1,46,3
12,7865.09,84.62,51.12,33.5,7831.59,WellsFargo1,46,3
13,7831.59,84.62,50.91,33.71,7797.88,WellsFargo1,46,3
14,7797.88,84.62,50.69,33.93,7763.95,WellsFargo1,46,3
15,7763.95,84.62,50.47,34.15,7729.8,WellsFargo1,46,3
16,7729.8,84.62,50.24,34.38,7695.42,WellsFargo1,46,3
17,7695.42,84.62,50.02,34.6,7660.82,WellsFargo1,46,3
18,7660.82,84.62,49.8,34.82,7626.0,WellsFargo1,46,3
19,7626.0,84.62,49.57,35.05,7590.95,WellsFargo1,46,3
20,7590.95,84.62,49.34,35.28,7555.67,WellsFargo1,46,3
21,7555.67,84.62,49.11,35.51,7520.16,WellsFargo1,46,3
22,7520.16,84.62,48.88,35.74,7484.42,WellsFargo1,46,3
23,7484.42,84.62,48.65,35.97,7448.45,WellsFargo1,46,3
24,7448.45,84.62,48.41,36.21,7412.24,WellsFargo1,46,3
25,7412.24,84.62,48.18,36.44,7375.8,WellsFargo1,46,3
26,7375.8,84.62,47.94,36.68,7339.12,WellsFargo1,46,3
27,7339.12,84.62,47.7,36.92,7302.2,WellsFargo1,46,3
28,7302.2,84.62,47.46,37.16,7265.04,WellsFargo1,46,3
29,7265.04,84.62,47.22,37.4,7227.64,WellsFargo1,46,3
30,7227.64,84.62,46.98,37.64,7190.0,WellsFargo1,46,3
31,7190.0,84.62,46.73,37.89,7152.11,WellsFargo1,46,3
32,7152.11,84.62,46.49,38.13,7113.98,WellsFargo1,46,3
33,7113.98,84.62,46.24,38.38,7075.6,WellsFargo1,46,3
34,7075.6,84.62,45.99,38.63,7036.97,WellsFargo1,46,3
35,7036.97,84.62,45.74,38.88,6998.09,WellsFargo1,46,3
36,6998.09,84.62,45.49,39.13,6958.96,WellsFargo1,46,3
37,6958.96,84.62,45.23,39.39,6919.57,WellsFargo1,46,3
38,6919.57,84.62,44.98,39.64,6879.93,WellsFargo1,46,3
39,6879.93,84.62,44.72,39.9,6840.03,WellsFargo1,46,3
40,6840.03,84.62,44.46,40.16,6799.87,WellsFargo1,46,3
41,6799.87,84.62,44.2,40.42,6759.45,WellsFargo1,46,3
42,6759.45,84.62,43.94,40.68,6718.77,WellsFargo1,46,3
43,6718.77,84.62,43.67,40.95,6677.82,WellsFargo1,46,3
44,6677.82,84.62,43.41,41.21,6636.61,WellsFargo1,46,3
45,6636.61,84.62,43.14,41.48,6595.13,WellsFargo1,46,3
46,6595.13,84.62,42.87,41.75,6553.38,WellsFargo1,46,3
47,6553.38,84.62,42.6,42.02,6511.36,WellsFargo1,46,3
48,6511.36,84.62,42.32,42.3,6469.06,WellsFargo1,46,3
49,6469.06,84.62,42.05,42.57,6426.49,WellsFargo1,46,3
50,6426.49,84.62,41.77,42.85,6383.64,WellsFargo1,46,3
51,6383.64,84.62,41.49,43.13,6340.51,WellsFargo1,46,3
52,6340.51,84.62,41.21,43.41,6297.1,WellsFargo1,46,3
53,6297.1,84.62,40.93,43.69,6253.41,WellsFargo1,46,3
54,6253.41,84.62,40.65,43.97,6209.44,WellsFargo1,46,3
55,6209.44,84.62,40.36,44.26,6165.18,WellsFargo1,46,3
56,6165.18,84.62,40.07,44.55,6120.63,WellsFargo1,46,3
57,6120.63,84.62,39.78,44.84,6075.79,WellsFargo1,46,3
58,6075.79,84.62,39.49,45.13,6030.66,WellsFargo1,46,3
59,6030.66,84.62,39.2,45.42,5985.24,WellsFargo1,46,3
60,5985.24,84.62,38.9,45.72,5939.52,WellsFargo1,46,3
61,5939.52,84.62,38.61,46.01,5893.51,WellsFargo1,46,3
62,5893.51,84.62,38.31,46.31,5847.2,WellsFargo1,46,3
63,5847.2,84.62,38.01,46.61,5800.59,WellsFargo1,46,3
64,5800.59,84.62,37.7,46.92,5753.67,WellsFargo1,46,3
65,5753.67,84.62,37.4,47.22,5706.45,WellsFargo1,46,3
66,5706.45,84.62,37.09,47.53,5658.92,WellsFargo1,46,3
67,5658.92,84.62,36.78,47.84,5611.08,WellsFargo1,46,3
68,5611.08,84.62,36.47,48.15,5562.93,WellsFargo1,46,3
69,5562.93,84.62,36.16,48.46,5514.47,WellsFargo1,46,3
70,5514.47,84.62,35.84,48.78,5465.69,WellsFargo1,46,3
71,5465.69,84.62,35.53,49.09,5416.6,WellsFargo1,46,3
72,5416.6,84.62,35.21,49.41,5367.19,WellsFargo1,46,3
73,5367.19,84.62,34.89,49.73,5317.46,WellsFargo1,46,3
74,5317.46,84.62,34.56,50.06,5267.4,WellsFargo1,46,3
75,5267.4,84.62,34.24,50.38,5217.02,WellsFargo1,46,3
76,5217.02,84.62,33.91,50.71,5166.31,WellsFargo1,46,3
77,5166.31,84.62,33.58,51.04,5115.27,WellsFargo1,46,3
78,5115.27,84.62,33.25,51.37,5063.9,WellsFargo1,46,3
79,5063.9,2717.41,32.92,2684.49,2379.41,WellsFargo1,46,3
80,2379.41,2749.06,15.47,2733.59,-354.18,WellsFargo1,46,3
0,20000.0,191.04,108.0,83.04,19916.96,WellsFargo2,46,4
1,19916.96,191.04,107.55,83.49,19833.47,WellsFargo2,46,4
2,19833.47,191.04,107.1,83.94,19749.53,WellsFargo2,46,4
3,19749.53,191.04,106.65,84.39,19665.14,WellsFargo2,46,4
4,19665.14,191.04,106.19,84.85,19580.29,WellsFargo2,46,4
5,19580.29,191.04,105.73,85.31,19494.98,WellsFargo2,46,4
6,19494.98,191.04,105.27,85.77,19409.21,WellsFargo2,46,4
7,19409.21,191.04,104.81,86.23,19322.98,WellsFargo2,46,4
8,19322.98,191.04,104.34,86.7,19236.28,WellsFargo2,46,4
9,19236.28,191.04,103.88,87.16,19149.12,WellsFargo2,46,4
10,19149.12,191.04,103.41,87.63,19061.49,WellsFargo2,46,4
11,19061.49,191.04,102.93,88.11,18973.38,WellsFargo2,46,4
12,18973.38,191.04,102.46,88.58,18884.8,WellsFargo2,46,4
13,18884.8,191.04,101.98,89.06,18795.74,WellsFargo2,46,4
14,18795.74,191.04,101.5,89.54,18706.2,WellsFargo2,46,4
15,18706.2,191.04,101.01,90.03,18616.17,WellsFargo2,46,4
16,18616.17,191.04,100.53,90.51,18525.66,WellsFargo2,46,4
17,18525.66,191.04,100.04,91.0,18434.66,WellsFargo2,46,4
18,18434.66,191.04,99.55,91.49,18343.17,WellsFargo2,46,4
19,18343.17,191.04,99.05,91.99,18251.18,WellsFargo2,46,4
20,18251.18,191.04,98.56,92.48,18158.7,WellsFargo2,46,4
21,18158.7,191.04,98.06,92.98,18065.72,WellsFargo2,46,4
22,18065.72,191.04,97.55,93.49,17972.23,WellsFargo2,46,4
23,17972.23,191.04,97.05,93.99,17878.24,WellsFargo2,46,4
24,17878.24,191.04,96.54,94.5,17783.74,WellsFargo2,46,4
25,17783.74,191.04,96.03,95.01,17688.73,WellsFargo2,46,4
26,17688.73,191.04,95.52,95.52,17593.21,WellsFargo2,46,4
27,17593.21,191.04,95.0,96.04,17497.17,WellsFargo2,46,4
28,17497.17,191.04,94.48,96.56,17400.61,WellsFargo2,46,4
29,17400.61,191.04,93.96,97.08,17303.53,WellsFargo2,46,4
30,17303.53,191.04,93.44,97.6,17205.93,WellsFargo2,46,4
31,17205.93,191.04,92.91,98.13,17107.8,WellsFargo2,46,4
32,17107.8,191.04,92.38,98.66,17009.14,WellsFargo2,46,4
33,17009.14,191.04,91.85,99.19,16909.95,WellsFargo2,46,4
34,16909.95,191.04,91.31,99.73,16810.22,WellsFargo2,46,4
35,16810.22,191.04,90.78,100.26,16709.96,WellsFargo2,46,4
36,16709.96,191.04,90.23,100.81,16609.15,WellsFargo2,46,4
37,16609.15,191.04,89.69,101.35,16507.8,WellsFargo2,46,4
38,16507.8,191.04,89.14,101.9,16405.9,WellsFargo2,46,4
39,16405.9,191.04,88.59,102.45,16303.45,WellsFargo2,46,4
40,16303.45,191.04,88.04,103.0,16200.45,WellsFargo2,46,4
41,16200.45,191.04,87.48,103.56,16096.89,WellsFargo2,46,4
42,16096.89,191.04,86.92,104.12,15992.77,WellsFargo2,46,4
43,15992.77,191.04,86.36,104.68,15888.09,WellsFargo2,46,4
44,15888.09,191.04,85.8,105.24,15782.85,WellsFargo2,46,4
45,15782.85,191.04,85.23,105.81,15677.04,WellsFargo2,46,4
46,15677.04,191.04,84.66,106.38,15570.66,WellsFargo2,46,4
47,15570.66,191.04,84.08,106.96,15463.7,WellsFargo2,46,4
48,15463.7,191.04,83.5,107.54,15356.16,WellsFargo2,46,4
49,15356.16,191.04,82.92,108.12,15248.04,WellsFargo2,46,4
50,15248.04,191.04,82.34,108.7,15139.34,WellsFargo2,46,4
51,15139.34,191.04,81.75,109.29,15030.05,WellsFargo2,46,4
52,15030.05,191.04,81.16,109.88,14920.17,WellsFargo2,46,4
53,14920.17,191.04,80.57,110.47,14809.7,WellsFargo2,46,4
54,14809.7,191.04,79.97,111.07,14698.63,WellsFargo2,46,4
55,14698.63,191.04,79.37,111.67,14586.96,WellsFargo2,46,4
56,14586.96,191.04,78.77,112.27,14474.69,WellsFargo2,46,4
57,14474.69,191.04,78.16,112.88,14361.81,WellsFargo2,46,4
58,14361.81,191.04,77.55,113.49,14248.32,WellsFargo2,46,4
59,14248.32,191.04,76.94,114.1,14134.22,WellsFargo2,46,4
60,14134.22,191.04,76.32,114.72,14019.5,WellsFargo2,46,4
61,14019.5,191.04,75.71,115.33,13904.17,WellsFargo2,46,4
62,13904.17,191.04,75.08,115.96,13788.21,WellsFargo2,46,4
63,13788.21,191.04,74.46,116.58,13671.63,WellsFargo2,46,4
64,13671.63,191.04,73.83,117.21,13554.42,WellsFargo2,46,4
65,13554.42,191.04,73.19,117.85,13436.57,WellsFargo2,46,4
66,13436.57,191.04,72.56,118.48,13318.09,WellsFargo2,46,4
67,13318.09,191.04,71.92,119.12,13198.97,WellsFargo2,46,4
68,13198.97,191.04,71.27,119.77,13079.2,WellsFargo2,46,4
69,13079.2,191.04,70.63,120.41,12958.79,WellsFargo2,46,4
70,12958.79,191.04,69.98,121.06,12837.73,WellsFargo2,46,4
71,12837.73,191.04,69.32,121.72,12716.01,WellsFargo2,46,4
72,12716.01,191.04,68.67,122.37,12593.64,WellsFargo2,46,4
73,12593.64,191.04,68.01,123.03,12470.61,WellsFargo2,46,4
74,12470.61,191.04,67.34,123.7,12346.91,WellsFargo2,46,4
75,12346.91,191.04,66.67,124.37,12222.54,WellsFargo2,46,4
76,12222.54,191.04,66.0,125.04,12097.5,WellsFargo2,46,4
77,12097.5,191.04,65.33,125.71,11971.79,WellsFargo2,46,4
78,11971.79,191.04,64.65,126.39,11845.4,WellsFargo2,46,4
79,11845.4,191.04,63.97,127.07,11718.33,WellsFargo2,46,4
80,11718.33,545.22,63.28,481.94,11236.39,WellsFargo2,46,4
81,11236.39,2940.1,60.68,2879.42,8356.97,WellsFargo2,46,4
82,8356.97,2940.1,45.13,2894.97,5462.0,WellsFargo2,46,4
83,5462.0,2940.1,29.49,2910.61,2551.39,WellsFargo2,46,4
84,2551.39,2940.1,13.78,2926.32,-374.93,WellsFargo2,46,4
0,4000.0,70.0,16.0,54.0,3946.0,testing,46,5
1,3946.0,70.0,15.78,54.22,3891.78,testing,46,5
2,3891.78,70.0,15.57,54.43,3837.35,testing,46,5
3,3837.35,70.0,15.35,54.65,3782.7,testing,46,5
4,3782.7,70.0,15.13,54.87,3727.83,testing,46,5
5,3727.83,70.0,14.91,55.09,3672.74,testing,46,5
6,3672.74,70.0,14.69,55.31,3617.43,testing,46,5
7,3617.43,70.0,14.47,55.53,3561.9,testing,46,5
8,3561.9,70.0,14.25,55.75,3506.15,testing,46,5
9,3506.15,70.0,14.02,55.98,3450.17,testing,46,5
10,3450.17,70.0,13.8,56.2,3393.97,testing,46,5
11,3393.97,70.0,13.58,56.42,3337.55,testing,46,5
12,3337.55,70.0,13.35,56.65,3280.9,testing,46,5
13,3280.9,70.0,13.12,56.88,3224.02,testing,46,5
14,3224.02,70.0,12.9,57.1,3166.92,testing,46,5
15,3166.92,70.0,12.67,57.33,3109.59,testing,46,5
16,3109.59,70.0,12.44,57.56,3052.03,testing,46,5
17,3052.03,70.0,12.21,57.79,2994.24,testing,46,5
18,2994.24,70.0,11.98,58.02,2936.22,testing,46,5
19,2936.22,70.0,11.74,58.26,2877.96,testing,46,5
20,2877.96,70.0,11.51,58.49,2819.47,testing,46,5
21,2819.47,70.0,11.28,58.72,2760.75,testing,46,5
22,2760.75,70.0,11.04,58.96,2701.79,testing,46,5
23,2701.79,70.0,10.81,59.19,2642.6,testing,46,5
24,2642.6,70.0,10.57,59.43,2583.17,testing,46,5
25,2583.17,70.0,10.33,59.67,2523.5,testing,46,5
26,2523.5,70.0,10.09,59.91,2463.59,testing,46,5
27,2463.59,70.0,9.85,60.15,2403.44,testing,46,5
28,2403.44,70.0,9.61,60.39,2343.05,testing,46,5
29,2343.05,70.0,9.37,60.63,2282.42,testing,46,5
30,2282.42,70.0,9.13,60.87,2221.55,testing,46,5
31,2221.55,70.0,8.89,61.11,2160.44,testing,46,5
32,2160.44,70.0,8.64,61.36,2099.08,testing,46,5
33,2099.08,70.0,8.4,61.6,2037.48,testing,46,5
34,2037.48,70.0,8.15,61.85,1975.63,testing,46,5
35,1975.63,70.0,7.9,62.1,1913.53,testing,46,5
36,1913.53,70.0,7.65,62.35,1851.18,testing,46,5
37,1851.18,70.0,7.4,62.6,1788.58,testing,46,5
38,1788.58,70.0,7.15,62.85,1725.73,testing,46,5
39,1725.73,70.0,6.9,63.1,1662.63,testing,46,5
40,1662.63,70.0,6.65,63.35,1599.28,testing,46,5
41,1599.28,70.0,6.4,63.6,1535.68,testing,46,5
42,1535.68,70.0,6.14,63.86,1471.82,testing,46,5
43,1471.82,70.0,5.89,64.11,1407.71,testing,46,5
44,1407.71,70.0,5.63,64.37,1343.34,testing,46,5
45,1343.34,70.0,5.37,64.63,1278.71,testing,46,5
46,1278.71,70.0,5.11,64.89,1213.82,testing,46,5
47,1213.82,70.0,4.86,65.14,1148.68,testing,46,5
48,1148.68,70.0,4.59,65.41,1083.27,testing,46,5
49,1083.27,70.0,4.33,65.67,1017.6,testing,46,5
50,1017.6,70.0,4.07,65.93,951.67,testing,46,5
51,951.67,70.0,3.81,66.19,885.48,testing,46,5
52,885.48,70.0,3.54,66.46,819.02,testing,46,5
53,819.02,70.0,3.28,66.72,752.3,testing,46,5
54,752.3,70.0,3.01,66.99,685.31,testing,46,5
55,685.31,70.0,2.74,67.26,618.05,testing,46,5
56,618.05,70.0,2.47,67.53,550.52,testing,46,5
57,550.52,70.0,2.2,67.8,482.72,testing,46,5
58,482.72,70.0,1.93,68.07,414.65,testing,46,5
59,414.65,70.0,1.66,68.34,346.31,testing,46,5
60,346.31,70.0,1.39,68.61,277.7,testing,46,5
61,277.7,70.0,1.11,68.89,208.81,testing,46,5
62,208.81,70.0,0.84,69.16,139.65,testing,46,5
63,139.65,70.0,0.56,69.44,70.21,testing,46,5
64,70.21,70.0,0.28,69.72,0.49,testing,46,5
65,0.49,70.0,0.0,70.0,-69.51,testing,46,5
0,5000.0,1333.0,36.0,1297.0,3703.0,Car,47,1
1,3703.0,1333.0,26.66,1306.34,2396.66,Car,47,1
2,2396.66,1333.0,17.26,1315.74,1080.92,Car,47,1
3,1080.92,1333.0,7.78,1325.22,-244.3,Car,47,1
0,180000.0,1331.44,594.0,737.44,179262.56,mortgage,47,2
1,179262.56,1331.44,591.57,739.87,178522.69,mortgage,47,2
2,178522.69,1331.44,589.12,742.32,177780.37,mortgage,47,2
3,177780.37,1575.74,586.68,989.06,176791.31,mortgage,47,2
4,176791.31,2664.44,583.41,2081.03,174710.28,mortgage,47,2
5,174710.28,2664.44,576.54,2087.9,172622.38,mortgage,47,2
6,172622.38,2664.44,569.65,2094.79,170527.59,mortgage,47,2
7,170527.59,2664.44,562.74,2101.7,168425.89,mortgage,47,2
8,168425.89,2664.44,555.81,2108.63,166317.26,mortgage,47,2
9,166317.26,2664.44,548.85,2115.59,164201.67,mortgage,47,2
10,164201.67,2664.44,541.87,2122.57,162079.1,mortgage,47,2
11,162079.1,2664.44,534.86,2129.58,159949.52,mortgage,47,2
12,159949.52,2664.44,527.83,2136.61,157812.91,mortgage,47,2
13,157812.91,2664.44,520.78,2143.66,155669.25,mortgage,47,2
14,155669.25,2664.44,513.71,2150.73,153518.52,mortgage,47,2
15,153518.52,2664.44,506.61,2157.83,151360.69,mortgage,47,2
16,151360.69,2664.44,499.49,2164.95,149195.74,mortgage,47,2
17,149195.74,2664.44,492.35,2172.09,147023.65,mortgage,47,2
18,147023.65,2664.44,485.18,2179.26,144844.39,mortgage,47,2
19,144844.39,2664.44,477.99,2186.45,142657.94,mortgage,47,2
20,142657.94,2664.44,470.77,2193.67,140464.27,mortgage,47,2
21,140464.27,2664.44,463.53,2200.91,138263.36,mortgage,47,2
22,138263.36,2664.44,456.27,2208.17,136055.19,mortgage,47,2
23,136055.19,2664.44,448.98,2215.46,133839.73,mortgage,47,2
24,133839.73,2664.44,441.67,2222.77,131616.96,mortgage,47,2
25,131616.96,2664.44,434.34,2230.1,129386.86,mortgage,47,2
26,129386.86,2664.44,426.98,2237.46,127149.4,mortgage,47,2
27,127149.4,2664.44,419.59,2244.85,124904.55,mortgage,47,2
28,124904.55,2664.44,412.19,2252.25,122652.3,mortgage,47,2
29,122652.3,2664.44,404.75,2259.69,120392.61,mortgage,47,2
30,120392.61,2664.44,397.3,2267.14,118125.47,mortgage,47,2
31,118125.47,2664.44,389.81,2274.63,115850.84,mortgage,47,2
32,115850.84,2664.44,382.31,2282.13,113568.71,mortgage,47,2
33,113568.71,2664.44,374.78,2289.66,111279.05,mortgage,47,2
34,111279.05,2664.44,367.22,2297.22,108981.83,mortgage,47,2
35,108981.83,2664.44,359.64,2304.8,106677.03,mortgage,47,2
36,106677.03,2664.44,352.03,2312.41,104364.62,mortgage,47,2
37,104364.62,2664.44,344.4,2320.04,102044.58,mortgage,47,2
38,102044.58,2664.44,336.75,2327.69,99716.89,mortgage,47,2
39,99716.89,2664.44,329.07,2335.37,97381.52,mortgage,47,2
40,97381.52,2664.44,321.36,2343.08,95038.44,mortgage,47,2
41,95038.44,2664.44,313.63,2350.81,92687.63,mortgage,47,2
42,92687.63,2664.44,305.87,2358.57,90329.06,mortgage,47,2
43,90329.06,2664.44,298.09,2366.35,87962.71,mortgage,47,2
44,87962.71,2664.44,290.28,2374.16,85588.55,mortgage,47,2
45,85588.55,2664.44,282.44,2382.0,83206.55,mortgage,47,2
46,83206.55,2664.44,274.58,2389.86,80816.69,mortgage,47,2
47,80816.69,2664.44,266.7,2397.74,78418.95,mortgage,47,2
48,78418.95,2664.44,258.78,2405.66,76013.29,mortgage,47,2
49,76013.29,2664.44,250.84,2413.6,73599.69,mortgage,47,2
50,73599.69,2664.44,242.88,2421.56,71178.13,mortgage,47,2
51,71178.13,2664.44,234.89,2429.55,68748.58,mortgage,47,2
52,68748.58,2664.44,226.87,2437.57,66311.01,mortgage,47,2
53,66311.01,2664.44,218.83,2445.61,63865.4,mortgage,47,2
54,63865.4,2664.44,210.76,2453.68,61411.72,mortgage,47,2
55,61411.72,2664.44,202.66,2461.78,58949.94,mortgage,47,2
56,58949.94,2664.44,194.53,2469.91,56480.03,mortgage,47,2
57,56480.03,2664.44,186.38,2478.06,54001.97,mortgage,47,2
58,54001.97,2664.44,178.21,2486.23,51515.74,mortgage,47,2
59,51515.74,2664.44,170.0,2494.44,49021.3,mortgage,47,2
60,49021.3,2664.44,161.77,2502.67,46518.63,mortgage,47,2
61,46518.63,2664.44,153.51,2510.93,44007.7,mortgage,47,2
62,44007.7,2664.44,145.23,2519.21,41488.49,mortgage,47,2
63,41488.49,2664.44,136.91,2527.53,38960.96,mortgage,47,2
64,38960.96,2664.44,128.57,2535.87,36425.09,mortgage,47,2
65,36425.09,2664.44,120.2,2544.24,33880.85,mortgage,47,2
66,33880.85,2664.44,111.81,2552.63,31328.22,mortgage,47,2
67,31328.22,2664.44,103.38,2561.06,28767.16,mortgage,47,2
68,28767.16,2664.44,94.93,2569.51,26197.65,mortgage,47,2
69,26197.65,2664.44,86.45,2577.99,23619.66,mortgage,47,2
70,23619.66,2664.44,77.94,2586.5,21033.16,mortgage,47,2
71,21033.16,2664.44,69.41,2595.03,18438.13,mortgage,47,2
72,18438.13,2664.44,60.85,2603.59,15834.54,mortgage,47,2
73,15834.54,2664.44,52.25,2612.19,13222.35,mortgage,47,2
74,13222.35,2664.44,43.63,2620.81,10601.54,mortgage,47,2
75,10601.54,2664.44,34.99,2629.45,7972.09,mortgage,47,2
76,7972.09,2664.44,26.31,2638.13,5333.96,mortgage,47,2
77,5333.96,2664.44,17.6,2646.84,2687.12,mortgage,47,2
78,2687.12,2664.44,8.87,2655.57,31.55,mortgage,47,2
79,31.55,2664.44,0.1,2664.34,-2632.79,mortgage,47,2
0,20000.0,191.04,108.0,83.04,19916.96,WellsFargo2,47,3
1,19916.96,191.04,107.55,83.49,19833.47,WellsFargo2,47,3
2,19833.47,191.04,107.1,83.94,19749.53,WellsFargo2,47,3
3,19749.53,191.04,106.65,84.39,19665.14,WellsFargo2,47,3
4,19665.14,191.04,106.19,84.85,19580.29,WellsFargo2,47,3
5,19580.29,191.04,105.73,85.31,19494.98,WellsFargo2,47,3
6,19494.98,191.04,105.27,85.77,19409.21,WellsFargo2,47,3
7,19409.21,191.04,104.81,86.23,19322.98,WellsFargo2,47,3
8,19322.98,191.04,104.34,86.7,19236.28,WellsFargo2,47,3
9,19236.28,191.04,103.88,87.16,19149.12,WellsFargo2,47,3
10,19149.12,191.04,103.41,87.63,19061.49,WellsFargo2,47,3
11,19061.49,191.04,102.93,88.11,18973.38,WellsFargo2,47,3
12,18973.38,191.04,102.46,88.58,18884.8,WellsFargo2,47,3
13,18884.8,191.04,101.98,89.06,18795.74,WellsFargo2,47,3
14,18795.74,191.04,101.5,89.54,18706.2,WellsFargo2,47,3
15,18706.2,191.04,101.01,90.03,18616.17,WellsFargo2,47,3
16,18616.17,191.04,100.53,90.51,18525.66,WellsFargo2,47,3
17,18525.66,191.04,100.04,91.0,18434.66,WellsFargo2,47,3
18,18434.66,191.04,99.55,91.49,18343.17,WellsFargo2,47,3
19,18343.17,191.04,99.05,91.99,18251.18,WellsFargo2,47,3
20,18251.18,191.04,98.56,92.48,18158.7,WellsFargo2,47,3
21,18158.7,191.04,98.06,92.98,18065.72,WellsFargo2,47,3
22,18065.72,191.04,97.55,93.49,17972.23,WellsFargo2,47,3
23,17972.23,191.04,97.05,93.99,17878.24,WellsFargo2,47,3
24,17878.24,191.04,96.54,94.5,17783.74,WellsFargo2,47,3
25,17783.74,191.04,96.03,95.01,17688.73,WellsFargo2,47,3
26,17688.73,191.04,95.52,95.52,17593.21,WellsFargo2,47,3
27,17593.21,191.04,95.0,96.04,17497.17,WellsFargo2,47,3
28,17497.17,191.04,94.48,96.56,17400.61,WellsFargo2,47,3
29,17400.61,191.04,93.96,97.08,17303.53,WellsFargo2,47,3
30,17303.53,191.04,93.44,97.6,17205.93,WellsFargo2,47,3
31,17205.93,191.04,92.91,98.13,17107.8,WellsFargo2,47,3
32,17107.8,191.04,92.38,98.66,17009.14,WellsFargo2,47,3
33,17009.14,191.04,91.85,99.19,16909.95,WellsFargo2,47,3
34,16909.95,191.04,91.31,99.73,16810.22,WellsFargo2,47,3
35,16810.22,191.04,90.78,100.26,16709.96,WellsFargo2,47,3
36,16709.96,191.04,90.23,100.81,16609.15,WellsFargo2,47,3
37,16609.15,191.04,89.69,101.35,16507.8,WellsFargo2,47,3
38,16507.8,191.04,89.14,101.9,16405.9,WellsFargo2,47,3
39,16405.9,191.04,88.59,102.45,16303.45,WellsFargo2,47,3
40,16303.45,191.04,88.04,103.0,16200.45,WellsFargo2,47,3
41,16200.45,191.04,87.48,103.56,16096.89,WellsFargo2,47,3
42,16096.89,191.04,86.92,104.12,15992.77,WellsFargo2,47,3
43,15992.77,191.04,86.36,104.68,15888.09,WellsFargo2,47,3
44,15888.09,191.04,85.8,105.24,15782.85,WellsFargo2,47,3
45,15782.85,191.04,85.23,105.81,15677.04,WellsFargo2,47,3
46,15677.04,191.04,84.66,106.38,15570.66,WellsFargo2,47,3
47,15570.66,191.04,84.08,106.96,15463.7,WellsFargo2,47,3
48,15463.7,191.04,83.5,107.54,15356.16,WellsFargo2,47,3
49,15356.16,191.04,82.92,108.12,15248.04,WellsFargo2,47,3
50,15248.04,191.04,82.34,108.7,15139.34,WellsFargo2,47,3
51,15139.34,191.04,81.75,109.29,15030.05,WellsFargo2,47,3
52,15030.05,191.04,81.16,109.88,14920.17,WellsFargo2,47,3
53,14920.17,191.04,80.57,110.47,14809.7,WellsFargo2,47,3
54,14809.7,191.04,79.97,111.07,14698.63,WellsFargo2,47,3
55,14698.63,191.04,79.37,111.67,14586.96,WellsFargo2,47,3
56,14586.96,191.04,78.77,112.27,14474.69,WellsFargo2,47,3
57,14474.69,191.04,78.16,112.88,14361.81,WellsFargo2,47,3
58,14361.81,191.04,77.55,113.49,14248.32,WellsFargo2,47,3
59,14248.32,191.04,76.94,114.1,14134.22,WellsFargo2,47,3
60,14134.22,191.04,76.32,114.72,14019.5,WellsFargo2,47,3
61,14019.5,191.04,75.71,115.33,13904.17,WellsFargo2,47,3
62,13904.17,191.04,75.08,115.96,13788.21,WellsFargo2,47,3
63,13788.21,191.04,74.46,116.58,13671.63,WellsFargo2,47,3
64,13671.63,191.04,73.83,117.21,13554.42,WellsFargo2,47,3
65,13554.42,191.04,73.19,117.85,13436.57,WellsFargo2,47,3
66,13436.57,191.04,72.56,118.48,13318.09,WellsFargo2,47,3
67,13318.09,191.04,71.92,119.12,13198.97,WellsFargo2,47,3
68,13198.97,191.04,71.27,119.77,13079.2,WellsFargo2,47,3
69,13079.2,191.04,70.63,120.41,12958.79,WellsFargo2,47,3
70,12958.79,191.04,69.98,121.06,12837.73,WellsFargo2,47,3
71,12837.73,191.04,69.32,121.72,12716.01,WellsFargo2,47,3
72,12716.01,191.04,68.67,122.37,12593.64,WellsFargo2,47,3
73,12593.64,191.04,68.01,123.03,12470.61,WellsFargo2,47,3
74,12470.61,191.04,67.34,123.7,12346.91,WellsFargo2,47,3
75,12346.91,191.04,66.67,124.37,12222.54,WellsFargo2,47,3
76,12222.54,191.04,66.0,125.04,12097.5,WellsFargo2,47,3
77,12097.5,191.04,65.33,125.71,11971.79,WellsFargo2,47,3
78,11971.79,191.04,64.65,126.39,11845.4,WellsFargo2,47,3
79,11845.4,2823.83,63.97,2759.86,9085.54,WellsFargo2,47,3
80,9085.54,2855.48,49.06,2806.42,6279.12,WellsFargo2,47,3
81,6279.12,2855.48,33.91,2821.57,3457.55,WellsFargo2,47,3
82,3457.55,2855.48,18.67,2836.81,620.74,WellsFargo2,47,3
83,620.74,2855.48,3.35,2852.13,-2231.39,WellsFargo2,47,3
0,4000.0,70.0,16.0,54.0,3946.0,testing,47,4
1,3946.0,70.0,15.78,54.22,3891.78,testing,47,4
2,3891.78,70.0,15.57,54.43,3837.35,testing,47,4
3,3837.35,70.0,15.35,54.65,3782.7,testing,47,4
4,3782.7,70.0,15.13,54.87,3727.83,testing,47,4
5,3727.83,70.0,14.91,55.09,3672.74,testing,47,4
6,3672.74,70.0,14.69,55.31,3617.43,testing,47,4
7,3617.43,70.0,14.47,55.53,3561.9,testing,47,4
8,3561.9,70.0,14.25,55.75,3506.15,testing,47,4
9,3506.15,70.0,14.02,55.98,3450.17,testing,47,4
10,3450.17,70.0,13.8,56.2,3393.97,testing,47,4
11,3393.97,70.0,13.58,56.42,3337.55,testing,47,4
12,3337.55,70.0,13.35,56.65,3280.9,testing,47,4
13,3280.9,70.0,13.12,56.88,3224.02,testing,47,4
14,3224.02,70.0,12.9,57.1,3166.92,testing,47,4
15,3166.92,70.0,12.67,57.33,3109.59,testing,47,4
16,3109.59,70.0,12.44,57.56,3052.03,testing,47,4
17,3052.03,70.0,12.21,57.79,2994.24,testing,47,4
18,2994.24,70.0,11.98,58.02,2936.22,testing,47,4
19,2936.22,70.0,11.74,58.26,2877.96,testing,47,4
20,2877.96,70.0,11.51,58.49,2819.47,testing,47,4
21,2819.47,70.0,11.28,58.72,2760.75,testing,47,4
22,2760.75,70.0,11.04,58.96,2701.79,testing,47,4
23,2701.79,70.0,10.81,59.19,2642.6,testing,47,4
24,2642.6,70.0,10.57,59.43,2583.17,testing,47,4
25,2583.17,70.0,10.33,59.67,2523.5,testing,47,4
26,2523.5,70.0,10.09,59.91,2463.59,testing,47,4
27,2463.59,70.0,9.85,60.15,2403.44,testing,47,4
28,2403.44,70.0,9.61,60.39,2343.05,testing,47,4
29,2343.05,70.0,9.37,60.63,2282.42,testing,47,4
30,2282.42,70.0,9.13,60.87,2221.55,testing,47,4
31,2221.55,70.0,8.89,61.11,2160.44,testing,47,4
32,2160.44,70.0,8.64,61.36,2099.08,testing,47,4
33,2099.08,70.0,8.4,61.6,2037.48,testing,47,4
34,2037.48,70.0,8.15,61.85,1975.63,testing,47,4
35,1975.63,70.0,7.9,62.1,1913.53,testing,47,4
36,1913.53,70.0,7.65,62.35,1851.18,testing,47,4
37,1851.18,70.0,7.4,62.6,1788.58,testing,47,4
38,1788.58,70.0,7.15,62.85,1725.73,testing,47,4
39,1725.73,70.0,6.9,63.1,1662.63,testing,47,4
40,1662.63,70.0,6.65,63.35,1599.28,testing,47,4
41,1599.28,70.0,6.4,63.6,1535.68,testing,47,4
42,1535.68,70.0,6.14,63.86,1471.82,testing,47,4
43,1471.82,70.0,5.89,64.11,1407.71,testing,47,4
44,1407.71,70.0,5.63,64.37,1343.34,testing,47,4
45,1343.34,70.0,5.37,64.63,1278.71,testing,47,4
46,1278.71,70.0,5.11,64.89,1213.82,testing,47,4
47,1213.82,70.0,4.86,65.14,1148.68,testing,47,4
48,1148.68,70.0,4.59,65.41,1083.27,testing,47,4
49,1083.27,70.0,4.33,65.67,1017.6,testing,47,4
50,1017.6,70.0,4.07,65.93,951.67,testing,47,4
51,951.67,70.0,3.81,66.19,885.48,testing,47,4
52,885.48,70.0,3.54,66.46,819.02,testing,47,4
53,819.02,70.0,3.28,66.72,752.3,testing,47,4
54,752.3,70.0,3.01,66.99,685.31,testing,47,4
55,685.31,70.0,2.74,67.26,618.05,testing,47,4
56,618.05,70.0,2.47,67.53,550.52,testing,47,4
57,550.52,70.0,2.2,67.8,482.72,testing,47,4
58,482.72,70.0,1.93,68.07,414.65,testing,47,4
59,414.65,70.0,1.66,68.34,346.31,testing,47,4
60,346.31,70.0,1.39,68.61,277.7,testing,47,4
61,277.7,70.0,1.11,68.89,208.81,testing,47,4
62,208.81,70.0,0.84,69.16,139.65,testing,47,4
63,139.65,70.0,0.56,69.44,70.21,testing,47,4
64,70.21,70.0,0.28,69.72,0.49,testing,47,4
65,0.49,70.0,0.0,70.0,-69.51,testing,47,4
0,8250.57,84.62,53.63,30.99,8219.58,WellsFargo1,47,5
1,8219.58,84.62,53.43,31.19,8188.39,WellsFargo1,47,5
2,8188.39,84.62,53.22,31.4,8156.99,WellsFargo1,47,5
3,8156.99,84.62,53.02,31.6,8125.39,WellsFargo1,47,5
4,8125.39,84.62,52.82,31.8,8093.59,WellsFargo1,47,5
5,8093.59,84.62,52.61,32.01,8061.58,WellsFargo1,47,5
6,8061.58,84.62,52.4,32.22,8029.36,WellsFargo1,47,5
7,8029.36,84.62,52.19,32.43,7996.93,WellsFargo1,47,5
8,7996.93,84.62,51.98,32.64,7964.29,WellsFargo1,47,5
9,7964.29,84.62,51.77,32.85,7931.44,WellsFargo1,47,5
10,7931.44,84.62,51.55,33.07,7898.37,WellsFargo1,47,5
11,7898.37,84.62,51.34,33.28,7865.09,WellsFargo1,47,5
12,7865.09,84.62,51.12,33.5,7831.59,WellsFargo1,47,5
13,7831.59,84.62,50.91,33.71,7797.88,WellsFargo1,47,5
14,7797.88,84.62,50.69,33.93,7763.95,WellsFargo1,47,5
15,7763.95,84.62,50.47,34.15,7729.8,WellsFargo1,47,5
16,7729.8,84.62,50.24,34.38,7695.42,WellsFargo1,47,5
17,7695.42,84.62,50.02,34.6,7660.82,WellsFargo1,47,5
18,7660.82,84.62,49.8,34.82,7626.0,WellsFargo1,47,5
19,7626.0,84.62,49.57,35.05,7590.95,WellsFargo1,47,5
20,7590.95,84.62,49.34,35.28,7555.67,WellsFargo1,47,5
21,7555.67,84.62,49.11,35.51,7520.16,WellsFargo1,47,5
22,7520.16,84.62,48.88,35.74,7484.42,WellsFargo1,47,5
23,7484.42,84.62,48.65,35.97,7448.45,WellsFargo1,47,5
24,7448.45,84.62,48.41,36.21,7412.24,WellsFargo1,47,5
25,7412.24,84.62,48.18,36.44,7375.8,WellsFargo1,47,5
26,7375.8,84.62,47.94,36.68,7339.12,WellsFargo1,47,5
27,7339.12,84.62,47.7,36.92,7302.2,WellsFargo1,47,5
28,7302.2,84.62,47.46,37.16,7265.04,WellsFargo1,47,5
29,7265.04,84.62,47.22,37.4,7227.64,WellsFargo1,47,5
30,7227.64,84.62,46.98,37.64,7190.0,WellsFargo1,47,5
31,7190.0,84.62,46.73,37.89,7152.11,WellsFargo1,47,5
32,7152.11,84.62,46.49,38.13,7113.98,WellsFargo1,47,5
33,7113.98,84.62,46.24,38.38,7075.6,WellsFargo1,47,5
34,7075.6,84.62,45.99,38.63,7036.97,WellsFargo1,47,5
35,7036.97,84.62,45.74,38.88,6998.09,WellsFargo1,47,5
36,6998.09,84.62,45.49,39.13,6958.96,WellsFargo1,47,5
37,6958.96,84.62,45.23,39.39,6919.57,WellsFargo1,47,5
38,6919.57,84.62,44.98,39.64,6879.93,WellsFargo1,47,5
39,6879.93,84.62,44.72,39.9,6840.03,WellsFargo1,47,5
40,6840.03,84.62,44.46,40.16,6799.87,WellsFargo1,47,5
41,6799.87,84.62,44.2,40.42,6759.45,WellsFargo1,47,5
42,6759.45,84.62,43.94,40.68,6718.77,WellsFargo1,47,5
43,6718.77,84.62,43.67,40.95,6677.82,WellsFargo1,47,5
44,6677.82,84.62,43.41,41.21,6636.61,WellsFargo1,47,5
45,6636.61,84.62,43.14,41.48,6595.13,WellsFargo1,47,5
46,6595.13,84.62,42.87,41.75,6553.38,WellsFargo1,47,5
47,6553.38,84.62,42.6,42.02,6511.36,WellsFargo1,47,5
48,6511.36,84.62,42.32,42.3,6469.06,WellsFargo1,47,5
49,6469.06,84.62,42.05,42.57,6426.49,WellsFargo1,47,5
50,6426.49,84.62,41.77,42.85,6383.64,WellsFargo1,47,5
51,6383.64,84.62,41.49,43.13,6340.51,WellsFargo1,47,5
52,6340.51,84.62,41.21,43.41,6297.1,WellsFargo1,47,5
53,6297.1,84.62,40.93,43.69,6253.41,WellsFargo1,47,5
54,6253.41,84.62,40.65,43.97,6209.44,WellsFargo1,47,5
55,6209.44,84.62,40.36,44.26,6165.18,WellsFargo1,47,5
56,6165.18,84.62,40.07,44.55,6120.63,WellsFargo1,47,5
57,6120.63,84.62,39.78,44.84,6075.79,WellsFargo1,47,5
58,6075.79,84.62,39.49,45.13,6030.66,WellsFargo1,47,5
59,6030.66,84.62,39.2,45.42,5985.24,WellsFargo1,47,5
60,5985.24,84.62,38.9,45.72,5939.52,WellsFargo1,47,5
61,5939.52,84.62,38.61,46.01,5893.51,WellsFargo1,47,5
62,5893.51,84.62,38.31,46.31,5847.2,WellsFargo1,47,5
63,5847.2,84.62,38.01,46.61,5800.59,WellsFargo1,47,5
64,5800.59,84.62,37.7,46.92,5753.67,WellsFargo1,47,5
65,5753.67,154.13,37.4,116.73,5636.94,WellsFargo1,47,5
66,5636.94,3010.1,36.64,2973.46,2663.48,WellsFargo1,47,5
67,2663.48,3010.1,17.31,2992.79,-329.31,WellsFargo1,47,5
0,5000.0,1333.0,36.0,1297.0,3703.0,Car,48,1
1,3703.0,1333.0,26.66,1306.34,2396.66,Car,48,1
2,2396.66,1333.0,17.26,1315.74,1080.92,Car,48,1
3,1080.92,1333.0,7.78,1325.22,-244.3,Car,48,1
0,180000.0,1331.44,594.0,737.44,179262.56,mortgage,48,2
1,179262.56,1331.44,591.57,739.87,178522.69,mortgage,48,2
2,178522.69,1331.44,589.12,742.32,177780.37,mortgage,48,2
3,177780.37,1575.74,586.68,989.06,176791.31,mortgage,48,2
4,176791.31,2664.44,583.41,2081.03,174710.28,mortgage,48,2
5,174710.28,2664.44,576.54,2087.9,172622.38,mortgage,48,2
6,172622.38,2664.44,569.65,2094.79,170527.59,mortgage,48,2
7,170527.59,2664.44,562.74,2101.7,168425.89,mortgage,48,2
8,168425.89,2664.44,555.81,2108.63,166317.26,mortgage,48,2
9,166317.26,2664.44,548.85,2115.59,164201.67,mortgage,48,2
10,164201.67,2664.44,541.87,2122.57,162079.1,mortgage,48,2
11,162079.1,2664.44,534.86,2129.58,159949.52,mortgage,48,2
12,159949.52,2664.44,527.83,2136.61,157812.91,mortgage,48,2
13,157812.91,2664.44,520.78,2143.66,155669.25,mortgage,48,2
14,155669.25,2664.44,513.71,2150.73,153518.52,mortgage,48,2
15,153518.52,2664.44,506.61,2157.83,151360.69,mortgage,48,2
16,151360.69,2664.44,499.49,2164.95,149195.74,mortgage,48,2
17,149195.74,2664.44,492.35,2172.09,147023.65,mortgage,48,2
18,147023.65,2664.44,485.18,2179.26,144844.39,mortgage,48,2
19,144844.39,2664.44,477.99,2186.45,142657.94,mortgage,48,2
20,142657.94,2664.44,470.77,2193.67,140464.27,mortgage,48,2
21,140464.27,2664.44,463.53,2200.91,138263.36,mortgage,48,2
22,138263.36,2664.44,456.27,2208.17,136055.19,mortgage,48,2
23,136055.19,2664.44,448.98,2215.46,133839.73,mortgage,48,2
24,133839.73,2664.44,441.67,2222.77,131616.96,mortgage,48,2
25,131616.96,2664.44,434.34,2230.1,129386.86,mortgage,48,2
26,129386.86,2664.44,426.98,2237.46,127149.4,mortgage,48,2
27,127149.4,2664.44,419.59,2244.85,124904.55,mortgage,48,2
28,124904.55,2664.44,412.19,2252.25,122652.3,mortgage,48,2
29,122652.3,2664.44,404.75,2259.69,120392.61,mortgage,48,2
30,120392.61,2664.44,397.3,2267.14,118125.47,mortgage,48,2
31,118125.47,2664.44,389.81,2274.63,115850.84,mortgage,48,2
32,115850.84,2664.44,382.31,2282.13,113568.71,mortgage,48,2
33,113568.71,2664.44,374.78,2289.66,111279.05,mortgage,48,2
34,111279.05,2664.44,367.22,2297.22,108981.83,mortgage,48,2
35,108981.83,2664.44,359.64,2304.8,106677.03,mortgage,48,2
36,106677.03,2664.44,352.03,2312.41,104364.62,mortgage,48,2
37,104364.62,2664.44,344.4,2320.04,102044.58,mortgage,48,2
38,102044.58,2664.44,336.75,2327.69,99716.89,mortgage,48,2
39,99716.89,2664.44,329.07,2335.37,97381.52,mortgage,48,2
40,97381.52,2664.44,321.36,2343.08,95038.44,mortgage,48,2
41,95038.44,2664.44,313.63,2350.81,92687.63,mortgage,48,2
42,92687.63,2664.44,305.87,2358.57,90329.06,mortgage,48,2
43,90329.06,2664.44,298.09,2366.35,87962.71,mortgage,48,2
44,87962.71,2664.44,290.28,2374.16,85588.55,mortgage,48,2
45,85588.55,2664.44,282.44,2382.0,83206.55,mortgage,48,2
46,83206.55,2664.44,274.58,2389.86,80816.69,mortgage,48,2
47,80816.69,2664.44,266.7,2397.74,78418.95,mortgage,48,2
48,78418.95,2664.44,258.78,2405.66,76013.29,mortgage,48,2
49,76013.29,2664.44,250.84,2413.6,73599.69,mortgage,48,2
50,73599.69,2664.44,242.88,2421.56,71178.13,mortgage,48,2
51,71178.13,2664.44,234.89,2429.55,68748.58,mortgage,48,2
52,68748.58,2664.44,226.87,2437.57,66311.01,mortgage,48,2
53,66311.01,2664.44,218.83,2445.61,63865.4,mortgage,48,2
54,63865.4,2664.44,210.76,2453.68,61411.72,mortgage,48,2
55,61411.72,2664.44,202.66,2461.78,58949.94,mortgage,48,2
56,58949.94,2664.44,194.53,2469.91,56480.03,mortgage,48,2
57,56480.03,2664.44,186.38,2478.06,54001.97,mortgage,48,2
58,54001.97,2664.44,178.21,2486.23,51515.74,mortgage,48,2
59,51515.74,2664.44,170.0,2494.44,49021.3,mortgage,48,2
60,49021.3,2664.44,161.77,2502.67,46518.63,mortgage,48,2
61,46518.63,2664.44,153.51,2510.93,44007.7,mortgage,48,2
62,44007.7,2664.44,145.23,2519.21,41488.49,mortgage,48,2
63,41488.49,2664.44,136.91,2527.53,38960.96,mortgage,48,2
64,38960.96,2664.44,128.57,2535.87,36425.09,mortgage,48,2
65,36425.09,2664.44,120.2,2544.24,33880.85,mortgage,48,2
66,33880.85,2664.44,111.81,2552.63,31328.22,mortgage,48,2
67,31328.22,2664.44,103.38,2561.06,28767.16,mortgage,48,2
68,28767.16,2664.44,94.93,2569.51,26197.65,mortgage,48,2
69,26197.65,2664.44,86.45,2577.99,23619.66,mortgage,48,2
70,23619.66,2664.44,77.94,2586.5,21033.16,mortgage,48,2
71,21033.16,2664.44,69.41,2595.03,18438.13,mortgage,48,2
72,18438.13,2664.44,60.85,2603.59,15834.54,mortgage,48,2
73,15834.54,2664.44,52.25,2612.19,13222.35,mortgage,48,2
74,13222.35,2664.44,43.63,2620.81,10601.54,mortgage,48,2
75,10601.54,2664.44,34.99,2629.45,7972.09,mortgage,48,2
76,7972.09,2664.44,26.31,2638.13,5333.96,mortgage,48,2
77,5333.96,2664.44,17.6,2646.84,2687.12,mortgage,48,2
78,2687.12,2664.44,8.87,2655.57,31.55,mortgage,48,2
79,31.55,2664.44,0.1,2664.34,-2632.79,mortgage,48,2
0,20000.0,191.04,108.0,83.04,19916.96,WellsFargo2,48,3
1,19916.96,191.04,107.55,83.49,19833.47,WellsFargo2,48,3
2,19833.47,191.04,107.1,83.94,19749.53,WellsFargo2,48,3
3,19749.53,191.04,106.65,84.39,19665.14,WellsFargo2,48,3
4,19665.14,191.04,106.19,84.85,19580.29,WellsFargo2,48,3
5,19580.29,191.04,105.73,85.31,19494.98,WellsFargo2,48,3
6,19494.98,191.04,105.27,85.77,19409.21,WellsFargo2,48,3
7,19409.21,191.04,104.81,86.23,19322.98,WellsFargo2,48,3
8,19322.98,191.04,104.34,86.7,19236.28,WellsFargo2,48,3
9,19236.28,191.04,103.88,87.16,19149.12,WellsFargo2,48,3
10,19149.12,191.04,103.41,87.63,19061.49,WellsFargo2,48,3
11,19061.49,191.04,102.93,88.11,18973.38,WellsFargo2,48,3
12,18973.38,191.04,102.46,88.58,18884.8,WellsFargo2,48,3
13,18884.8,191.04,101.98,89.06,18795.74,WellsFargo2,48,3
14,18795.74,191.04,101.5,89.54,18706.2,WellsFargo2,48,3
15,18706.2,191.04,101.01,90.03,18616.17,WellsFargo2,48,3
16,18616.17,191.04,100.53,90.51,18525.66,WellsFargo2,48,3
17,18525.66,191.04,100.04,91.0,18434.66,WellsFargo2,48,3
18,18434.66,191.04,99.55,91.49,18343.17,WellsFargo2,48,3
19,18343.17,191.04,99.05,91.99,18251.18,WellsFargo2,48,3
20,18251.18,191.04,98.56,92.48,18158.7,WellsFargo2,48,3
21,18158.7,191.04,98.06,92.98,18065.72,WellsFargo2,48,3
22,18065.72,191.04,97.55,93.49,17972.23,WellsFargo2,48,3
23,17972.23,191.04,97.05,93.99,17878.24,WellsFargo2,48,3
24,17878.24,191.04,96.54,94.5,17783.74,WellsFargo2,48,3
25,17783.74,191.04,96.03,95.01,17688.73,WellsFargo2,48,3
26,17688.73,191.04,95.52,95.52,17593.21,WellsFargo2,48,3
27,17593.21,191.04,95.0,96.04,17497.17,WellsFargo2,48,3
28,17497.17,191.04,94.48,96.56,17400.61,WellsFargo2,48,3
29,17400.61,191.04,93.96,97.08,17303.53,WellsFargo2,48,3
30,17303.53,191.04,93.44,97.6,17205.93,WellsFargo2,48,3
31,17205.93,191.04,92.91,98.13,17107.8,WellsFargo2,48,3
32,17107.8,191.04,92.38,98.66,17009.14,WellsFargo2,48,3
33,17009.14,191.04,91.85,99.19,16909.95,WellsFargo2,48,3
34,16909.95,191.04,91.31,99.73,16810.22,WellsFargo2,48,3
35,16810.22,191.04,90.78,100.26,16709.96,WellsFargo2,48,3
36,16709.96,191.04,90.23,100.81,16609.15,WellsFargo2,48,3
37,16609.15,191.04,89.69,101.35,16507.8,WellsFargo2,48,3
38,16507.8,191.04,89.14,101.9,16405.9,WellsFargo2,48,3
39,16405.9,191.04,88.59,102.45,16303.45,WellsFargo2,48,3
40,16303.45,191.04,88.04,103.0,16200.45,WellsFargo2,48,3
41,16200.45,191.04,87.48,103.56,16096.89,WellsFargo2,48,3
42,16096.89,191.04,86.92,104.12,15992.77,WellsFargo2,48,3
43,15992.77,191.04,86.36,104.68,15888.09,WellsFargo2,48,3
44,15888.09,191.04,85.8,105.24,15782.85,WellsFargo2,48,3
45,15782.85,191.04,85.23,105.81,15677.04,WellsFargo2,48,3
46,15677.04,191.04,84.66,106.38,15570.66,WellsFargo2,48,3
47,15570.66,191.04,84.08,106.96,15463.7,WellsFargo2,48,3
48,15463.7,191.04,83.5,107.54,15356.16,WellsFargo2,48,3
49,15356.16,191.04,82.92,108.12,15248.04,WellsFargo2,48,3
50,15248.04,191.04,82.34,108.7,15139.34,WellsFargo2,48,3
51,15139.34,191.04,81.75,109.29,15030.05,WellsFargo2,48,3
52,15030.05,191.04,81.16,109.88,14920.17,WellsFargo2,48,3
53,14920.17,191.04,80.57,110.47,14809.7,WellsFargo2,48,3
54,14809.7,191.04,79.97,111.07,14698.63,WellsFargo2,48,3
55,14698.63,191.04,79.37,111.67,14586.96,WellsFargo2,48,3
56,14586.96,191.04,78.77,112.27,14474.69,WellsFargo2,48,3
57,14474.69,191.04,78.16,112.88,14361.81,WellsFargo2,48,3
58,14361.81,191.04,77.55,113.49,14248.32,WellsFargo2,48,3
59,14248.32,191.04,76.94,114.1,14134.22,WellsFargo2,48,3
60,14134.22,191.04,76.32,114.72,14019.5,WellsFargo2,48,3
61,14019.5,191.04,75.71,115.33,13904.17,WellsFargo2,48,3
62,13904.17,191.04,75.08,115.96,13788.21,WellsFargo2,48,3
63,13788.21,191.04,74.46,116.58,13671.63,WellsFargo2,48,3
64,13671.63,191.04,73.83,117.21,13554.42,WellsFargo2,48,3
65,13554.42,191.04,73.19,117.85,13436.57,WellsFargo2,48,3
66,13436.57,191.04,72.56,118.48,13318.09,WellsFargo2,48,3
67,13318.09,191.04,71.92,119.12,13198.97,WellsFargo2,48,3
68,13198.97,191.04,71.27,119.77,13079.2,WellsFargo2,48,3
69,13079.2,191.04,70.63,120.41,12958.79,WellsFargo2,48,3
70,12958.79,191.04,69.98,121.06,12837.73,WellsFargo2,48,3
71,12837.73,191.04,69.32,121.72,12716.01,WellsFargo2,48,3
72,12716.01,191.04,68.67,122.37,12593.64,WellsFargo2,48,3
73,12593.64,191.04,68.01,123.03,12470.61,WellsFargo2,48,3
74,12470.61,191.04,67.34,123.7,12346.91,WellsFargo2,48,3
75,12346.91,191.04,66.67,124.37,12222.54,WellsFargo2,48,3
76,12222.54,191.04,66.0,125.04,12097.5,WellsFargo2,48,3
77,12097.5,191.04,65.33,125.71,11971.79,WellsFargo2,48,3
78,11971.79,191.04,64.65,126.39,11845.4,WellsFargo2,48,3
79,11845.4,2823.83,63.97,2759.86,9085.54,WellsFargo2,48,3
80,9085.54,2855.48,49.06,2806.42,6279.12,WellsFargo2,48,3
81,6279.12,2855.48,33.91,2821.57,3457.55,WellsFargo2,48,3
82,3457.55,2855.48,18.67,2836.81,620.74,WellsFargo2,48,3
83,620.74,2855.48,3.35,2852.13,-2231.39,WellsFargo2,48,3
0,8250.57,84.62,53.63,30.99,8219.58,WellsFargo1,48,4
1,8219.58,84.62,53.43,31.19,8188.39,WellsFargo1,48,4
2,8188.39,84.62,53.22,31.4,8156.99,WellsFargo1,48,4
3,8156.99,84.62,53.02,31.6,8125.39,WellsFargo1,48,4
4,8125.39,84.62,52.82,31.8,8093.59,WellsFargo1,48,4
5,8093.59,84.62,52.61,32.01,8061.58,WellsFargo1,48,4
6,8061.58,84.62,52.4,32.22,8029.36,WellsFargo1,48,4
7,8029.36,84.62,52.19,32.43,7996.93,WellsFargo1,48,4
8,7996.93,84.62,51.98,32.64,7964.29,WellsFargo1,48,4
9,7964.29,84.62,51.77,32.85,7931.44,WellsFargo1,48,4
10,7931.44,84.62,51.55,33.07,7898.37,WellsFargo1,48,4
11,7898.37,84.62,51.34,33.28,7865.09,WellsFargo1,48,4
12,7865.09,84.62,51.12,33.5,7831.59,WellsFargo1,48,4
13,7831.59,84.62,50.91,33.71,7797.88,WellsFargo1,48,4
14,7797.88,84.62,50.69,33.93,7763.95,WellsFargo1,48,4
15,7763.95,84.62,50.47,34.15,7729.8,WellsFargo1,48,4
16,7729.8,84.62,50.24,34.38,7695.42,WellsFargo1,48,4
17,7695.42,84.62,50.02,34.6,7660.82,WellsFargo1,48,4
18,7660.82,84.62,49.8,34.82,7626.0,WellsFargo1,48,4
19,7626.0,84.62,49.57,35.05,7590.95,WellsFargo1,48,4
20,7590.95,84.62,49.34,35.28,7555.67,WellsFargo1,48,4
21,7555.67,84.62,49.11,35.51,7520.16,WellsFargo1,48,4
22,7520.16,84.62,48.88,35.74,7484.42,WellsFargo1,48,4
23,7484.42,84.62,48.65,35.97,7448.45,WellsFargo1,48,4
24,7448.45,84.62,48.41,36.21,7412.24,WellsFargo1,48,4
25,7412.24,84.62,48.18,36.44,7375.8,WellsFargo1,48,4
26,7375.8,84.62,47.94,36.68,7339.12,WellsFargo1,48,4
27,7339.12,84.62,47.7,36.92,7302.2,WellsFargo1,48,4
28,7302.2,84.62,47.46,37.16,7265.04,WellsFargo1,48,4
29,7265.04,84.62,47.22,37.4,7227.64,WellsFargo1,48,4
30,7227.64,84.62,46.98,37.64,7190.0,WellsFargo1,48,4
31,7190.0,84.62,46.73,37.89,7152.11,WellsFargo1,48,4
32,7152.11,84.62,46.49,38.13,7113.98,WellsFargo1,48,4
33,7113.98,84.62,46.24,38.38,7075.6,WellsFargo1,48,4
34,7075.6,84.62,45.99,38.63,7036.97,WellsFargo1,48,4
35,7036.97,84.62,45.74,38.88,6998.09,WellsFargo1,48,4
36,6998.09,84.62,45.49,39.13,6958.96,WellsFargo1,48,4
37,6958.96,84.62,45.23,39.39,6919.57,WellsFargo1,48,4
38,6919.57,84.62,44.98,39.64,6879.93,WellsFargo1,48,4
39,6879.93,84.62,44.72,39.9,6840.03,WellsFargo1,48,4
40,6840.03,84.62,44.46,40.16,6799.87,WellsFargo1,48,4
41,6799.87,84.62,44.2,40.42,6759.45,WellsFargo1,48,4
42,6759.45,84.62,43.94,40.68,6718.77,WellsFargo1,48,4
43,6718.77,84.62,43.67,40.95,6677.82,WellsFargo1,48,4
44,6677.82,84.62,43.41,41.21,6636.61,WellsFargo1,48,4
45,6636.61,84.62,43.14,41.48,6595.13,WellsFargo1,48,4
46,6595.13,84.62,42.87,41.75,6553.38,WellsFargo1,48,4
47,6553.38,84.62,42.6,42.02,6511.36,WellsFargo1,48,4
48,6511.36,84.62,42.32,42.3,6469.06,WellsFargo1,48,4
49,6469.06,84.62,42.05,42.57,6426.49,WellsFargo1,48,4
50,6426.49,84.62,41.77,42.85,6383.64,WellsFargo1,48,4
51,6383.64,84.62,41.49,43.13,6340.51,WellsFargo1,48,4
52,6340.51,84.62,41.21,43.41,6297.1,WellsFargo1,48,4
53,6297.1,84.62,40.93,43.69,6253.41,WellsFargo1,48,4
54,6253.41,84.62,40.65,43.97,6209.44,WellsFargo1,48,4
55,6209.44,84.62,40.36,44.26,6165.18,WellsFargo1,48,4
56,6165.18,84.62,40.07,44.55,6120.63,WellsFargo1,48,4
57,6120.63,84.62,39.78,44.84,6075.79,WellsFargo1,48,4
58,6075.79,84.62,39.49,45.13,6030.66,WellsFargo1,48,4
59,6030.66,84.62,39.2,45.42,5985.24,WellsFargo1,48,4
60,5985.24,84.62,38.9,45.72,5939.52,WellsFargo1,48,4
61,5939.52,84.62,38.61,46.01,5893.51,WellsFargo1,48,4
62,5893.51,84.62,38.31,46.31,5847.2,WellsFargo1,48,4
63,5847.2,84.62,38.01,46.61,5800.59,WellsFargo1,48,4
64,5800.59,84.62,37.7,46.92,5753.67,WellsFargo1,48,4
65,5753.67,84.62,37.4,47.22,5706.45,WellsFargo1,48,4
66,5706.45,84.62,37.09,47.53,5658.92,WellsFargo1,48,4
67,5658.92,84.62,36.78,47.84,5611.08,WellsFargo1,48,4
68,5611.08,84.62,36.47,48.15,5562.93,WellsFargo1,48,4
69,5562.93,84.62,36.16,48.46,5514.47,WellsFargo1,48,4
70,5514.47,84.62,35.84,48.78,5465.69,WellsFargo1,48,4
71,5465.69,84.62,35.53,49.09,5416.6,WellsFargo1,48,4
72,5416.6,84.62,35.21,49.41,5367.19,WellsFargo1,48,4
73,5367.19,84.62,34.89,49.73,5317.46,WellsFargo1,48,4
74,5317.46,84.62,34.56,50.06,5267.4,WellsFargo1,48,4
75,5267.4,84.62,34.24,50.38,5217.02,WellsFargo1,48,4
76,5217.02,84.62,33.91,50.71,5166.31,WellsFargo1,48,4
77,5166.31,84.62,33.58,51.04,5115.27,WellsFargo1,48,4
78,5115.27,84.62,33.25,51.37,5063.9,WellsFargo1,48,4
79,5063.9,84.62,32.92,51.7,5012.2,WellsFargo1,48,4
80,5012.2,84.62,32.58,52.04,4960.16,WellsFargo1,48,4
81,4960.16,84.62,32.24,52.38,4907.78,WellsFargo1,48,4
82,4907.78,84.62,31.9,52.72,4855.06,WellsFargo1,48,4
83,4855.06,2316.01,31.56,2284.45,2570.61,WellsFargo1,48,4
84,2570.61,2940.1,16.71,2923.39,-352.78,WellsFargo1,48,4
0,4000.0,70.0,16.0,54.0,3946.0,testing,48,5
1,3946.0,70.0,15.78,54.22,3891.78,testing,48,5
2,3891.78,70.0,15.57,54.43,3837.35,testing,48,5
3,3837.35,70.0,15.35,54.65,3782.7,testing,48,5
4,3782.7,70.0,15.13,54.87,3727.83,testing,48,5
5,3727.83,70.0,14.91,55.09,3672.74,testing,48,5
6,3672.74,70.0,14.69,55.31,3617.43,testing,48,5
7,3617.43,70.0,14.47,55.53,3561.9,testing,48,5
8,3561.9,70.0,14.25,55.75,3506.15,testing,48,5
9,3506.15,70.0,14.02,55.98,3450.17,testing,48,5
10,3450.17,70.0,13.8,56.2,3393.97,testing,48,5
11,3393.97,70.0,13.58,56.42,3337.55,testing,48,5
12,3337.55,70.0,13.35,56.65,3280.9,testing,48,5
13,3280.9,70.0,13.12,56.88,3224.02,testing,48,5
14,3224.02,70.0,12.9,57.1,3166.92,testing,48,5
15,3166.92,70.0,12.67,57.33,3109.59,testing,48,5
16,3109.59,70.0,12.44,57.56,3052.03,testing,48,5
17,3052.03,70.0,12.21,57.79,2994.24,testing,48,5
18,2994.24,70.0,11.98,58.02,2936.22,testing,48,5
19,2936.22,70.0,11.74,58.26,2877.96,testing,48,5
20,2877.96,70.0,11.51,58.49,2819.47,testing,48,5
21,2819.47,70.0,11.28,58.72,2760.75,testing,48,5
22,2760.75,70.0,11.04,58.96,2701.79,testing,48,5
23,2701.79,70.0,10.81,59.19,2642.6,testing,48,5
24,2642.6,70.0,10.57,59.43,2583.17,testing,48,5
25,2583.17,70.0,10.33,59.67,2523.5,testing,48,5
26,2523.5,70.0,10.09,59.91,2463.59,testing,48,5
27,2463.59,70.0,9.85,60.15,2403.44,testing,48,5
28,2403.44,70.0,9.61,60.39,2343.05,testing,48,5
29,2343.05,70.0,9.37,60.63,2282.42,testing,48,5
30,2282.42,70.0,9.13,60.87,2221.55,testing,48,5
31,2221.55,70.0,8.89,61.11,2160.44,testing,48,5
32,2160.44,70.0,8.64,61.36,2099.08,testing,48,5
33,2099.08,70.0,8.4,61.6,2037.48,testing,48,5
34,2037.48,70.0,8.15,61.85,1975.63,testing,48,5
35,1975.63,70.0,7.9,62.1,1913.53,testing,48,5
36,1913.53,70.0,7.65,62.35,1851.18,testing,48,5
37,1851.18,70.0,7.4,62.6,1788.58,testing,48,5
38,1788.58,70.0,7.15,62.85,1725.73,testing,48,5
39,1725.73,70.0,6.9,63.1,1662.63,testing,48,5
40,1662.63,70.0,6.65,63.35,1599.28,testing,48,5
41,1599.28,70.0,6.4,63.6,1535.68,testing,48,5
42,1535.68,70.0,6.14,63.86,1471.82,testing,48,5
43,1471.82,70.0,5.89,64.11,1407.71,testing,48,5
44,1407.71,70.0,5.63,64.37,1343.34,testing,48,5
45,1343.34,70.0,5.37,64.63,1278.71,testing,48,5
46,1278.71,70.0,5.11,64.89,1213.82,testing,48,5
47,1213.82,70.0,4.86,65.14,1148.68,testing,48,5
48,1148.68,70.0,4.59,65.41,1083.27,testing,48,5
49,1083.27,70.0,4.33,65.67,1017.6,testing,48,5
50,1017.6,70.0,4.07,65.93,951.67,testing,48,5
51,951.67,70.0,3.81,66.19,885.48,testing,48,5
52,885.48,70.0,3.54,66.46,819.02,testing,48,5
53,819.02,70.0,3.28,66.72,752.3,testing,48,5
54,752.3,70.0,3.01,66.99,685.31,testing,48,5
55,685.31,70.0,2.74,67.26,618.05,testing,48,5
56,618.05,70.0,2.47,67.53,550.52,testing,48,5
57,550.52,70.0,2.2,67.8,482.72,testing,48,5
58,482.72,70.0,1.93,68.07,414.65,testing,48,5
59,414.65,70.0,1.66,68.34,346.31,testing,48,5
60,346.31,70.0,1.39,68.61,277.7,testing,48,5
61,277.7,70.0,1.11,68.89,208.81,testing,48,5
62,208.81,70.0,0.84,69.16,139.65,testing,48,5
63,139.65,70.0,0.56,69.44,70.21,testing,48,5
64,70.21,70.0,0.28,69.72,0.49,testing,48,5
65,0.49,70.0,0.0,70.0,-69.51,testing,48,5
0,8250.57,1084.62,53.63,1030.99,7219.58,WellsFargo1,49,1
1,7219.58,1084.62,46.93,1037.69,6181.89,WellsFargo1,49,1
2,6181.89,1084.62,40.18,1044.44,5137.45,WellsFargo1,49,1
3,5137.45,1084.62,33.39,1051.23,4086.22,WellsFargo1,49,1
4,4086.22,1084.62,26.56,1058.06,3028.16,WellsFargo1,49,1
5,3028.16,1084.62,19.68,1064.94,1963.22,WellsFargo1,49,1
6,1963.22,1084.62,12.76,1071.86,891.36,WellsFargo1,49,1
7,891.36,1084.62,5.79,1078.83,-187.47,WellsFargo1,49,1
0,4000.0,70.0,16.0,54.0,3946.0,testing,49,2
1,3946.0,70.0,15.78,54.22,3891.78,testing,49,2
2,3891.78,70.0,15.57,54.43,3837.35,testing,49,2
3,3837.35,70.0,15.35,54.65,3782.7,testing,49,2
4,3782.7,70.0,15.13,54.87,3727.83,testing,49,2
5,3727.83,70.0,14.91,55.09,3672.74,testing,49,2
6,3672.74,70.0,14.69,55.31,3617.43,testing,49,2
7,3617.43,257.47,14.47,243.0,3374.43,testing,49,2
8,3374.43,1154.62,13.5,1141.12,2233.31,testing,49,2
9,2233.31,1154.62,8.93,1145.69,1087.62,testing,49,2
10,1087.62,1154.62,4.35,1150.27,-62.65,testing,49,2
0,5000.0,333.0,36.0,297.0,4703.0,Car,49,3
1,4703.0,333.0,33.86,299.14,4403.86,Car,49,3
2,4403.86,333.0,31.71,301.29,4102.57,Car,49,3
3,4102.57,333.0,29.54,303.46,3799.11,Car,49,3
4,3799.11,333.0,27.35,305.65,3493.46,Car,49,3
5,3493.46,333.0,25.15,307.85,3185.61,Car,49,3
6,3185.61,333.0,22.94,310.06,2875.55,Car,49,3
7,2875.55,333.0,20.7,312.3,2563.25,Car,49,3
8,2563.25,333.0,18.46,314.54,2248.71,Car,49,3
9,2248.71,333.0,16.19,316.81,1931.9,Car,49,3
10,1931.9,395.65,13.91,381.74,1550.16,Car,49,3
11,1550.16,1487.62,11.16,1476.46,73.7,Car,49,3
12,73.7,1487.62,0.53,1487.09,-1413.39,Car,49,3
0,20000.0,191.04,108.0,83.04,19916.96,WellsFargo2,49,4
1,19916.96,191.04,107.55,83.49,19833.47,WellsFargo2,49,4
2,19833.47,191.04,107.1,83.94,19749.53,WellsFargo2,49,4
3,19749.53,191.04,106.65,84.39,19665.14,WellsFargo2,49,4
4,19665.14,191.04,106.19,84.85,19580.29,WellsFargo2,49,4
5,19580.29,191.04,105.73,85.31,19494.98,WellsFargo2,49,4
6,19494.98,191.04,105.27,85.77,19409.21,WellsFargo2,49,4
7,19409.21,191.04,104.81,86.23,19322.98,WellsFargo2,49,4
8,19322.98,191.04,104.34,86.7,19236.28,WellsFargo2,49,4
9,19236.28,191.04,103.88,87.16,19149.12,WellsFargo2,49,4
10,19149.12,191.04,103.41,87.63,19061.49,WellsFargo2,49,4
11,19061.49,191.04,102.93,88.11,18973.38,WellsFargo2,49,4
12,18973.38,1604.43,102.46,1501.97,17471.41,WellsFargo2,49,4
13,17471.41,1678.66,94.35,1584.31,15887.1,WellsFargo2,49,4
14,15887.1,1678.66,85.79,1592.87,14294.23,WellsFargo2,49,4
15,14294.23,1678.66,77.19,1601.47,12692.76,WellsFargo2,49,4
16,12692.76,1678.66,68.54,1610.12,11082.64,WellsFargo2,49,4
17,11082.64,1678.66,59.85,1618.81,9463.83,WellsFargo2,49,4
18,9463.83,1678.66,51.1,1627.56,7836.27,WellsFargo2,49,4
19,7836.27,1678.66,42.32,1636.34,6199.93,WellsFargo2,49,4
20,6199.93,1678.66,33.48,1645.18,4554.75,WellsFargo2,49,4
21,4554.75,1678.66,24.6,1654.06,2900.69,WellsFargo2,49,4
22,2900.69,1678.66,15.66,1663.0,1237.69,WellsFargo2,49,4
23,1237.69,1678.66,6.68,1671.98,-434.29,WellsFargo2,49,4
0,180000.0,1331.44,594.0,737.44,179262.56,mortgage,49,5
1,179262.56,1331.44,591.57,739.87,178522.69,mortgage,49,5
2,178522.69,1331.44,589.12,742.32,177780.37,mortgage,49,5
3,177780.37,1331.44,586.68,744.76,177035.61,mortgage,49,5
4,177035.61,1331.44,584.22,747.22,176288.39,mortgage,49,5
5,176288.39,1331.44,581.75,749.69,175538.7,mortgage,49,5
6,175538.7,1331.44,579.28,752.16,174786.54,mortgage,49,5
7,174786.54,1331.44,576.8,754.64,174031.9,mortgage,49,5
8,174031.9,1331.44,574.31,757.13,173274.77,mortgage,49,5
9,173274.77,1331.44,571.81,759.63,172515.14,mortgage,49,5
10,172515.14,1331.44,569.3,762.14,171753.0,mortgage,49,5
11,171753.0,1331.44,566.78,764.66,170988.34,mortgage,49,5
12,170988.34,1331.44,564.26,767.18,170221.16,mortgage,49,5
13,170221.16,1331.44,561.73,769.71,169451.45,mortgage,49,5
14,169451.45,1331.44,559.19,772.25,168679.2,mortgage,49,5
15,168679.2,1331.44,556.64,774.8,167904.4,mortgage,49,5
16,167904.4,1331.44,554.08,777.36,167127.04,mortgage,49,5
17,167127.04,1331.44,551.52,779.92,166347.12,mortgage,49,5
18,166347.12,1331.44,548.95,782.49,165564.63,mortgage,49,5
19,165564.63,1331.44,546.36,785.08,164779.55,mortgage,49,5
20,164779.55,1331.44,543.77,787.67,163991.88,mortgage,49,5
21,163991.88,1331.44,541.17,790.27,163201.61,mortgage,49,5
22,163201.61,1331.44,538.57,792.87,162408.74,mortgage,49,5
23,162408.74,1765.73,535.95,1229.78,161178.96,mortgage,49,5
24,161178.96,3010.1,531.89,2478.21,158700.75,mortgage,49,5
25,158700.75,3010.1,523.71,2486.39,156214.36,mortgage,49,5
26,156214.36,3010.1,515.51,2494.59,153719.77,mortgage,49,5
27,153719.77,3010.1,507.28,2502.82,151216.95,mortgage,49,5
28,151216.95,3010.1,499.02,2511.08,148705.87,mortgage,49,5
29,148705.87,3010.1,490.73,2519.37,146186.5,mortgage,49,5
30,146186.5,3010.1,482.42,2527.68,143658.82,mortgage,49,5
31,143658.82,3010.1,474.07,2536.03,141122.79,mortgage,49,5
32,141122.79,3010.1,465.71,2544.39,138578.4,mortgage,49,5
33,138578.4,3010.1,457.31,2552.79,136025.61,mortgage,49,5
34,136025.61,3010.1,448.88,2561.22,133464.39,mortgage,49,5
35,133464.39,3010.1,440.43,2569.67,130894.72,mortgage,49,5
36,130894.72,3010.1,431.95,2578.15,128316.57,mortgage,49,5
37,128316.57,3010.1,423.44,2586.66,125729.91,mortgage,49,5
38,125729.91,3010.1,414.91,2595.19,123134.72,mortgage,49,5
39,123134.72,3010.1,406.34,2603.76,120530.96,mortgage,49,5
40,120530.96,3010.1,397.75,2612.35,117918.61,mortgage,49,5
41,117918.61,3010.1,389.13,2620.97,115297.64,mortgage,49,5
42,115297.64,3010.1,380.48,2629.62,112668.02,mortgage,49,5
43,112668.02,3010.1,371.8,2638.3,110029.72,mortgage,49,5
44,110029.72,3010.1,363.1,2647.0,107382.72,mortgage,49,5
45,107382.72,3010.1,354.36,2655.74,104726.98,mortgage,49,5
46,104726.98,3010.1,345.6,2664.5,102062.48,mortgage,49,5
47,102062.48,3010.1,336.81,2673.29,99389.19,mortgage,49,5
48,99389.19,3010.1,327.98,2682.12,96707.07,mortgage,49,5
49,96707.07,3010.1,319.13,2690.97,94016.1,mortgage,49,5
50,94016.1,3010.1,310.25,2699.85,91316.25,mortgage,49,5
51,91316.25,3010.1,301.34,2708.76,88607.49,mortgage,49,5
52,88607.49,3010.1,292.4,2717.7,85889.79,mortgage,49,5
53,85889.79,3010.1,283.44,2726.66,83163.13,mortgage,49,5
54,83163.13,3010.1,274.44,2735.66,80427.47,mortgage,49,5
55,80427.47,3010.1,265.41,2744.69,77682.78,mortgage,49,5
56,77682.78,3010.1,256.35,2753.75,74929.03,mortgage,49,5
57,74929.03,3010.1,247.27,2762.83,72166.2,mortgage,49,5
58,72166.2,3010.1,238.15,2771.95,69394.25,mortgage,49,5
59,69394.25,3010.1,229.0,2781.1,66613.15,mortgage,49,5
60,66613.15,3010.1,219.82,2790.28,63822.87,mortgage,49,5
61,63822.87,3010.1,210.62,2799.48,61023.39,mortgage,49,5
62,61023.39,3010.1,201.38,2808.72,58214.67,mortgage,49,5
63,58214.67,3010.1,192.11,2817.99,55396.68,mortgage,49,5
64,55396.68,3010.1,182.81,2827.29,52569.39,mortgage,49,5
65,52569.39,3010.1,173.48,2836.62,49732.77,mortgage,49,5
66,49732.77,3010.1,164.12,2845.98,46886.79,mortgage,49,5
67,46886.79,3010.1,154.73,2855.37,44031.42,mortgage,49,5
68,44031.42,3010.1,145.3,2864.8,41166.62,mortgage,49,5
69,41166.62,3010.1,135.85,2874.25,38292.37,mortgage,49,5
70,38292.37,3010.1,126.36,2883.74,35408.63,mortgage,49,5
71,35408.63,3010.1,116.85,2893.25,32515.38,mortgage,49,5
72,32515.38,3010.1,107.3,2902.8,29612.58,mortgage,49,5
73,29612.58,3010.1,97.72,2912.38,26700.2,mortgage,49,5
74,26700.2,3010.1,88.11,2921.99,23778.21,mortgage,49,5
75,23778.21,3010.1,78.47,2931.63,20846.58,mortgage,49,5
76,20846.58,3010.1,68.79,2941.31,17905.27,mortgage,49,5
77,17905.27,3010.1,59.09,2951.01,14954.26,mortgage,49,5
78,14954.26,3010.1,49.35,2960.75,11993.51,mortgage,49,5
79,11993.51,3010.1,39.58,2970.52,9022.99,mortgage,49,5
80,9022.99,3010.1,29.78,2980.32,6042.67,mortgage,49,5
81,6042.67,3010.1,19.94,2990.16,3052.51,mortgage,49,5
82,3052.51,3010.1,10.07,3000.03,52.48,mortgage,49,5
83,52.48,3010.1,0.17,3009.93,-2957.45,mortgage,49,5
0,8250.57,1084.62,53.63,1030.99,7219.58,WellsFargo1,50,1
1,7219.58,1084.62,46.93,1037.69,6181.89,WellsFargo1,50,1
2,6181.89,1084.62,40.18,1044.44,5137.45,WellsFargo1,50,1
3,5137.45,1084.62,33.39,1051.23,4086.22,WellsFargo1,50,1
4,4086.22,1084.62,26.56,1058.06,3028.16,WellsFargo1,50,1
5,3028.16,1084.62,19.68,1064.94,1963.22,WellsFargo1,50,1
6,1963.22,1084.62,12.76,1071.86,891.36,WellsFargo1,50,1
7,891.36,1084.62,5.79,1078.83,-187.47,WellsFargo1,50,1
0,4000.0,70.0,16.0,54.0,3946.0,testing,50,2
1,3946.0,70.0,15.78,54.22,3891.78,testing,50,2
2,3891.78,70.0,15.57,54.43,3837.35,testing,50,2
3,3837.35,70.0,15.35,54.65,3782.7,testing,50,2
4,3782.7,70.0,15.13,54.87,3727.83,testing,50,2
5,3727.83,70.0,14.91,55.09,3672.74,testing,50,2
6,3672.74,70.0,14.69,55.31,3617.43,testing,50,2
7,3617.43,257.47,14.47,243.0,3374.43,testing,50,2
8,3374.43,1154.62,13.5,1141.12,2233.31,testing,50,2
9,2233.31,1154.62,8.93,1145.69,1087.62,testing,50,2
10,1087.62,1154.62,4.35,1150.27,-62.65,testing,50,2
0,5000.0,333.0,36.0,297.0,4703.0,Car,50,3
1,4703.0,333.0,33.86,299.14,4403.86,Car,50,3
2,4403.86,333.0,31.71,301.29,4102.57,Car,50,3
3,4102.57,333.0,29.54,303.46,3799.11,Car,50,3
4,3799.11,333.0,27.35,305.65,3493.46,Car,50,3
5,3493.46,333.0,25.15,307.85,3185.61,Car,50,3
6,3185.61,333.0,22.94,310.06,2875.55,Car,50,3
7,2875.55,333.0,20.7,312.3,2563.25,Car,50,3
8,2563.25,333.0,18.46,314.54,2248.71,Car,50,3
9,2248.71,333.0,16.19,316.81,1931.9,Car,50,3
10,1931.9,395.65,13.91,381.74,1550.16,Car,50,3
11,1550.16,1487.62,11.16,1476.46,73.7,Car,50,3
12,73.7,1487.62,0.53,1487.09,-1413.39,Car,50,3
0,180000.0,1331.44,594.0,737.44,179262.56,mortgage,50,4
1,179262.56,1331.44,591.57,739.87,178522.69,mortgage,50,4
2,178522.69,1331.44,589.12,742.32,177780.37,mortgage,50,4
3,177780.37,1331.44,586.68,744.76,177035.61,mortgage,50,4
4,177035.61,1331.44,584.22,747.22,176288.39,mortgage,50,4
5,176288.39,1331.44,581.75,749.69,175538.7,mortgage,50,4
6,175538.7,1331.44,579.28,752.16,174786.54,mortgage,50,4
7,174786.54,1331.44,576.8,754.64,174031.9,mortgage,50,4
8,174031.9,1331.44,574.31,757.13,173274.77,mortgage,50,4
9,173274.77,1331.44,571.81,759.63,172515.14,mortgage,50,4
10,172515.14,1331.44,569.3,762.14,171753.0,mortgage,50,4
11,171753.0,1331.44,566.78,764.66,170988.34,mortgage,50,4
12,170988.34,2744.83,564.26,2180.57,168807.77,mortgage,50,4
13,168807.77,2819.06,557.07,2261.99,166545.78,mortgage,50,4
14,166545.78,2819.06,549.6,2269.46,164276.32,mortgage,50,4
15,164276.32,2819.06,542.11,2276.95,161999.37,mortgage,50,4
16,161999.37,2819.06,534.6,2284.46,159714.91,mortgage,50,4
17,159714.91,2819.06,527.06,2292.0,157422.91,mortgage,50,4
18,157422.91,2819.06,519.5,2299.56,155123.35,mortgage,50,4
19,155123.35,2819.06,511.91,2307.15,152816.2,mortgage,50,4
20,152816.2,2819.06,504.29,2314.77,150501.43,mortgage,50,4
21,150501.43,2819.06,496.65,2322.41,148179.02,mortgage,50,4
22,148179.02,2819.06,488.99,2330.07,145848.95,mortgage,50,4
23,145848.95,2819.06,481.3,2337.76,143511.19,mortgage,50,4
24,143511.19,2819.06,473.59,2345.47,141165.72,mortgage,50,4
25,141165.72,2819.06,465.85,2353.21,138812.51,mortgage,50,4
26,138812.51,2819.06,458.08,2360.98,136451.53,mortgage,50,4
27,136451.53,2819.06,450.29,2368.77,134082.76,mortgage,50,4
28,134082.76,2819.06,442.47,2376.59,131706.17,mortgage,50,4
29,131706.17,2819.06,434.63,2384.43,129321.74,mortgage,50,4
30,129321.74,2819.06,426.76,2392.3,126929.44,mortgage,50,4
31,126929.44,2819.06,418.87,2400.19,124529.25,mortgage,50,4
32,124529.25,2819.06,410.95,2408.11,122121.14,mortgage,50,4
33,122121.14,2819.06,403.0,2416.06,119705.08,mortgage,50,4
34,119705.08,2819.06,395.03,2424.03,117281.05,mortgage,50,4
35,117281.05,2819.06,387.03,2432.03,114849.02,mortgage,50,4
36,114849.02,2819.06,379.0,2440.06,112408.96,mortgage,50,4
37,112408.96,2819.06,370.95,2448.11,109960.85,mortgage,50,4
38,109960.85,2819.06,362.87,2456.19,107504.66,mortgage,50,4
39,107504.66,2819.06,354.77,2464.29,105040.37,mortgage,50,4
40,105040.37,2819.06,346.63,2472.43,102567.94,mortgage,50,4
41,102567.94,2819.06,338.47,2480.59,100087.35,mortgage,50,4
42,100087.35,2819.06,330.29,2488.77,97598.58,mortgage,50,4
43,97598.58,2819.06,322.08,2496.98,95101.6,mortgage,50,4
44,95101.6,2819.06,313.84,2505.22,92596.38,mortgage,50,4
45,92596.38,2819.06,305.57,2513.49,90082.89,mortgage,50,4
46,90082.89,2819.06,297.27,2521.79,87561.1,mortgage,50,4
47,87561.1,2819.06,288.95,2530.11,85030.99,mortgage,50,4
48,85030.99,2819.06,280.6,2538.46,82492.53,mortgage,50,4
49,82492.53,2819.06,272.23,2546.83,79945.7,mortgage,50,4
50,79945.7,2819.06,263.82,2555.24,77390.46,mortgage,50,4
51,77390.46,2819.06,255.39,2563.67,74826.79,mortgage,50,4
52,74826.79,2819.06,246.93,2572.13,72254.66,mortgage,50,4
53,72254.66,2819.06,238.44,2580.62,69674.04,mortgage,50,4
54,69674.04,2819.06,229.92,2589.14,67084.9,mortgage,50,4
55,67084.9,2819.06,221.38,2597.68,64487.22,mortgage,50,4
56,64487.22,2819.06,212.81,2606.25,61880.97,mortgage,50,4
57,61880.97,2819.06,204.21,2614.85,59266.12,mortgage,50,4
58,59266.12,2819.06,195.58,2623.48,56642.64,mortgage,50,4
59,56642.64,2819.06,186.92,2632.14,54010.5,mortgage,50,4
60,54010.5,2819.06,178.23,2640.83,51369.67,mortgage,50,4
61,51369.67,2819.06,169.52,2649.54,48720.13,mortgage,50,4
62,48720.13,2819.06,160.78,2658.28,46061.85,mortgage,50,4
63,46061.85,2819.06,152.0,2667.06,43394.79,mortgage,50,4
64,43394.79,2819.06,143.2,2675.86,40718.93,mortgage,50,4
65,40718.93,2819.06,134.37,2684.69,38034.24,mortgage,50,4
66,38034.24,2819.06,125.51,2693.55,35340.69,mortgage,50,4
67,35340.69,2819.06,116.62,2702.44,32638.25,mortgage,50,4
68,32638.25,2819.06,107.71,2711.35,29926.9,mortgage,50,4
69,29926.9,2819.06,98.76,2720.3,27206.6,mortgage,50,4
70,27206.6,2819.06,89.78,2729.28,24477.32,mortgage,50,4
71,24477.32,2819.06,80.78,2738.28,21739.04,mortgage,50,4
72,21739.04,2819.06,71.74,2747.32,18991.72,mortgage,50,4
73,18991.72,2819.06,62.67,2756.39,16235.33,mortgage,50,4
74,16235.33,2819.06,53.58,2765.48,13469.85,mortgage,50,4
75,13469.85,2819.06,44.45,2774.61,10695.24,mortgage,50,4
76,10695.24,2819.06,35.29,2783.77,7911.47,mortgage,50,4
77,7911.47,2819.06,26.11,2792.95,5118.52,mortgage,50,4
78,5118.52,2819.06,16.89,2802.17,2316.35,mortgage,50,4
79,2316.35,2819.06,7.64,2811.42,-495.07,mortgage,50,4
0,20000.0,191.04,108.0,83.04,19916.96,WellsFargo2,50,5
1,19916.96,191.04,107.55,83.49,19833.47,WellsFargo2,50,5
2,19833.47,191.04,107.1,83.94,19749.53,WellsFargo2,50,5
3,19749.53,191.04,106.65,84.39,19665.14,WellsFargo2,50,5
4,19665.14,191.04,106.19,84.85,19580.29,WellsFargo2,50,5
5,19580.29,191.04,105.73,85.31,19494.98,WellsFargo2,50,5
6,19494.98,191.04,105.27,85.77,19409.21,WellsFargo2,50,5
7,19409.21,191.04,104.81,86.23,19322.98,WellsFargo2,50,5
8,19322.98,191.04,104.34,86.7,19236.28,WellsFargo2,50,5
9,19236.28,191.04,103.88,87.16,19149.12,WellsFargo2,50,5
10,19149.12,191.04,103.41,87.63,19061.49,WellsFargo2,50,5
11,19061.49,191.04,102.93,88.11,18973.38,WellsFargo2,50,5
12,18973.38,191.04,102.46,88.58,18884.8,WellsFargo2,50,5
13,18884.8,191.04,101.98,89.06,18795.74,WellsFargo2,50,5
14,18795.74,191.04,101.5,89.54,18706.2,WellsFargo2,50,5
15,18706.2,191.04,101.01,90.03,18616.17,WellsFargo2,50,5
16,18616.17,191.04,100.53,90.51,18525.66,WellsFargo2,50,5
17,18525.66,191.04,100.04,91.0,18434.66,WellsFargo2,50,5
18,18434.66,191.04,99.55,91.49,18343.17,WellsFargo2,50,5
19,18343.17,191.04,99.05,91.99,18251.18,WellsFargo2,50,5
20,18251.18,191.04,98.56,92.48,18158.7,WellsFargo2,50,5
21,18158.7,191.04,98.06,92.98,18065.72,WellsFargo2,50,5
22,18065.72,191.04,97.55,93.49,17972.23,WellsFargo2,50,5
23,17972.23,191.04,97.05,93.99,17878.24,WellsFargo2,50,5
24,17878.24,191.04,96.54,94.5,17783.74,WellsFargo2,50,5
25,17783.74,191.04,96.03,95.01,17688.73,WellsFargo2,50,5
26,17688.73,191.04,95.52,95.52,17593.21,WellsFargo2,50,5
27,17593.21,191.04,95.0,96.04,17497.17,WellsFargo2,50,5
28,17497.17,191.04,94.48,96.56,17400.61,WellsFargo2,50,5
29,17400.61,191.04,93.96,97.08,17303.53,WellsFargo2,50,5
30,17303.53,191.04,93.44,97.6,17205.93,WellsFargo2,50,5
31,17205.93,191.04,92.91,98.13,17107.8,WellsFargo2,50,5
32,17107.8,191.04,92.38,98.66,17009.14,WellsFargo2,50,5
33,17009.14,191.04,91.85,99.19,16909.95,WellsFargo2,50,5
34,16909.95,191.04,91.31,99.73,16810.22,WellsFargo2,50,5
35,16810.22,191.04,90.78,100.26,16709.96,WellsFargo2,50,5
36,16709.96,191.04,90.23,100.81,16609.15,WellsFargo2,50,5
37,16609.15,191.04,89.69,101.35,16507.8,WellsFargo2,50,5
38,16507.8,191.04,89.14,101.9,16405.9,WellsFargo2,50,5
39,16405.9,191.04,88.59,102.45,16303.45,WellsFargo2,50,5
40,16303.45,191.04,88.04,103.0,16200.45,WellsFargo2,50,5
41,16200.45,191.04,87.48,103.56,16096.89,WellsFargo2,50,5
42,16096.89,191.04,86.92,104.12,15992.77,WellsFargo2,50,5
43,15992.77,191.04,86.36,104.68,15888.09,WellsFargo2,50,5
44,15888.09,191.04,85.8,105.24,15782.85,WellsFargo2,50,5
45,15782.85,191.04,85.23,105.81,15677.04,WellsFargo2,50,5
46,15677.04,191.04,84.66,106.38,15570.66,WellsFargo2,50,5
47,15570.66,191.04,84.08,106.96,15463.7,WellsFargo2,50,5
48,15463.7,191.04,83.5,107.54,15356.16,WellsFargo2,50,5
49,15356.16,191.04,82.92,108.12,15248.04,WellsFargo2,50,5
50,15248.04,191.04,82.34,108.7,15139.34,WellsFargo2,50,5
51,15139.34,191.04,81.75,109.29,15030.05,WellsFargo2,50,5
52,15030.05,191.04,81.16,109.88,14920.17,WellsFargo2,50,5
53,14920.17,191.04,80.57,110.47,14809.7,WellsFargo2,50,5
54,14809.7,191.04,79.97,111.07,14698.63,WellsFargo2,50,5
55,14698.63,191.04,79.37,111.67,14586.96,WellsFargo2,50,5
56,14586.96,191.04,78.77,112.27,14474.69,WellsFargo2,50,5
57,14474.69,191.04,78.16,112.88,14361.81,WellsFargo2,50,5
58,14361.81,191.04,77.55,113.49,14248.32,WellsFargo2,50,5
59,14248.32,191.04,76.94,114.1,14134.22,WellsFargo2,50,5
60,14134.22,191.04,76.32,114.72,14019.5,WellsFargo2,50,5
61,14019.5,191.04,75.71,115.33,13904.17,WellsFargo2,50,5
62,13904.17,191.04,75.08,115.96,13788.21,WellsFargo2,50,5
63,13788.21,191.04,74.46,116.58,13671.63,WellsFargo2,50,5
64,13671.63,191.04,73.83,117.21,13554.42,WellsFargo2,50,5
65,13554.42,191.04,73.19,117.85,13436.57,WellsFargo2,50,5
66,13436.57,191.04,72.56,118.48,13318.09,WellsFargo2,50,5
67,13318.09,191.04,71.92,119.12,13198.97,WellsFargo2,50,5
68,13198.97,191.04,71.27,119.77,13079.2,WellsFargo2,50,5
69,13079.2,191.04,70.63,120.41,12958.79,WellsFargo2,50,5
70,12958.79,191.04,69.98,121.06,12837.73,WellsFargo2,50,5
71,12837.73,191.04,69.32,121.72,12716.01,WellsFargo2,50,5
72,12716.01,191.04,68.67,122.37,12593.64,WellsFargo2,50,5
73,12593.64,191.04,68.01,123.03,12470.61,WellsFargo2,50,5
74,12470.61,191.04,67.34,123.7,12346.91,WellsFargo2,50,5
75,12346.91,191.04,66.67,124.37,12222.54,WellsFargo2,50,5
76,12222.54,191.04,66.0,125.04,12097.5,WellsFargo2,50,5
77,12097.5,191.04,65.33,125.71,11971.79,WellsFargo2,50,5
78,11971.79,191.04,64.65,126.39,11845.4,WellsFargo2,50,5
79,11845.4,686.11,63.97,622.14,11223.26,WellsFargo2,50,5
80,11223.26,3010.1,60.61,2949.49,8273.77,WellsFargo2,50,5
81,8273.77,3010.1,44.68,2965.42,5308.35,WellsFargo2,50,5
82,5308.35,3010.1,28.67,2981.43,2326.92,WellsFargo2,50,5
83,2326.92,3010.1,12.57,2997.53,-670.61,WellsFargo2,50,5
0,8250.57,1084.62,53.63,1030.99,7219.58,WellsFargo1,51,1
1,7219.58,1084.62,46.93,1037.69,6181.89,WellsFargo1,51,1
2,6181.89,1084.62,40.18,1044.44,5137.45,WellsFargo1,51,1
3,5137.45,1084.62,33.39,1051.23,4086.22,WellsFargo1,51,1
4,4086.22,1084.62,26.56,1058.06,3028.16,WellsFargo1,51,1
5,3028.16,1084.62,19.68,1064.94,1963.22,WellsFargo1,51,1
6,1963.22,1084.62,12.76,1071.86,891.36,WellsFargo1,51,1
7,891.36,1084.62,5.79,1078.83,-187.47,WellsFargo1,51,1
0,4000.0,70.0,16.0,54.0,3946.0,testing,51,2
1,3946.0,70.0,15.78,54.22,3891.78,testing,51,2
2,3891.78,70.0,15.57,54.43,3837.35,testing,51,2
3,3837.35,70.0,15.35,54.65,3782.7,testing,51,2
4,3782.7,70.0,15.13,54.87,3727.83,testing,51,2
5,3727.83,70.0,14.91,55.09,3672.74,testing,51,2
6,3672.74,70.0,14.69,55.31,3617.43,testing,51,2
7,3617.43,257.47,14.47,243.0,3374.43,testing,51,2
8,3374.43,1154.62,13.5,1141.12,2233.31,testing,51,2
9,2233.31,1154.62,8.93,1145.69,1087.62,testing,51,2
10,1087.62,1154.62,4.35,1150.27,-62.65,testing,51,2
0,20000.0,191.04,108.0,83.04,19916.96,WellsFargo2,51,3
1,19916.96,191.04,107.55,83.49,19833.47,WellsFargo2,51,3
2,19833.47,191.04,107.1,83.94,19749.53,WellsFargo2,51,3
3,19749.53,191.04,106.65,84.39,19665.14,WellsFargo2,51,3
4,19665.14,191.04,106.19,84.85,19580.29,WellsFargo2,51,3
5,19580.29,191.04,105.73,85.31,19494.98,WellsFargo2,51,3
6,19494.98,191.04,105.27,85.77,19409.21,WellsFargo2,51,3
7,19409.21,191.04,104.81,86.23,19322.98,WellsFargo2,51,3
8,19322.98,191.04,104.34,86.7,19236.28,WellsFargo2,51,3
9,19236.28,191.04,103.88,87.16,19149.12,WellsFargo2,51,3
10,19149.12,253.69,103.41,150.28,18998.84,WellsFargo2,51,3
11,18998.84,1345.66,102.59,1243.07,17755.77,WellsFargo2,51,3
12,17755.77,1345.66,95.88,1249.78,16505.99,WellsFargo2,51,3
13,16505.99,1345.66,89.13,1256.53,15249.46,WellsFargo2,51,3
14,15249.46,1345.66,82.35,1263.31,13986.15,WellsFargo2,51,3
15,13986.15,1345.66,75.53,1270.13,12716.02,WellsFargo2,51,3
16,12716.02,1345.66,68.67,1276.99,11439.03,WellsFargo2,51,3
17,11439.03,1345.66,61.77,1283.89,10155.14,WellsFargo2,51,3
18,10155.14,1345.66,54.84,1290.82,8864.32,WellsFargo2,51,3
19,8864.32,1345.66,47.87,1297.79,7566.53,WellsFargo2,51,3
20,7566.53,1345.66,40.86,1304.8,6261.73,WellsFargo2,51,3
21,6261.73,1345.66,33.81,1311.85,4949.88,WellsFargo2,51,3
22,4949.88,1345.66,26.73,1318.93,3630.95,WellsFargo2,51,3
23,3630.95,1345.66,19.61,1326.05,2304.9,WellsFargo2,51,3
24,2304.9,1345.66,12.45,1333.21,971.69,WellsFargo2,51,3
25,971.69,1345.66,5.25,1340.41,-368.72,WellsFargo2,51,3
0,5000.0,333.0,36.0,297.0,4703.0,Car,51,4
1,4703.0,333.0,33.86,299.14,4403.86,Car,51,4
2,4403.86,333.0,31.71,301.29,4102.57,Car,51,4
3,4102.57,333.0,29.54,303.46,3799.11,Car,51,4
4,3799.11,333.0,27.35,305.65,3493.46,Car,51,4
5,3493.46,333.0,25.15,307.85,3185.61,Car,51,4
6,3185.61,333.0,22.94,310.06,2875.55,Car,51,4
7,2875.55,333.0,20.7,312.3,2563.25,Car,51,4
8,2563.25,333.0,18.46,314.54,2248.71,Car,51,4
9,2248.71,333.0,16.19,316.81,1931.9,Car,51,4
10,1931.9,333.0,13.91,319.09,1612.81,Car,51,4
11,1612.81,333.0,11.61,321.39,1291.42,Car,51,4
12,1291.42,333.0,9.3,323.7,967.72,Car,51,4
13,967.72,333.0,6.97,326.03,641.69,Car,51,4
14,641.69,333.0,4.62,328.38,313.31,Car,51,4
15,313.31,333.0,2.26,330.74,-17.43,Car,51,4
0,180000.0,1331.44,594.0,737.44,179262.56,mortgage,51,5
1,179262.56,1331.44,591.57,739.87,178522.69,mortgage,51,5
2,178522.69,1331.44,589.12,742.32,177780.37,mortgage,51,5
3,177780.37,1331.44,586.68,744.76,177035.61,mortgage,51,5
4,177035.61,1331.44,584.22,747.22,176288.39,mortgage,51,5
5,176288.39,1331.44,581.75,749.69,175538.7,mortgage,51,5
6,175538.7,1331.44,579.28,752.16,174786.54,mortgage,51,5
7,174786.54,1331.44,576.8,754.64,174031.9,mortgage,51,5
8,174031.9,1331.44,574.31,757.13,173274.77,mortgage,51,5
9,173274.77,1331.44,571.81,759.63,172515.14,mortgage,51,5
10,172515.14,1331.44,569.3,762.14,171753.0,mortgage,51,5
11,171753.0,1331.44,566.78,764.66,170988.34,mortgage,51,5
12,170988.34,1331.44,564.26,767.18,170221.16,mortgage,51,5
13,170221.16,1331.44,561.73,769.71,169451.45,mortgage,51,5
14,169451.45,1331.44,559.19,772.25,168679.2,mortgage,51,5
15,168679.2,1348.87,556.64,792.23,167886.97,mortgage,51,5
16,167886.97,3010.1,554.03,2456.07,165430.9,mortgage,51,5
17,165430.9,3010.1,545.92,2464.18,162966.72,mortgage,51,5
18,162966.72,3010.1,537.79,2472.31,160494.41,mortgage,51,5
19,160494.41,3010.1,529.63,2480.47,158013.94,mortgage,51,5
20,158013.94,3010.1,521.45,2488.65,155525.29,mortgage,51,5
21,155525.29,3010.1,513.23,2496.87,153028.42,mortgage,51,5
22,153028.42,3010.1,504.99,2505.11,150523.31,mortgage,51,5
23,150523.31,3010.1,496.73,2513.37,148009.94,mortgage,51,5
24,148009.94,3010.1,488.43,2521.67,145488.27,mortgage,51,5
25,145488.27,3010.1,480.11,2529.99,142958.28,mortgage,51,5
26,142958.28,3010.1,471.76,2538.34,140419.94,mortgage,51,5
27,140419.94,3010.1,463.39,2546.71,137873.23,mortgage,51,5
28,137873.23,3010.1,454.98,2555.12,135318.11,mortgage,51,5
29,135318.11,3010.1,446.55,2563.55,132754.56,mortgage,51,5
30,132754.56,3010.1,438.09,2572.01,130182.55,mortgage,51,5
31,130182.55,3010.1,429.6,2580.5,127602.05,mortgage,51,5
32,127602.05,3010.1,421.09,2589.01,125013.04,mortgage,51,5
33,125013.04,3010.1,412.54,2597.56,122415.48,mortgage,51,5
34,122415.48,3010.1,403.97,2606.13,119809.35,mortgage,51,5
35,119809.35,3010.1,395.37,2614.73,117194.62,mortgage,51,5
36,117194.62,3010.1,386.74,2623.36,114571.26,mortgage,51,5
37,114571.26,3010.1,378.09,2632.01,111939.25,mortgage,51,5
38,111939.25,3010.1,369.4,2640.7,109298.55,mortgage,51,5
39,109298.55,3010.1,360.69,2649.41,106649.14,mortgage,51,5
40,106649.14,3010.1,351.94,2658.16,103990.98,mortgage,51,5
41,103990.98,3010.1,343.17,2666.93,101324.05,mortgage,51,5
42,101324.05,3010.1,334.37,2675.73,98648.32,mortgage,51,5
43,98648.32,3010.1,325.54,2684.56,95963.76,mortgage,51,5
44,95963.76,3010.1,316.68,2693.42,93270.34,mortgage,51,5
45,93270.34,3010.1,307.79,2702.31,90568.03,mortgage,51,5
46,90568.03,3010.1,298.87,2711.23,87856.8,mortgage,51,5
47,87856.8,3010.1,289.93,2720.17,85136.63,mortgage,51,5
48,85136.63,3010.1,280.95,2729.15,82407.48,mortgage,51,5
49,82407.48,3010.1,271.94,2738.16,79669.32,mortgage,51,5
50,79669.32,3010.1,262.91,2747.19,76922.13,mortgage,51,5
51,76922.13,3010.1,253.84,2756.26,74165.87,mortgage,51,5
52,74165.87,3010.1,244.75,2765.35,71400.52,mortgage,51,5
53,71400.52,3010.1,235.62,2774.48,68626.04,mortgage,51,5
54,68626.04,3010.1,226.47,2783.63,65842.41,mortgage,51,5
55,65842.41,3010.1,217.28,2792.82,63049.59,mortgage,51,5
56,63049.59,3010.1,208.06,2802.04,60247.55,mortgage,51,5
57,60247.55,3010.1,198.82,2811.28,57436.27,mortgage,51,5
58,57436.27,3010.1,189.54,2820.56,54615.71,mortgage,51,5
59,54615.71,3010.1,180.23,2829.87,51785.84,mortgage,51,5
60,51785.84,3010.1,170.89,2839.21,48946.63,mortgage,51,5
61,48946.63,3010.1,161.52,2848.58,46098.05,mortgage,51,5
62,46098.05,3010.1,152.12,2857.98,43240.07,mortgage,51,5
63,43240.07,3010.1,142.69,2867.41,40372.66,mortgage,51,5
64,40372.66,3010.1,133.23,2876.87,37495.79,mortgage,51,5
65,37495.79,3010.1,123.74,2886.36,34609.43,mortgage,51,5
66,34609.43,3010.1,114.21,2895.89,31713.54,mortgage,51,5
67,31713.54,3010.1,104.65,2905.45,28808.09,mortgage,51,5
68,28808.09,3010.1,95.07,2915.03,25893.06,mortgage,51,5
69,25893.06,3010.1,85.45,2924.65,22968.41,mortgage,51,5
70,22968.41,3010.1,75.8,2934.3,20034.11,mortgage,51,5
71,20034.11,3010.1,66.11,2943.99,17090.12,mortgage,51,5
72,17090.12,3010.1,56.4,2953.7,14136.42,mortgage,51,5
73,14136.42,3010.1,46.65,2963.45,11172.97,mortgage,51,5
74,11172.97,3010.1,36.87,2973.23,8199.74,mortgage,51,5
75,8199.74,3010.1,27.06,2983.04,5216.7,mortgage,51,5
76,5216.7,3010.1,17.22,2992.88,2223.82,mortgage,51,5
77,2223.82,3010.1,7.34,3002.76,-778.94,mortgage,51,5
0,8250.57,1084.62,53.63,1030.99,7219.58,WellsFargo1,52,1
1,7219.58,1084.62,46.93,1037.69,6181.89,WellsFargo1,52,1
2,6181.89,1084.62,40.18,1044.44,5137.45,WellsFargo1,52,1
3,5137.45,1084.62,33.39,1051.23,4086.22,WellsFargo1,52,1
4,4086.22,1084.62,26.56,1058.06,3028.16,WellsFargo1,52,1
5,3028.16,1084.62,19.68,1064.94,1963.22,WellsFargo1,52,1
6,1963.22,1084.62,12.76,1071.86,891.36,WellsFargo1,52,1
7,891.36,1084.62,5.79,1078.83,-187.47,WellsFargo1,52,1
0,4000.0,70.0,16.0,54.0,3946.0,testing,52,2
1,3946.0,70.0,15.78,54.22,3891.78,testing,52,2
2,3891.78,70.0,15.57,54.43,3837.35,testing,52,2
3,3837.35,70.0,15.35,54.65,3782.7,testing,52,2
4,3782.7,70.0,15.13,54.87,3727.83,testing,52,2
5,3727.83,70.0,14.91,55.09,3672.74,testing,52,2
6,3672.74,70.0,14.69,55.31,3617.43,testing,52,2
7,3617.43,257.47,14.47,243.0,3374.43,testing,52,2
8,3374.43,1154.62,13.5,1141.12,2233.31,testing,52,2
9,2233.31,1154.62,8.93,1145.69,1087.62,testing,52,2
10,1087.62,1154.62,4.35,1150.27,-62.65,testing,52,2
0,20000.0,191.04,108.0,83.04,19916.96,WellsFargo2,52,3
1,19916.96,191.04,107.55,83.49,19833.47,WellsFargo2,52,3
2,19833.47,191.04,107.1,83.94,19749.53,WellsFargo2,52,3
3,19749.53,191.04,106.65,84.39,19665.14,WellsFargo2,52,3
4,19665.14,191.04,106.19,84.85,19580.29,WellsFargo2,52,3
5,19580.29,191.04,105.73,85.31,19494.98,WellsFargo2,52,3
6,19494.98,191.04,105.27,85.77,19409.21,WellsFargo2,52,3
7,19409.21,191.04,104.81,86.23,19322.98,WellsFargo2,52,3
8,19322.98,191.04,104.34,86.7,19236.28,WellsFargo2,52,3
9,19236.28,191.04,103.88,87.16,19149.12,WellsFargo2,52,3
10,19149.12,253.69,103.41,150.28,18998.84,WellsFargo2,52,3
11,18998.84,1345.66,102.59,1243.07,17755.77,WellsFargo2,52,3
12,17755.77,1345.66,95.88,1249.78,16505.99,WellsFargo2,52,3
13,16505.99,1345.66,89.13,1256.53,15249.46,WellsFargo2,52,3
14,15249.46,1345.66,82.35,1263.31,13986.15,WellsFargo2,52,3
15,13986.15,1345.66,75.53,1270.13,12716.02,WellsFargo2,52,3
16,12716.02,1345.66,68.67,1276.99,11439.03,WellsFargo2,52,3
17,11439.03,1345.66,61.77,1283.89,10155.14,WellsFargo2,52,3
18,10155.14,1345.66,54.84,1290.82,8864.32,WellsFargo2,52,3
19,8864.32,1345.66,47.87,1297.79,7566.53,WellsFargo2,52,3
20,7566.53,1345.66,40.86,1304.8,6261.73,WellsFargo2,52,3
21,6261.73,1345.66,33.81,1311.85,4949.88,WellsFargo2,52,3
22,4949.88,1345.66,26.73,1318.93,3630.95,WellsFargo2,52,3
23,3630.95,1345.66,19.61,1326.05,2304.9,WellsFargo2,52,3
24,2304.9,1345.66,12.45,1333.21,971.69,WellsFargo2,52,3
25,971.69,1345.66,5.25,1340.41,-368.72,WellsFargo2,52,3
0,180000.0,1331.44,594.0,737.44,179262.56,mortgage,52,4
1,179262.56,1331.44,591.57,739.87,178522.69,mortgage,52,4
2,178522.69,1331.44,589.12,742.32,177780.37,mortgage,52,4
3,177780.37,1331.44,586.68,744.76,177035.61,mortgage,52,4
4,177035.61,1331.44,584.22,747.22,176288.39,mortgage,52,4
5,176288.39,1331.44,581.75,749.69,175538.7,mortgage,52,4
6,175538.7,1331.44,579.28,752.16,174786.54,mortgage,52,4
7,174786.54,1331.44,576.8,754.64,174031.9,mortgage,52,4
8,174031.9,1331.44,574.31,757.13,173274.77,mortgage,52,4
9,173274.77,1331.44,571.81,759.63,172515.14,mortgage,52,4
10,172515.14,1331.44,569.3,762.14,171753.0,mortgage,52,4
11,171753.0,1331.44,566.78,764.66,170988.34,mortgage,52,4
12,170988.34,1331.44,564.26,767.18,170221.16,mortgage,52,4
13,170221.16,1331.44,561.73,769.71,169451.45,mortgage,52,4
14,169451.45,1331.44,559.19,772.25,168679.2,mortgage,52,4
15,168679.2,1331.44,556.64,774.8,167904.4,mortgage,52,4
16,167904.4,1331.44,554.08,777.36,167127.04,mortgage,52,4
17,167127.04,1331.44,551.52,779.92,166347.12,mortgage,52,4
18,166347.12,1331.44,548.95,782.49,165564.63,mortgage,52,4
19,165564.63,1331.44,546.36,785.08,164779.55,mortgage,52,4
20,164779.55,1331.44,543.77,787.67,163991.88,mortgage,52,4
21,163991.88,1331.44,541.17,790.27,163201.61,mortgage,52,4
22,163201.61,1331.44,538.57,792.87,162408.74,mortgage,52,4
23,162408.74,1331.44,535.95,795.49,161613.25,mortgage,52,4
24,161613.25,1331.44,533.32,798.12,160815.13,mortgage,52,4
25,160815.13,1700.16,530.69,1169.47,159645.66,mortgage,52,4
26,159645.66,2677.1,526.83,2150.27,157495.39,mortgage,52,4
27,157495.39,2677.1,519.73,2157.37,155338.02,mortgage,52,4
28,155338.02,2677.1,512.62,2164.48,153173.54,mortgage,52,4
29,153173.54,2677.1,505.47,2171.63,151001.91,mortgage,52,4
30,151001.91,2677.1,498.31,2178.79,148823.12,mortgage,52,4
31,148823.12,2677.1,491.12,2185.98,146637.14,mortgage,52,4
32,146637.14,2677.1,483.9,2193.2,144443.94,mortgage,52,4
33,144443.94,2677.1,476.67,2200.43,142243.51,mortgage,52,4
34,142243.51,2677.1,469.4,2207.7,140035.81,mortgage,52,4
35,140035.81,2677.1,462.12,2214.98,137820.83,mortgage,52,4
36,137820.83,2677.1,454.81,2222.29,135598.54,mortgage,52,4
37,135598.54,2677.1,447.48,2229.62,133368.92,mortgage,52,4
38,133368.92,2677.1,440.12,2236.98,131131.94,mortgage,52,4
39,131131.94,2677.1,432.74,2244.36,128887.58,mortgage,52,4
40,128887.58,2677.1,425.33,2251.77,126635.81,mortgage,52,4
41,126635.81,2677.1,417.9,2259.2,124376.61,mortgage,52,4
42,124376.61,2677.1,410.44,2266.66,122109.95,mortgage,52,4
43,122109.95,2677.1,402.96,2274.14,119835.81,mortgage,52,4
44,119835.81,2677.1,395.46,2281.64,117554.17,mortgage,52,4
45,117554.17,2677.1,387.93,2289.17,115265.0,mortgage,52,4
46,115265.0,2677.1,380.37,2296.73,112968.27,mortgage,52,4
47,112968.27,2677.1,372.8,2304.3,110663.97,mortgage,52,4
48,110663.97,2677.1,365.19,2311.91,108352.06,mortgage,52,4
49,108352.06,2677.1,357.56,2319.54,106032.52,mortgage,52,4
50,106032.52,2677.1,349.91,2327.19,103705.33,mortgage,52,4
51,103705.33,2677.1,342.23,2334.87,101370.46,mortgage,52,4
52,101370.46,2677.1,334.52,2342.58,99027.88,mortgage,52,4
53,99027.88,2677.1,326.79,2350.31,96677.57,mortgage,52,4
54,96677.57,2677.1,319.04,2358.06,94319.51,mortgage,52,4
55,94319.51,2677.1,311.25,2365.85,91953.66,mortgage,52,4
56,91953.66,2677.1,303.45,2373.65,89580.01,mortgage,52,4
57,89580.01,2677.1,295.61,2381.49,87198.52,mortgage,52,4
58,87198.52,2677.1,287.76,2389.34,84809.18,mortgage,52,4
59,84809.18,2677.1,279.87,2397.23,82411.95,mortgage,52,4
60,82411.95,2677.1,271.96,2405.14,80006.81,mortgage,52,4
61,80006.81,2677.1,264.02,2413.08,77593.73,mortgage,52,4
62,77593.73,2677.1,256.06,2421.04,75172.69,mortgage,52,4
63,75172.69,2677.1,248.07,2429.03,72743.66,mortgage,52,4
64,72743.66,2677.1,240.05,2437.05,70306.61,mortgage,52,4
65,70306.61,2677.1,232.01,2445.09,67861.52,mortgage,52,4
66,67861.52,2677.1,223.94,2453.16,65408.36,mortgage,52,4
67,65408.36,2677.1,215.85,2461.25,62947.11,mortgage,52,4
68,62947.11,2677.1,207.73,2469.37,60477.74,mortgage,52,4
69,60477.74,2677.1,199.58,2477.52,58000.22,mortgage,52,4
70,58000.22,2677.1,191.4,2485.7,55514.52,mortgage,52,4
71,55514.52,2677.1,183.2,2493.9,53020.62,mortgage,52,4
72,53020.62,2677.1,174.97,2502.13,50518.49,mortgage,52,4
73,50518.49,2677.1,166.71,2510.39,48008.1,mortgage,52,4
74,48008.1,2677.1,158.43,2518.67,45489.43,mortgage,52,4
75,45489.43,2677.1,150.12,2526.98,42962.45,mortgage,52,4
76,42962.45,2677.1,141.78,2535.32,40427.13,mortgage,52,4
77,40427.13,2677.1,133.41,2543.69,37883.44,mortgage,52,4
78,37883.44,2677.1,125.02,2552.08,35331.36,mortgage,52,4
79,35331.36,2677.1,116.59,2560.51,32770.85,mortgage,52,4
80,32770.85,2677.1,108.14,2568.96,30201.89,mortgage,52,4
81,30201.89,2677.1,99.67,2577.43,27624.46,mortgage,52,4
82,27624.46,2677.1,91.16,2585.94,25038.52,mortgage,52,4
83,25038.52,2677.1,82.63,2594.47,22444.05,mortgage,52,4
84,22444.05,2677.1,74.07,2603.03,19841.02,mortgage,52,4
85,19841.02,2677.1,65.48,2611.62,17229.4,mortgage,52,4
86,17229.4,2677.1,56.86,2620.24,14609.16,mortgage,52,4
87,14609.16,2677.1,48.21,2628.89,11980.27,mortgage,52,4
88,11980.27,2677.1,39.53,2637.57,9342.7,mortgage,52,4
89,9342.7,2677.1,30.83,2646.27,6696.43,mortgage,52,4
90,6696.43,2677.1,22.1,2655.0,4041.43,mortgage,52,4
91,4041.43,2677.1,13.34,2663.76,1377.67,mortgage,52,4
92,1377.67,2677.1,4.55,2672.55,-1294.88,mortgage,52,4
0,5000.0,333.0,36.0,297.0,4703.0,Car,52,5
1,4703.0,333.0,33.86,299.14,4403.86,Car,52,5
2,4403.86,333.0,31.71,301.29,4102.57,Car,52,5
3,4102.57,333.0,29.54,303.46,3799.11,Car,52,5
4,3799.11,333.0,27.35,305.65,3493.46,Car,52,5
5,3493.46,333.0,25.15,307.85,3185.61,Car,52,5
6,3185.61,333.0,22.94,310.06,2875.55,Car,52,5
7,2875.55,333.0,20.7,312.3,2563.25,Car,52,5
8,2563.25,333.0,18.46,314.54,2248.71,Car,52,5
9,2248.71,333.0,16.19,316.81,1931.9,Car,52,5
10,1931.9,333.0,13.91,319.09,1612.81,Car,52,5
11,1612.81,333.0,11.61,321.39,1291.42,Car,52,5
12,1291.42,333.0,9.3,323.7,967.72,Car,52,5
13,967.72,333.0,6.97,326.03,641.69,Car,52,5
14,641.69,333.0,4.62,328.38,313.31,Car,52,5
15,313.31,333.0,2.26,330.74,-17.43,Car,52,5
0,8250.57,1084.62,53.63,1030.99,7219.58,WellsFargo1,53,1
1,7219.58,1084.62,46.93,1037.69,6181.89,WellsFargo1,53,1
2,6181.89,1084.62,40.18,1044.44,5137.45,WellsFargo1,53,1
3,5137.45,1084.62,33.39,1051.23,4086.22,WellsFargo1,53,1
4,4086.22,1084.62,26.56,1058.06,3028.16,WellsFargo1,53,1
5,3028.16,1084.62,19.68,1064.94,1963.22,WellsFargo1,53,1
6,1963.22,1084.62,12.76,1071.86,891.36,WellsFargo1,53,1
7,891.36,1084.62,5.79,1078.83,-187.47,WellsFargo1,53,1
0,4000.0,70.0,16.0,54.0,3946.0,testing,53,2
1,3946.0,70.0,15.78,54.22,3891.78,testing,53,2
2,3891.78,70.0,15.57,54.43,3837.35,testing,53,2
3,3837.35,70.0,15.35,54.65,3782.7,testing,53,2
4,3782.7,70.0,15.13,54.87,3727.83,testing,53,2
5,3727.83,70.0,14.91,55.09,3672.74,testing,53,2
6,3672.74,70.0,14.69,55.31,3617.43,testing,53,2
7,3617.43,257.47,14.47,243.0,3374.43,testing,53,2
8,3374.43,1154.62,13.5,1141.12,2233.31,testing,53,2
9,2233.31,1154.62,8.93,1145.69,1087.62,testing,53,2
10,1087.62,1154.62,4.35,1150.27,-62.65,testing,53,2
0,180000.0,1331.44,594.0,737.44,179262.56,mortgage,53,3
1,179262.56,1331.44,591.57,739.87,178522.69,mortgage,53,3
2,178522.69,1331.44,589.12,742.32,177780.37,mortgage,53,3
3,177780.37,1331.44,586.68,744.76,177035.61,mortgage,53,3
4,177035.61,1331.44,584.22,747.22,176288.39,mortgage,53,3
5,176288.39,1331.44,581.75,749.69,175538.7,mortgage,53,3
6,175538.7,1331.44,579.28,752.16,174786.54,mortgage,53,3
7,174786.54,1331.44,576.8,754.64,174031.9,mortgage,53,3
8,174031.9,1331.44,574.31,757.13,173274.77,mortgage,53,3
9,173274.77,1331.44,571.81,759.63,172515.14,mortgage,53,3
10,172515.14,1394.09,569.3,824.79,171690.35,mortgage,53,3
11,171690.35,2486.06,566.58,1919.48,169770.87,mortgage,53,3
12,169770.87,2486.06,560.24,1925.82,167845.05,mortgage,53,3
13,167845.05,2486.06,553.89,1932.17,165912.88,mortgage,53,3
14,165912.88,2486.06,547.51,1938.55,163974.33,mortgage,53,3
15,163974.33,2486.06,541.12,1944.94,162029.39,mortgage,53,3
16,162029.39,2486.06,534.7,1951.36,160078.03,mortgage,53,3
17,160078.03,2486.06,528.26,1957.8,158120.23,mortgage,53,3
18,158120.23,2486.06,521.8,1964.26,156155.97,mortgage,53,3
19,156155.97,2486.06,515.31,1970.75,154185.22,mortgage,53,3
20,154185.22,2486.06,508.81,1977.25,152207.97,mortgage,53,3
21,152207.97,2486.06,502.29,1983.77,150224.2,mortgage,53,3
22,150224.2,2486.06,495.74,1990.32,148233.88,mortgage,53,3
23,148233.88,2486.06,489.17,1996.89,146236.99,mortgage,53,3
24,146236.99,2486.06,482.58,2003.48,144233.51,mortgage,53,3
25,144233.51,2486.06,475.97,2010.09,142223.42,mortgage,53,3
26,142223.42,2486.06,469.34,2016.72,140206.7,mortgage,53,3
27,140206.7,2486.06,462.68,2023.38,138183.32,mortgage,53,3
28,138183.32,2486.06,456.0,2030.06,136153.26,mortgage,53,3
29,136153.26,2486.06,449.31,2036.75,134116.51,mortgage,53,3
30,134116.51,2486.06,442.58,2043.48,132073.03,mortgage,53,3
31,132073.03,2486.06,435.84,2050.22,130022.81,mortgage,53,3
32,130022.81,2486.06,429.08,2056.98,127965.83,mortgage,53,3
33,127965.83,2486.06,422.29,2063.77,125902.06,mortgage,53,3
34,125902.06,2486.06,415.48,2070.58,123831.48,mortgage,53,3
35,123831.48,2486.06,408.64,2077.42,121754.06,mortgage,53,3
36,121754.06,2486.06,401.79,2084.27,119669.79,mortgage,53,3
37,119669.79,2486.06,394.91,2091.15,117578.64,mortgage,53,3
38,117578.64,2486.06,388.01,2098.05,115480.59,mortgage,53,3
39,115480.59,2486.06,381.09,2104.97,113375.62,mortgage,53,3
40,113375.62,2486.06,374.14,2111.92,111263.7,mortgage,53,3
41,111263.7,2486.06,367.17,2118.89,109144.81,mortgage,53,3
42,109144.81,2486.06,360.18,2125.88,107018.93,mortgage,53,3
43,107018.93,2486.06,353.16,2132.9,104886.03,mortgage,53,3
44,104886.03,2486.06,346.12,2139.94,102746.09,mortgage,53,3
45,102746.09,2486.06,339.06,2147.0,100599.09,mortgage,53,3
46,100599.09,2486.06,331.98,2154.08,98445.01,mortgage,53,3
47,98445.01,2486.06,324.87,2161.19,96283.82,mortgage,53,3
48,96283.82,2486.06,317.74,2168.32,94115.5,mortgage,53,3
49,94115.5,2486.06,310.58,2175.48,91940.02,mortgage,53,3
50,91940.02,2486.06,303.4,2182.66,89757.36,mortgage,53,3
51,89757.36,2486.06,296.2,2189.86,87567.5,mortgage,53,3
52,87567.5,2486.06,288.97,2197.09,85370.41,mortgage,53,3
53,85370.41,2486.06,281.72,2204.34,83166.07,mortgage,53,3
54,83166.07,2486.06,274.45,2211.61,80954.46,mortgage,53,3
55,80954.46,2486.06,267.15,2218.91,78735.55,mortgage,53,3
56,78735.55,2486.06,259.83,2226.23,76509.32,mortgage,53,3
57,76509.32,2486.06,252.48,2233.58,74275.74,mortgage,53,3
58,74275.74,2486.06,245.11,2240.95,72034.79,mortgage,53,3
59,72034.79,2486.06,237.71,2248.35,69786.44,mortgage,53,3
60,69786.44,2486.06,230.3,2255.76,67530.68,mortgage,53,3
61,67530.68,2486.06,222.85,2263.21,65267.47,mortgage,53,3
62,65267.47,2486.06,215.38,2270.68,62996.79,mortgage,53,3
63,62996.79,2486.06,207.89,2278.17,60718.62,mortgage,53,3
64,60718.62,2486.06,200.37,2285.69,58432.93,mortgage,53,3
65,58432.93,2486.06,192.83,2293.23,56139.7,mortgage,53,3
66,56139.7,2486.06,185.26,2300.8,53838.9,mortgage,53,3
67,53838.9,2486.06,177.67,2308.39,51530.51,mortgage,53,3
68,51530.51,2486.06,170.05,2316.01,49214.5,mortgage,53,3
69,49214.5,2486.06,162.41,2323.65,46890.85,mortgage,53,3
70,46890.85,2486.06,154.74,2331.32,44559.53,mortgage,53,3
71,44559.53,2486.06,147.05,2339.01,42220.52,mortgage,53,3
72,42220.52,2486.06,139.33,2346.73,39873.79,mortgage,53,3
73,39873.79,2486.06,131.58,2354.48,37519.31,mortgage,53,3
74,37519.31,2486.06,123.81,2362.25,35157.06,mortgage,53,3
75,35157.06,2486.06,116.02,2370.04,32787.02,mortgage,53,3
76,32787.02,2486.06,108.2,2377.86,30409.16,mortgage,53,3
77,30409.16,2486.06,100.35,2385.71,28023.45,mortgage,53,3
78,28023.45,2486.06,92.48,2393.58,25629.87,mortgage,53,3
79,25629.87,2486.06,84.58,2401.48,23228.39,mortgage,53,3
80,23228.39,2486.06,76.65,2409.41,20818.98,mortgage,53,3
81,20818.98,2486.06,68.7,2417.36,18401.62,mortgage,53,3
82,18401.62,2486.06,60.73,2425.33,15976.29,mortgage,53,3
83,15976.29,2486.06,52.72,2433.34,13542.95,mortgage,53,3
84,13542.95,2486.06,44.69,2441.37,11101.58,mortgage,53,3
85,11101.58,2486.06,36.64,2449.42,8652.16,mortgage,53,3
86,8652.16,2486.06,28.55,2457.51,6194.65,mortgage,53,3
87,6194.65,2486.06,20.44,2465.62,3729.03,mortgage,53,3
88,3729.03,2486.06,12.31,2473.75,1255.28,mortgage,53,3
89,1255.28,2486.06,4.14,2481.92,-1226.64,mortgage,53,3
0,5000.0,333.0,36.0,297.0,4703.0,Car,53,4
1,4703.0,333.0,33.86,299.14,4403.86,Car,53,4
2,4403.86,333.0,31.71,301.29,4102.57,Car,53,4
3,4102.57,333.0,29.54,303.46,3799.11,Car,53,4
4,3799.11,333.0,27.35,305.65,3493.46,Car,53,4
5,3493.46,333.0,25.15,307.85,3185.61,Car,53,4
6,3185.61,333.0,22.94,310.06,2875.55,Car,53,4
7,2875.55,333.0,20.7,312.3,2563.25,Car,53,4
8,2563.25,333.0,18.46,314.54,2248.71,Car,53,4
9,2248.71,333.0,16.19,316.81,1931.9,Car,53,4
10,1931.9,333.0,13.91,319.09,1612.81,Car,53,4
11,1612.81,333.0,11.61,321.39,1291.42,Car,53,4
12,1291.42,333.0,9.3,323.7,967.72,Car,53,4
13,967.72,333.0,6.97,326.03,641.69,Car,53,4
14,641.69,333.0,4.62,328.38,313.31,Car,53,4
15,313.31,333.0,2.26,330.74,-17.43,Car,53,4
0,20000.0,191.04,108.0,83.04,19916.96,WellsFargo2,53,5
1,19916.96,191.04,107.55,83.49,19833.47,WellsFargo2,53,5
2,19833.47,191.04,107.1,83.94,19749.53,WellsFargo2,53,5
3,19749.53,191.04,106.65,84.39,19665.14,WellsFargo2,53,5
4,19665.14,191.04,106.19,84.85,19580.29,WellsFargo2,53,5
5,19580.29,191.04,105.73,85.31,19494.98,WellsFargo2,53,5
6,19494.98,191.04,105.27,85.77,19409.21,WellsFargo2,53,5
7,19409.21,191.04,104.81,86.23,19322.98,WellsFargo2,53,5
8,19322.98,191.04,104.34,86.7,19236.28,WellsFargo2,53,5
9,19236.28,191.04,103.88,87.16,19149.12,WellsFargo2,53,5
10,19149.12,191.04,103.41,87.63,19061.49,WellsFargo2,53,5
11,19061.49,191.04,102.93,88.11,18973.38,WellsFargo2,53,5
12,18973.38,191.04,102.46,88.58,18884.8,WellsFargo2,53,5
13,18884.8,191.04,101.98,89.06,18795.74,WellsFargo2,53,5
14,18795.74,191.04,101.5,89.54,18706.2,WellsFargo2,53,5
15,18706.2,208.47,101.01,107.46,18598.74,WellsFargo2,53,5
16,18598.74,3010.1,100.43,2909.67,15689.07,WellsFargo2,53,5
17,15689.07,3010.1,84.72,2925.38,12763.69,WellsFargo2,53,5
18,12763.69,3010.1,68.92,2941.18,9822.51,WellsFargo2,53,5
19,9822.51,3010.1,53.04,2957.06,6865.45,WellsFargo2,53,5
20,6865.45,3010.1,37.07,2973.03,3892.42,WellsFargo2,53,5
21,3892.42,3010.1,21.02,2989.08,903.34,WellsFargo2,53,5
22,903.34,3010.1,4.88,3005.22,-2101.88,WellsFargo2,53,5
0,8250.57,1084.62,53.63,1030.99,7219.58,WellsFargo1,54,1
1,7219.58,1084.62,46.93,1037.69,6181.89,WellsFargo1,54,1
2,6181.89,1084.62,40.18,1044.44,5137.45,WellsFargo1,54,1
3,5137.45,1084.62,33.39,1051.23,4086.22,WellsFargo1,54,1
4,4086.22,1084.62,26.56,1058.06,3028.16,WellsFargo1,54,1
5,3028.16,1084.62,19.68,1064.94,1963.22,WellsFargo1,54,1
6,1963.22,1084.62,12.76,1071.86,891.36,WellsFargo1,54,1
7,891.36,1084.62,5.79,1078.83,-187.47,WellsFargo1,54,1
0,4000.0,70.0,16.0,54.0,3946.0,testing,54,2
1,3946.0,70.0,15.78,54.22,3891.78,testing,54,2
2,3891.78,70.0,15.57,54.43,3837.35,testing,54,2
3,3837.35,70.0,15.35,54.65,3782.7,testing,54,2
4,3782.7,70.0,15.13,54.87,3727.83,testing,54,2
5,3727.83,70.0,14.91,55.09,3672.74,testing,54,2
6,3672.74,70.0,14.69,55.31,3617.43,testing,54,2
7,3617.43,257.47,14.47,243.0,3374.43,testing,54,2
8,3374.43,1154.62,13.5,1141.12,2233.31,testing,54,2
9,2233.31,1154.62,8.93,1145.69,1087.62,testing,54,2
10,1087.62,1154.62,4.35,1150.27,-62.65,testing,54,2
0,180000.0,1331.44,594.0,737.44,179262.56,mortgage,54,3
1,179262.56,1331.44,591.57,739.87,178522.69,mortgage,54,3
2,178522.69,1331.44,589.12,742.32,177780.37,mortgage,54,3
3,177780.37,1331.44,586.68,744.76,177035.61,mortgage,54,3
4,177035.61,1331.44,584.22,747.22,176288.39,mortgage,54,3
5,176288.39,1331.44,581.75,749.69,175538.7,mortgage,54,3
6,175538.7,1331.44,579.28,752.16,174786.54,mortgage,54,3
7,174786.54,1331.44,576.8,754.64,174031.9,mortgage,54,3
8,174031.9,1331.44,574.31,757.13,173274.77,mortgage,54,3
9,173274.77,1331.44,571.81,759.63,172515.14,mortgage,54,3
10,172515.14,1394.09,569.3,824.79,171690.35,mortgage,54,3
11,171690.35,2486.06,566.58,1919.48,169770.87,mortgage,54,3
12,169770.87,2486.06,560.24,1925.82,167845.05,mortgage,54,3
13,167845.05,2486.06,553.89,1932.17,165912.88,mortgage,54,3
14,165912.88,2486.06,547.51,1938.55,163974.33,mortgage,54,3
15,163974.33,2486.06,541.12,1944.94,162029.39,mortgage,54,3
16,162029.39,2486.06,534.7,1951.36,160078.03,mortgage,54,3
17,160078.03,2486.06,528.26,1957.8,158120.23,mortgage,54,3
18,158120.23,2486.06,521.8,1964.26,156155.97,mortgage,54,3
19,156155.97,2486.06,515.31,1970.75,154185.22,mortgage,54,3
20,154185.22,2486.06,508.81,1977.25,152207.97,mortgage,54,3
21,152207.97,2486.06,502.29,1983.77,150224.2,mortgage,54,3
22,150224.2,2486.06,495.74,1990.32,148233.88,mortgage,54,3
23,148233.88,2486.06,489.17,1996.89,146236.99,mortgage,54,3
24,146236.99,2486.06,482.58,2003.48,144233.51,mortgage,54,3
25,144233.51,2486.06,475.97,2010.09,142223.42,mortgage,54,3
26,142223.42,2486.06,469.34,2016.72,140206.7,mortgage,54,3
27,140206.7,2486.06,462.68,2023.38,138183.32,mortgage,54,3
28,138183.32,2486.06,456.0,2030.06,136153.26,mortgage,54,3
29,136153.26,2486.06,449.31,2036.75,134116.51,mortgage,54,3
30,134116.51,2486.06,442.58,2043.48,132073.03,mortgage,54,3
31,132073.03,2486.06,435.84,2050.22,130022.81,mortgage,54,3
32,130022.81,2486.06,429.08,2056.98,127965.83,mortgage,54,3
33,127965.83,2486.06,422.29,2063.77,125902.06,mortgage,54,3
34,125902.06,2486.06,415.48,2070.58,123831.48,mortgage,54,3
35,123831.48,2486.06,408.64,2077.42,121754.06,mortgage,54,3
36,121754.06,2486.06,401.79,2084.27,119669.79,mortgage,54,3
37,119669.79,2486.06,394.91,2091.15,117578.64,mortgage,54,3
38,117578.64,2486.06,388.01,2098.05,115480.59,mortgage,54,3
39,115480.59,2486.06,381.09,2104.97,113375.62,mortgage,54,3
40,113375.62,2486.06,374.14,2111.92,111263.7,mortgage,54,3
41,111263.7,2486.06,367.17,2118.89,109144.81,mortgage,54,3
42,109144.81,2486.06,360.18,2125.88,107018.93,mortgage,54,3
43,107018.93,2486.06,353.16,2132.9,104886.03,mortgage,54,3
44,104886.03,2486.06,346.12,2139.94,102746.09,mortgage,54,3
45,102746.09,2486.06,339.06,2147.0,100599.09,mortgage,54,3
46,100599.09,2486.06,331.98,2154.08,98445.01,mortgage,54,3
47,98445.01,2486.06,324.87,2161.19,96283.82,mortgage,54,3
48,96283.82,2486.06,317.74,2168.32,94115.5,mortgage,54,3
49,94115.5,2486.06,310.58,2175.48,91940.02,mortgage,54,3
50,91940.02,2486.06,303.4,2182.66,89757.36,mortgage,54,3
51,89757.36,2486.06,296.2,2189.86,87567.5,mortgage,54,3
52,87567.5,2486.06,288.97,2197.09,85370.41,mortgage,54,3
53,85370.41,2486.06,281.72,2204.34,83166.07,mortgage,54,3
54,83166.07,2486.06,274.45,2211.61,80954.46,mortgage,54,3
55,80954.46,2486.06,267.15,2218.91,78735.55,mortgage,54,3
56,78735.55,2486.06,259.83,2226.23,76509.32,mortgage,54,3
57,76509.32,2486.06,252.48,2233.58,74275.74,mortgage,54,3
58,74275.74,2486.06,245.11,2240.95,72034.79,mortgage,54,3
59,72034.79,2486.06,237.71,2248.35,69786.44,mortgage,54,3
60,69786.44,2486.06,230.3,2255.76,67530.68,mortgage,54,3
61,67530.68,2486.06,222.85,2263.21,65267.47,mortgage,54,3
62,65267.47,2486.06,215.38,2270.68,62996.79,mortgage,54,3
63,62996.79,2486.06,207.89,2278.17,60718.62,mortgage,54,3
64,60718.62,2486.06,200.37,2285.69,58432.93,mortgage,54,3
65,58432.93,2486.06,192.83,2293.23,56139.7,mortgage,54,3
66,56139.7,2486.06,185.26,2300.8,53838.9,mortgage,54,3
67,53838.9,2486.06,177.67,2308.39,51530.51,mortgage,54,3
68,51530.51,2486.06,170.05,2316.01,49214.5,mortgage,54,3
69,49214.5,2486.06,162.41,2323.65,46890.85,mortgage,54,3
70,46890.85,2486.06,154.74,2331.32,44559.53,mortgage,54,3
71,44559.53,2486.06,147.05,2339.01,42220.52,mortgage,54,3
72,42220.52,2486.06,139.33,2346.73,39873.79,mortgage,54,3
73,39873.79,2486.06,131.58,2354.48,37519.31,mortgage,54,3
74,37519.31,2486.06,123.81,2362.25,35157.06,mortgage,54,3
75,35157.06,2486.06,116.02,2370.04,32787.02,mortgage,54,3
76,32787.02,2486.06,108.2,2377.86,30409.16,mortgage,54,3
77,30409.16,2486.06,100.35,2385.71,28023.45,mortgage,54,3
78,28023.45,2486.06,92.48,2393.58,25629.87,mortgage,54,3
79,25629.87,2486.06,84.58,2401.48,23228.39,mortgage,54,3
80,23228.39,2486.06,76.65,2409.41,20818.98,mortgage,54,3
81,20818.98,2486.06,68.7,2417.36,18401.62,mortgage,54,3
82,18401.62,2486.06,60.73,2425.33,15976.29,mortgage,54,3
83,15976.29,2486.06,52.72,2433.34,13542.95,mortgage,54,3
84,13542.95,2486.06,44.69,2441.37,11101.58,mortgage,54,3
85,11101.58,2486.06,36.64,2449.42,8652.16,mortgage,54,3
86,8652.16,2486.06,28.55,2457.51,6194.65,mortgage,54,3
87,6194.65,2486.06,20.44,2465.62,3729.03,mortgage,54,3
88,3729.03,2486.06,12.31,2473.75,1255.28,mortgage,54,3
89,1255.28,2486.06,4.14,2481.92,-1226.64,mortgage,54,3
0,20000.0,191.04,108.0,83.04,19916.96,WellsFargo2,54,4
1,19916.96,191.04,107.55,83.49,19833.47,WellsFargo2,54,4
2,19833.47,191.04,107.1,83.94,19749.53,WellsFargo2,54,4
3,19749.53,191.04,106.65,84.39,19665.14,WellsFargo2,54,4
4,19665.14,191.04,106.19,84.85,19580.29,WellsFargo2,54,4
5,19580.29,191.04,105.73,85.31,19494.98,WellsFargo2,54,4
6,19494.98,191.04,105.27,85.77,19409.21,WellsFargo2,54,4
7,19409.21,191.04,104.81,86.23,19322.98,WellsFargo2,54,4
8,19322.98,191.04,104.34,86.7,19236.28,WellsFargo2,54,4
9,19236.28,191.04,103.88,87.16,19149.12,WellsFargo2,54,4
10,19149.12,191.04,103.41,87.63,19061.49,WellsFargo2,54,4
11,19061.49,191.04,102.93,88.11,18973.38,WellsFargo2,54,4
12,18973.38,191.04,102.46,88.58,18884.8,WellsFargo2,54,4
13,18884.8,191.04,101.98,89.06,18795.74,WellsFargo2,54,4
14,18795.74,191.04,101.5,89.54,18706.2,WellsFargo2,54,4
15,18706.2,191.04,101.01,90.03,18616.17,WellsFargo2,54,4
16,18616.17,191.04,100.53,90.51,18525.66,WellsFargo2,54,4
17,18525.66,191.04,100.04,91.0,18434.66,WellsFargo2,54,4
18,18434.66,191.04,99.55,91.49,18343.17,WellsFargo2,54,4
19,18343.17,191.04,99.05,91.99,18251.18,WellsFargo2,54,4
20,18251.18,191.04,98.56,92.48,18158.7,WellsFargo2,54,4
21,18158.7,191.04,98.06,92.98,18065.72,WellsFargo2,54,4
22,18065.72,191.04,97.55,93.49,17972.23,WellsFargo2,54,4
23,17972.23,191.04,97.05,93.99,17878.24,WellsFargo2,54,4
24,17878.24,191.04,96.54,94.5,17783.74,WellsFargo2,54,4
25,17783.74,191.04,96.03,95.01,17688.73,WellsFargo2,54,4
26,17688.73,191.04,95.52,95.52,17593.21,WellsFargo2,54,4
27,17593.21,191.04,95.0,96.04,17497.17,WellsFargo2,54,4
28,17497.17,191.04,94.48,96.56,17400.61,WellsFargo2,54,4
29,17400.61,191.04,93.96,97.08,17303.53,WellsFargo2,54,4
30,17303.53,191.04,93.44,97.6,17205.93,WellsFargo2,54,4
31,17205.93,191.04,92.91,98.13,17107.8,WellsFargo2,54,4
32,17107.8,191.04,92.38,98.66,17009.14,WellsFargo2,54,4
33,17009.14,191.04,91.85,99.19,16909.95,WellsFargo2,54,4
34,16909.95,191.04,91.31,99.73,16810.22,WellsFargo2,54,4
35,16810.22,191.04,90.78,100.26,16709.96,WellsFargo2,54,4
36,16709.96,191.04,90.23,100.81,16609.15,WellsFargo2,54,4
37,16609.15,191.04,89.69,101.35,16507.8,WellsFargo2,54,4
38,16507.8,191.04,89.14,101.9,16405.9,WellsFargo2,54,4
39,16405.9,191.04,88.59,102.45,16303.45,WellsFargo2,54,4
40,16303.45,191.04,88.04,103.0,16200.45,WellsFargo2,54,4
41,16200.45,191.04,87.48,103.56,16096.89,WellsFargo2,54,4
42,16096.89,191.04,86.92,104.12,15992.77,WellsFargo2,54,4
43,15992.77,191.04,86.36,104.68,15888.09,WellsFargo2,54,4
44,15888.09,191.04,85.8,105.24,15782.85,WellsFargo2,54,4
45,15782.85,191.04,85.23,105.81,15677.04,WellsFargo2,54,4
46,15677.04,191.04,84.66,106.38,15570.66,WellsFargo2,54,4
47,15570.66,191.04,84.08,106.96,15463.7,WellsFargo2,54,4
48,15463.7,191.04,83.5,107.54,15356.16,WellsFargo2,54,4
49,15356.16,191.04,82.92,108.12,15248.04,WellsFargo2,54,4
50,15248.04,191.04,82.34,108.7,15139.34,WellsFargo2,54,4
51,15139.34,191.04,81.75,109.29,15030.05,WellsFargo2,54,4
52,15030.05,191.04,81.16,109.88,14920.17,WellsFargo2,54,4
53,14920.17,191.04,80.57,110.47,14809.7,WellsFargo2,54,4
54,14809.7,191.04,79.97,111.07,14698.63,WellsFargo2,54,4
55,14698.63,191.04,79.37,111.67,14586.96,WellsFargo2,54,4
56,14586.96,191.04,78.77,112.27,14474.69,WellsFargo2,54,4
57,14474.69,191.04,78.16,112.88,14361.81,WellsFargo2,54,4
58,14361.81,191.04,77.55,113.49,14248.32,WellsFargo2,54,4
59,14248.32,191.04,76.94,114.1,14134.22,WellsFargo2,54,4
60,14134.22,191.04,76.32,114.72,14019.5,WellsFargo2,54,4
61,14019.5,191.04,75.71,115.33,13904.17,WellsFargo2,54,4
62,13904.17,191.04,75.08,115.96,13788.21,WellsFargo2,54,4
63,13788.21,191.04,74.46,116.58,13671.63,WellsFargo2,54,4
64,13671.63,191.04,73.83,117.21,13554.42,WellsFargo2,54,4
65,13554.42,191.04,73.19,117.85,13436.57,WellsFargo2,54,4
66,13436.57,191.04,72.56,118.48,13318.09,WellsFargo2,54,4
67,13318.09,191.04,71.92,119.12,13198.97,WellsFargo2,54,4
68,13198.97,191.04,71.27,119.77,13079.2,WellsFargo2,54,4
69,13079.2,191.04,70.63,120.41,12958.79,WellsFargo2,54,4
70,12958.79,191.04,69.98,121.06,12837.73,WellsFargo2,54,4
71,12837.73,191.04,69.32,121.72,12716.01,WellsFargo2,54,4
72,12716.01,191.04,68.67,122.37,12593.64,WellsFargo2,54,4
73,12593.64,191.04,68.01,123.03,12470.61,WellsFargo2,54,4
74,12470.61,191.04,67.34,123.7,12346.91,WellsFargo2,54,4
75,12346.91,191.04,66.67,124.37,12222.54,WellsFargo2,54,4
76,12222.54,191.04,66.0,125.04,12097.5,WellsFargo2,54,4
77,12097.5,191.04,65.33,125.71,11971.79,WellsFargo2,54,4
78,11971.79,191.04,64.65,126.39,11845.4,WellsFargo2,54,4
79,11845.4,191.04,63.97,127.07,11718.33,WellsFargo2,54,4
80,11718.33,191.04,63.28,127.76,11590.57,WellsFargo2,54,4
81,11590.57,191.04,62.59,128.45,11462.12,WellsFargo2,54,4
82,11462.12,191.04,61.9,129.14,11332.98,WellsFargo2,54,4
83,11332.98,191.04,61.2,129.84,11203.14,WellsFargo2,54,4
84,11203.14,191.04,60.5,130.54,11072.6,WellsFargo2,54,4
85,11072.6,191.04,59.79,131.25,10941.35,WellsFargo2,54,4
86,10941.35,191.04,59.08,131.96,10809.39,WellsFargo2,54,4
87,10809.39,191.04,58.37,132.67,10676.72,WellsFargo2,54,4
88,10676.72,191.04,57.65,133.39,10543.33,WellsFargo2,54,4
89,10543.33,1417.68,56.93,1360.75,9182.58,WellsFargo2,54,4
90,9182.58,2677.1,49.59,2627.51,6555.07,WellsFargo2,54,4
91,6555.07,2677.1,35.4,2641.7,3913.37,WellsFargo2,54,4
92,3913.37,2677.1,21.13,2655.97,1257.4,WellsFargo2,54,4
93,1257.4,2677.1,6.79,2670.31,-1412.91,WellsFargo2,54,4
0,5000.0,333.0,36.0,297.0,4703.0,Car,54,5
1,4703.0,333.0,33.86,299.14,4403.86,Car,54,5
2,4403.86,333.0,31.71,301.29,4102.57,Car,54,5
3,4102.57,333.0,29.54,303.46,3799.11,Car,54,5
4,3799.11,333.0,27.35,305.65,3493.46,Car,54,5
5,3493.46,333.0,25.15,307.85,3185.61,Car,54,5
6,3185.61,333.0,22.94,310.06,2875.55,Car,54,5
7,2875.55,333.0,20.7,312.3,2563.25,Car,54,5
8,2563.25,333.0,18.46,314.54,2248.71,Car,54,5
9,2248.71,333.0,16.19,316.81,1931.9,Car,54,5
10,1931.9,333.0,13.91,319.09,1612.81,Car,54,5
11,1612.81,333.0,11.61,321.39,1291.42,Car,54,5
12,1291.42,333.0,9.3,323.7,967.72,Car,54,5
13,967.72,333.0,6.97,326.03,641.69,Car,54,5
14,641.69,333.0,4.62,328.38,313.31,Car,54,5
15,313.31,333.0,2.26,330.74,-17.43,Car,54,5
0,8250.57,1084.62,53.63,1030.99,7219.58,WellsFargo1,55,1
1,7219.58,1084.62,46.93,1037.69,6181.89,WellsFargo1,55,1
2,6181.89,1084.62,40.18,1044.44,5137.45,WellsFargo1,55,1
3,5137.45,1084.62,33.39,1051.23,4086.22,WellsFargo1,55,1
4,4086.22,1084.62,26.56,1058.06,3028.16,WellsFargo1,55,1
5,3028.16,1084.62,19.68,1064.94,1963.22,WellsFargo1,55,1
6,1963.22,1084.62,12.76,1071.86,891.36,WellsFargo1,55,1
7,891.36,1084.62,5.79,1078.83,-187.47,WellsFargo1,55,1
0,5000.0,333.0,36.0,297.0,4703.0,Car,55,2
1,4703.0,333.0,33.86,299.14,4403.86,Car,55,2
2,4403.86,333.0,31.71,301.29,4102.57,Car,55,2
3,4102.57,333.0,29.54,303.46,3799.11,Car,55,2
4,3799.11,333.0,27.35,305.65,3493.46,Car,55,2
5,3493.46,333.0,25.15,307.85,3185.61,Car,55,2
6,3185.61,333.0,22.94,310.06,2875.55,Car,55,2
7,2875.55,520.47,20.7,499.77,2375.78,Car,55,2
8,2375.78,1417.62,17.11,1400.51,975.27,Car,55,2
9,975.27,1417.62,7.02,1410.6,-435.33,Car,55,2
0,4000.0,70.0,16.0,54.0,3946.0,testing,55,3
1,3946.0,70.0,15.78,54.22,3891.78,testing,55,3
2,3891.78,70.0,15.57,54.43,3837.35,testing,55,3
3,3837.35,70.0,15.35,54.65,3782.7,testing,55,3
4,3782.7,70.0,15.13,54.87,3727.83,testing,55,3
5,3727.83,70.0,14.91,55.09,3672.74,testing,55,3
6,3672.74,70.0,14.69,55.31,3617.43,testing,55,3
7,3617.43,70.0,14.47,55.53,3561.9,testing,55,3
8,3561.9,70.0,14.25,55.75,3506.15,testing,55,3
9,3506.15,505.33,14.02,491.31,3014.84,testing,55,3
10,3014.84,1487.62,12.06,1475.56,1539.28,testing,55,3
11,1539.28,1487.62,6.16,1481.46,57.82,testing,55,3
12,57.82,1487.62,0.23,1487.39,-1429.57,testing,55,3
0,20000.0,191.04,108.0,83.04,19916.96,WellsFargo2,55,4
1,19916.96,191.04,107.55,83.49,19833.47,WellsFargo2,55,4
2,19833.47,191.04,107.1,83.94,19749.53,WellsFargo2,55,4
3,19749.53,191.04,106.65,84.39,19665.14,WellsFargo2,55,4
4,19665.14,191.04,106.19,84.85,19580.29,WellsFargo2,55,4
5,19580.29,191.04,105.73,85.31,19494.98,WellsFargo2,55,4
6,19494.98,191.04,105.27,85.77,19409.21,WellsFargo2,55,4
7,19409.21,191.04,104.81,86.23,19322.98,WellsFargo2,55,4
8,19322.98,191.04,104.34,86.7,19236.28,WellsFargo2,55,4
9,19236.28,191.04,103.88,87.16,19149.12,WellsFargo2,55,4
10,19149.12,191.04,103.41,87.63,19061.49,WellsFargo2,55,4
11,19061.49,191.04,102.93,88.11,18973.38,WellsFargo2,55,4
12,18973.38,1620.61,102.46,1518.15,17455.23,WellsFargo2,55,4
13,17455.23,1678.66,94.26,1584.4,15870.83,WellsFargo2,55,4
14,15870.83,1678.66,85.7,1592.96,14277.87,WellsFargo2,55,4
15,14277.87,1678.66,77.1,1601.56,12676.31,WellsFargo2,55,4
16,12676.31,1678.66,68.45,1610.21,11066.1,WellsFargo2,55,4
17,11066.1,1678.66,59.76,1618.9,9447.2,WellsFargo2,55,4
18,9447.2,1678.66,51.01,1627.65,7819.55,WellsFargo2,55,4
19,7819.55,1678.66,42.23,1636.43,6183.12,WellsFargo2,55,4
20,6183.12,1678.66,33.39,1645.27,4537.85,WellsFargo2,55,4
21,4537.85,1678.66,24.5,1654.16,2883.69,WellsFargo2,55,4
22,2883.69,1678.66,15.57,1663.09,1220.6,WellsFargo2,55,4
23,1220.6,1678.66,6.59,1672.07,-451.47,WellsFargo2,55,4
0,180000.0,1331.44,594.0,737.44,179262.56,mortgage,55,5
1,179262.56,1331.44,591.57,739.87,178522.69,mortgage,55,5
2,178522.69,1331.44,589.12,742.32,177780.37,mortgage,55,5
3,177780.37,1331.44,586.68,744.76,177035.61,mortgage,55,5
4,177035.61,1331.44,584.22,747.22,176288.39,mortgage,55,5
5,176288.39,1331.44,581.75,749.69,175538.7,mortgage,55,5
6,175538.7,1331.44,579.28,752.16,174786.54,mortgage,55,5
7,174786.54,1331.44,576.8,754.64,174031.9,mortgage,55,5
8,174031.9,1331.44,574.31,757.13,173274.77,mortgage,55,5
9,173274.77,1331.44,571.81,759.63,172515.14,mortgage,55,5
10,172515.14,1331.44,569.3,762.14,171753.0,mortgage,55,5
11,171753.0,1331.44,566.78,764.66,170988.34,mortgage,55,5
12,170988.34,1331.44,564.26,767.18,170221.16,mortgage,55,5
13,170221.16,1331.44,561.73,769.71,169451.45,mortgage,55,5
14,169451.45,1331.44,559.19,772.25,168679.2,mortgage,55,5
15,168679.2,1331.44,556.64,774.8,167904.4,mortgage,55,5
16,167904.4,1331.44,554.08,777.36,167127.04,mortgage,55,5
17,167127.04,1331.44,551.52,779.92,166347.12,mortgage,55,5
18,166347.12,1331.44,548.95,782.49,165564.63,mortgage,55,5
19,165564.63,1331.44,546.36,785.08,164779.55,mortgage,55,5
20,164779.55,1331.44,543.77,787.67,163991.88,mortgage,55,5
21,163991.88,1331.44,541.17,790.27,163201.61,mortgage,55,5
22,163201.61,1331.44,538.57,792.87,162408.74,mortgage,55,5
23,162408.74,1782.91,535.95,1246.96,161161.78,mortgage,55,5
24,161161.78,3010.1,531.83,2478.27,158683.51,mortgage,55,5
25,158683.51,3010.1,523.66,2486.44,156197.07,mortgage,55,5
26,156197.07,3010.1,515.45,2494.65,153702.42,mortgage,55,5
27,153702.42,3010.1,507.22,2502.88,151199.54,mortgage,55,5
28,151199.54,3010.1,498.96,2511.14,148688.4,mortgage,55,5
29,148688.4,3010.1,490.67,2519.43,146168.97,mortgage,55,5
30,146168.97,3010.1,482.36,2527.74,143641.23,mortgage,55,5
31,143641.23,3010.1,474.02,2536.08,141105.15,mortgage,55,5
32,141105.15,3010.1,465.65,2544.45,138560.7,mortgage,55,5
33,138560.7,3010.1,457.25,2552.85,136007.85,mortgage,55,5
34,136007.85,3010.1,448.83,2561.27,133446.58,mortgage,55,5
35,133446.58,3010.1,440.37,2569.73,130876.85,mortgage,55,5
36,130876.85,3010.1,431.89,2578.21,128298.64,mortgage,55,5
37,128298.64,3010.1,423.39,2586.71,125711.93,mortgage,55,5
38,125711.93,3010.1,414.85,2595.25,123116.68,mortgage,55,5
39,123116.68,3010.1,406.29,2603.81,120512.87,mortgage,55,5
40,120512.87,3010.1,397.69,2612.41,117900.46,mortgage,55,5
41,117900.46,3010.1,389.07,2621.03,115279.43,mortgage,55,5
42,115279.43,3010.1,380.42,2629.68,112649.75,mortgage,55,5
43,112649.75,3010.1,371.74,2638.36,110011.39,mortgage,55,5
44,110011.39,3010.1,363.04,2647.06,107364.33,mortgage,55,5
45,107364.33,3010.1,354.3,2655.8,104708.53,mortgage,55,5
46,104708.53,3010.1,345.54,2664.56,102043.97,mortgage,55,5
47,102043.97,3010.1,336.75,2673.35,99370.62,mortgage,55,5
48,99370.62,3010.1,327.92,2682.18,96688.44,mortgage,55,5
49,96688.44,3010.1,319.07,2691.03,93997.41,mortgage,55,5
50,93997.41,3010.1,310.19,2699.91,91297.5,mortgage,55,5
51,91297.5,3010.1,301.28,2708.82,88588.68,mortgage,55,5
52,88588.68,3010.1,292.34,2717.76,85870.92,mortgage,55,5
53,85870.92,3010.1,283.37,2726.73,83144.19,mortgage,55,5
54,83144.19,3010.1,274.38,2735.72,80408.47,mortgage,55,5
55,80408.47,3010.1,265.35,2744.75,77663.72,mortgage,55,5
56,77663.72,3010.1,256.29,2753.81,74909.91,mortgage,55,5
57,74909.91,3010.1,247.2,2762.9,72147.01,mortgage,55,5
58,72147.01,3010.1,238.09,2772.01,69375.0,mortgage,55,5
59,69375.0,3010.1,228.94,2781.16,66593.84,mortgage,55,5
60,66593.84,3010.1,219.76,2790.34,63803.5,mortgage,55,5
61,63803.5,3010.1,210.55,2799.55,61003.95,mortgage,55,5
62,61003.95,3010.1,201.31,2808.79,58195.16,mortgage,55,5
63,58195.16,3010.1,192.04,2818.06,55377.1,mortgage,55,5
64,55377.1,3010.1,182.74,2827.36,52549.74,mortgage,55,5
65,52549.74,3010.1,173.41,2836.69,49713.05,mortgage,55,5
66,49713.05,3010.1,164.05,2846.05,46867.0,mortgage,55,5
67,46867.0,3010.1,154.66,2855.44,44011.56,mortgage,55,5
68,44011.56,3010.1,145.24,2864.86,41146.7,mortgage,55,5
69,41146.7,3010.1,135.78,2874.32,38272.38,mortgage,55,5
70,38272.38,3010.1,126.3,2883.8,35388.58,mortgage,55,5
71,35388.58,3010.1,116.78,2893.32,32495.26,mortgage,55,5
72,32495.26,3010.1,107.23,2902.87,29592.39,mortgage,55,5
73,29592.39,3010.1,97.65,2912.45,26679.94,mortgage,55,5
74,26679.94,3010.1,88.04,2922.06,23757.88,mortgage,55,5
75,23757.88,3010.1,78.4,2931.7,20826.18,mortgage,55,5
76,20826.18,3010.1,68.73,2941.37,17884.81,mortgage,55,5
77,17884.81,3010.1,59.02,2951.08,14933.73,mortgage,55,5
78,14933.73,3010.1,49.28,2960.82,11972.91,mortgage,55,5
79,11972.91,3010.1,39.51,2970.59,9002.32,mortgage,55,5
80,9002.32,3010.1,29.71,2980.39,6021.93,mortgage,55,5
81,6021.93,3010.1,19.87,2990.23,3031.7,mortgage,55,5
82,3031.7,3010.1,10.0,3000.1,31.6,mortgage,55,5
83,31.6,3010.1,0.1,3010.0,-2978.4,mortgage,55,5
0,8250.57,1084.62,53.63,1030.99,7219.58,WellsFargo1,56,1
1,7219.58,1084.62,46.93,1037.69,6181.89,WellsFargo1,56,1
2,6181.89,1084.62,40.18,1044.44,5137.45,WellsFargo1,56,1
3,5137.45,1084.62,33.39,1051.23,4086.22,WellsFargo1,56,1
4,4086.22,1084.62,26.56,1058.06,3028.16,WellsFargo1,56,1
5,3028.16,1084.62,19.68,1064.94,1963.22,WellsFargo1,56,1
6,1963.22,1084.62,12.76,1071.86,891.36,WellsFargo1,56,1
7,891.36,1084.62,5.79,1078.83,-187.47,WellsFargo1,56,1
0,5000.0,333.0,36.0,297.0,4703.0,Car,56,2
1,4703.0,333.0,33.86,299.14,4403.86,Car,56,2
2,4403.86,333.0,31.71,301.29,4102.57,Car,56,2
3,4102.57,333.0,29.54,303.46,3799.11,Car,56,2
4,3799.11,333.0,27.35,305.65,3493.46,Car,56,2
5,3493.46,333.0,25.15,307.85,3185.61,Car,56,2
6,3185.61,333.0,22.94,310.06,2875.55,Car,56,2
7,2875.55,520.47,20.7,499.77,2375.78,Car,56,2
8,2375.78,1417.62,17.11,1400.51,975.27,Car,56,2
9,975.27,1417.62,7.02,1410.6,-435.33,Car,56,2
0,4000.0,70.0,16.0,54.0,3946.0,testing,56,3
1,3946.0,70.0,15.78,54.22,3891.78,testing,56,3
2,3891.78,70.0,15.57,54.43,3837.35,testing,56,3
3,3837.35,70.0,15.35,54.65,3782.7,testing,56,3
4,3782.7,70.0,15.13,54.87,3727.83,testing,56,3
5,3727.83,70.0,14.91,55.09,3672.74,testing,56,3
6,3672.74,70.0,14.69,55.31,3617.43,testing,56,3
7,3617.43,70.0,14.47,55.53,3561.9,testing,56,3
8,3561.9,70.0,14.25,55.75,3506.15,testing,56,3
9,3506.15,505.33,14.02,491.31,3014.84,testing,56,3
10,3014.84,1487.62,12.06,1475.56,1539.28,testing,56,3
11,1539.28,1487.62,6.16,1481.46,57.82,testing,56,3
12,57.82,1487.62,0.23,1487.39,-1429.57,testing,56,3
0,180000.0,1331.44,594.0,737.44,179262.56,mortgage,56,4
1,179262.56,1331.44,591.57,739.87,178522.69,mortgage,56,4
2,178522.69,1331.44,589.12,742.32,177780.37,mortgage,56,4
3,177780.37,1331.44,586.68,744.76,177035.61,mortgage,56,4
4,177035.61,1331.44,584.22,747.22,176288.39,mortgage,56,4
5,176288.39,1331.44,581.75,749.69,175538.7,mortgage,56,4
6,175538.7,1331.44,579.28,752.16,174786.54,mortgage,56,4
7,174786.54,1331.44,576.8,754.64,174031.9,mortgage,56,4
8,174031.9,1331.44,574.31,757.13,173274.77,mortgage,56,4
9,173274.77,1331.44,571.81,759.63,172515.14,mortgage,56,4
10,172515.14,1331.44,569.3,762.14,171753.0,mortgage,56,4
11,171753.0,1331.44,566.78,764.66,170988.34,mortgage,56,4
12,170988.34,2761.01,564.26,2196.75,168791.59,mortgage,56,4
13,168791.59,2819.06,557.01,2262.05,166529.54,mortgage,56,4
14,166529.54,2819.06,549.55,2269.51,164260.03,mortgage,56,4
15,164260.03,2819.06,542.06,2277.0,161983.03,mortgage,56,4
16,161983.03,2819.06,534.54,2284.52,159698.51,mortgage,56,4
17,159698.51,2819.06,527.01,2292.05,157406.46,mortgage,56,4
18,157406.46,2819.06,519.44,2299.62,155106.84,mortgage,56,4
19,155106.84,2819.06,511.85,2307.21,152799.63,mortgage,56,4
20,152799.63,2819.06,504.24,2314.82,150484.81,mortgage,56,4
21,150484.81,2819.06,496.6,2322.46,148162.35,mortgage,56,4
22,148162.35,2819.06,488.94,2330.12,145832.23,mortgage,56,4
23,145832.23,2819.06,481.25,2337.81,143494.42,mortgage,56,4
24,143494.42,2819.06,473.53,2345.53,141148.89,mortgage,56,4
25,141148.89,2819.06,465.79,2353.27,138795.62,mortgage,56,4
26,138795.62,2819.06,458.03,2361.03,136434.59,mortgage,56,4
27,136434.59,2819.06,450.23,2368.83,134065.76,mortgage,56,4
28,134065.76,2819.06,442.42,2376.64,131689.12,mortgage,56,4
29,131689.12,2819.06,434.57,2384.49,129304.63,mortgage,56,4
30,129304.63,2819.06,426.71,2392.35,126912.28,mortgage,56,4
31,126912.28,2819.06,418.81,2400.25,124512.03,mortgage,56,4
32,124512.03,2819.06,410.89,2408.17,122103.86,mortgage,56,4
33,122103.86,2819.06,402.94,2416.12,119687.74,mortgage,56,4
34,119687.74,2819.06,394.97,2424.09,117263.65,mortgage,56,4
35,117263.65,2819.06,386.97,2432.09,114831.56,mortgage,56,4
36,114831.56,2819.06,378.94,2440.12,112391.44,mortgage,56,4
37,112391.44,2819.06,370.89,2448.17,109943.27,mortgage,56,4
38,109943.27,2819.06,362.81,2456.25,107487.02,mortgage,56,4
39,107487.02,2819.06,354.71,2464.35,105022.67,mortgage,56,4
40,105022.67,2819.06,346.57,2472.49,102550.18,mortgage,56,4
41,102550.18,2819.06,338.42,2480.64,100069.54,mortgage,56,4
42,100069.54,2819.06,330.23,2488.83,97580.71,mortgage,56,4
43,97580.71,2819.06,322.02,2497.04,95083.67,mortgage,56,4
44,95083.67,2819.06,313.78,2505.28,92578.39,mortgage,56,4
45,92578.39,2819.06,305.51,2513.55,90064.84,mortgage,56,4
46,90064.84,2819.06,297.21,2521.85,87542.99,mortgage,56,4
47,87542.99,2819.06,288.89,2530.17,85012.82,mortgage,56,4
48,85012.82,2819.06,280.54,2538.52,82474.3,mortgage,56,4
49,82474.3,2819.06,272.17,2546.89,79927.41,mortgage,56,4
50,79927.41,2819.06,263.76,2555.3,77372.11,mortgage,56,4
51,77372.11,2819.06,255.33,2563.73,74808.38,mortgage,56,4
52,74808.38,2819.06,246.87,2572.19,72236.19,mortgage,56,4
53,72236.19,2819.06,238.38,2580.68,69655.51,mortgage,56,4
54,69655.51,2819.06,229.86,2589.2,67066.31,mortgage,56,4
55,67066.31,2819.06,221.32,2597.74,64468.57,mortgage,56,4
56,64468.57,2819.06,212.75,2606.31,61862.26,mortgage,56,4
57,61862.26,2819.06,204.15,2614.91,59247.35,mortgage,56,4
58,59247.35,2819.06,195.52,2623.54,56623.81,mortgage,56,4
59,56623.81,2819.06,186.86,2632.2,53991.61,mortgage,56,4
60,53991.61,2819.06,178.17,2640.89,51350.72,mortgage,56,4
61,51350.72,2819.06,169.46,2649.6,48701.12,mortgage,56,4
62,48701.12,2819.06,160.71,2658.35,46042.77,mortgage,56,4
63,46042.77,2819.06,151.94,2667.12,43375.65,mortgage,56,4
64,43375.65,2819.06,143.14,2675.92,40699.73,mortgage,56,4
65,40699.73,2819.06,134.31,2684.75,38014.98,mortgage,56,4
66,38014.98,2819.06,125.45,2693.61,35321.37,mortgage,56,4
67,35321.37,2819.06,116.56,2702.5,32618.87,mortgage,56,4
68,32618.87,2819.06,107.64,2711.42,29907.45,mortgage,56,4
69,29907.45,2819.06,98.69,2720.37,27187.08,mortgage,56,4
70,27187.08,2819.06,89.72,2729.34,24457.74,mortgage,56,4
71,24457.74,2819.06,80.71,2738.35,21719.39,mortgage,56,4
72,21719.39,2819.06,71.67,2747.39,18972.0,mortgage,56,4
73,18972.0,2819.06,62.61,2756.45,16215.55,mortgage,56,4
74,16215.55,2819.06,53.51,2765.55,13450.0,mortgage,56,4
75,13450.0,2819.06,44.38,2774.68,10675.32,mortgage,56,4
76,10675.32,2819.06,35.23,2783.83,7891.49,mortgage,56,4
77,7891.49,2819.06,26.04,2793.02,5098.47,mortgage,56,4
78,5098.47,2819.06,16.82,2802.24,2296.23,mortgage,56,4
79,2296.23,2819.06,7.58,2811.48,-515.25,mortgage,56,4
0,20000.0,191.04,108.0,83.04,19916.96,WellsFargo2,56,5
1,19916.96,191.04,107.55,83.49,19833.47,WellsFargo2,56,5
2,19833.47,191.04,107.1,83.94,19749.53,WellsFargo2,56,5
3,19749.53,191.04,106.65,84.39,19665.14,WellsFargo2,56,5
4,19665.14,191.04,106.19,84.85,19580.29,WellsFargo2,56,5
5,19580.29,191.04,105.73,85.31,19494.98,WellsFargo2,56,5
6,19494.98,191.04,105.27,85.77,19409.21,WellsFargo2,56,5
7,19409.21,191.04,104.81,86.23,19322.98,WellsFargo2,56,5
8,19322.98,191.04,104.34,86.7,19236.28,WellsFargo2,56,5
9,19236.28,191.04,103.88,87.16,19149.12,WellsFargo2,56,5
10,19149.12,191.04,103.41,87.63,19061.49,WellsFargo2,56,5
11,19061.49,191.04,102.93,88.11,18973.38,WellsFargo2,56,5
12,18973.38,191.04,102.46,88.58,18884.8,WellsFargo2,56,5
13,18884.8,191.04,101.98,89.06,18795.74,WellsFargo2,56,5
14,18795.74,191.04,101.5,89.54,18706.2,WellsFargo2,56,5
15,18706.2,191.04,101.01,90.03,18616.17,WellsFargo2,56,5
16,18616.17,191.04,100.53,90.51,18525.66,WellsFargo2,56,5
17,18525.66,191.04,100.04,91.0,18434.66,WellsFargo2,56,5
18,18434.66,191.04,99.55,91.49,18343.17,WellsFargo2,56,5
19,18343.17,191.04,99.05,91.99,18251.18,WellsFargo2,56,5
20,18251.18,191.04,98.56,92.48,18158.7,WellsFargo2,56,5
21,18158.7,191.04,98.06,92.98,18065.72,WellsFargo2,56,5
22,18065.72,191.04,97.55,93.49,17972.23,WellsFargo2,56,5
23,17972.23,191.04,97.05,93.99,17878.24,WellsFargo2,56,5
24,17878.24,191.04,96.54,94.5,17783.74,WellsFargo2,56,5
25,17783.74,191.04,96.03,95.01,17688.73,WellsFargo2,56,5
26,17688.73,191.04,95.52,95.52,17593.21,WellsFargo2,56,5
27,17593.21,191.04,95.0,96.04,17497.17,WellsFargo2,56,5
28,17497.17,191.04,94.48,96.56,17400.61,WellsFargo2,56,5
29,17400.61,191.04,93.96,97.08,17303.53,WellsFargo2,56,5
30,17303.53,191.04,93.44,97.6,17205.93,WellsFargo2,56,5
31,17205.93,191.04,92.91,98.13,17107.8,WellsFargo2,56,5
32,17107.8,191.04,92.38,98.66,17009.14,WellsFargo2,56,5
33,17009.14,191.04,91.85,99.19,16909.95,WellsFargo2,56,5
34,16909.95,191.04,91.31,99.73,16810.22,WellsFargo2,56,5
35,16810.22,191.04,90.78,100.26,16709.96,WellsFargo2,56,5
36,16709.96,191.04,90.23,100.81,16609.15,WellsFargo2,56,5
37,16609.15,191.04,89.69,101.35,16507.8,WellsFargo2,56,5
38,16507.8,191.04,89.14,101.9,16405.9,WellsFargo2,56,5
39,16405.9,191.04,88.59,102.45,16303.45,WellsFargo2,56,5
40,16303.45,191.04,88.04,103.0,16200.45,WellsFargo2,56,5
41,16200.45,191.04,87.48,103.56,16096.89,WellsFargo2,56,5
42,16096.89,191.04,86.92,104.12,15992.77,WellsFargo2,56,5
43,15992.77,191.04,86.36,104.68,15888.09,WellsFargo2,56,5
44,15888.09,191.04,85.8,105.24,15782.85,WellsFargo2,56,5
45,15782.85,191.04,85.23,105.81,15677.04,WellsFargo2,56,5
46,15677.04,191.04,84.66,106.38,15570.66,WellsFargo2,56,5
47,15570.66,191.04,84.08,106.96,15463.7,WellsFargo2,56,5
48,15463.7,191.04,83.5,107.54,15356.16,WellsFargo2,56,5
49,15356.16,191.04,82.92,108.12,15248.04,WellsFargo2,56,5
50,15248.04,191.04,82.34,108.7,15139.34,WellsFargo2,56,5
51,15139.34,191.04,81.75,109.29,15030.05,WellsFargo2,56,5
52,15030.05,191.04,81.16,109.88,14920.17,WellsFargo2,56,5
53,14920.17,191.04,80.57,110.47,14809.7,WellsFargo2,56,5
54,14809.7,191.04,79.97,111.07,14698.63,WellsFargo2,56,5
55,14698.63,191.04,79.37,111.67,14586.96,WellsFargo2,56,5
56,14586.96,191.04,78.77,112.27,14474.69,WellsFargo2,56,5
57,14474.69,191.04,78.16,112.88,14361.81,WellsFargo2,56,5
58,14361.81,191.04,77.55,113.49,14248.32,WellsFargo2,56,5
59,14248.32,191.04,76.94,114.1,14134.22,WellsFargo2,56,5
60,14134.22,191.04,76.32,114.72,14019.5,WellsFargo2,56,5
61,14019.5,191.04,75.71,115.33,13904.17,WellsFargo2,56,5
62,13904.17,191.04,75.08,115.96,13788.21,WellsFargo2,56,5
63,13788.21,191.04,74.46,116.58,13671.63,WellsFargo2,56,5
64,13671.63,191.04,73.83,117.21,13554.42,WellsFargo2,56,5
65,13554.42,191.04,73.19,117.85,13436.57,WellsFargo2,56,5
66,13436.57,191.04,72.56,118.48,13318.09,WellsFargo2,56,5
67,13318.09,191.04,71.92,119.12,13198.97,WellsFargo2,56,5
68,13198.97,191.04,71.27,119.77,13079.2,WellsFargo2,56,5
69,13079.2,191.04,70.63,120.41,12958.79,WellsFargo2,56,5
70,12958.79,191.04,69.98,121.06,12837.73,WellsFargo2,56,5
71,12837.73,191.04,69.32,121.72,12716.01,WellsFargo2,56,5
72,12716.01,191.04,68.67,122.37,12593.64,WellsFargo2,56,5
73,12593.64,191.04,68.01,123.03,12470.61,WellsFargo2,56,5
74,12470.61,191.04,67.34,123.7,12346.91,WellsFargo2,56,5
75,12346.91,191.04,66.67,124.37,12222.54,WellsFargo2,56,5
76,12222.54,191.04,66.0,125.04,12097.5,WellsFargo2,56,5
77,12097.5,191.04,65.33,125.71,11971.79,WellsFargo2,56,5
78,11971.79,191.04,64.65,126.39,11845.4,WellsFargo2,56,5
79,11845.4,706.29,63.97,642.32,11203.08,WellsFargo2,56,5
80,11203.08,3010.1,60.5,2949.6,8253.48,WellsFargo2,56,5
81,8253.48,3010.1,44.57,2965.53,5287.95,WellsFargo2,56,5
82,5287.95,3010.1,28.55,2981.55,2306.4,WellsFargo2,56,5
83,2306.4,3010.1,12.45,2997.65,-691.25,WellsFargo2,56,5
0,8250.57,1084.62,53.63,1030.99,7219.58,WellsFargo1,57,1
1,7219.58,1084.62,46.93,1037.69,6181.89,WellsFargo1,57,1
2,6181.89,1084.62,40.18,1044.44,5137.45,WellsFargo1,57,1
3,5137.45,1084.62,33.39,1051.23,4086.22,WellsFargo1,57,1
4,4086.22,1084.62,26.56,1058.06,3028.16,WellsFargo1,57,1
5,3028.16,1084.62,19.68,1064.94,1963.22,WellsFargo1,57,1
6,1963.22,1084.62,12.76,1071.86,891.36,WellsFargo1,57,1
7,891.36,1084.62,5.79,1078.83,-187.47,WellsFargo1,57,1
0,5000.0,333.0,36.0,297.0,4703.0,Car,57,2
1,4703.0,333.0,33.86,299.14,4403.86,Car,57,2
2,4403.86,333.0,31.71,301.29,4102.57,Car,57,2
3,4102.57,333.0,29.54,303.46,3799.11,Car,57,2
4,3799.11,333.0,27.35,305.65,3493.46,Car,57,2
5,3493.46,333.0,25.15,307.85,3185.61,Car,57,2
6,3185.61,333.0,22.94,310.06,2875.55,Car,57,2
7,2875.55,520.47,20.7,499.77,2375.78,Car,57,2
8,2375.78,1417.62,17.11,1400.51,975.27,Car,57,2
9,975.27,1417.62,7.02,1410.6,-435.33,Car,57,2
0,20000.0,191.04,108.0,83.04,19916.96,WellsFargo2,57,3
1,19916.96,191.04,107.55,83.49,19833.47,WellsFargo2,57,3
2,19833.47,191.04,107.1,83.94,19749.53,WellsFargo2,57,3
3,19749.53,191.04,106.65,84.39,19665.14,WellsFargo2,57,3
4,19665.14,191.04,106.19,84.85,19580.29,WellsFargo2,57,3
5,19580.29,191.04,105.73,85.31,19494.98,WellsFargo2,57,3
6,19494.98,191.04,105.27,85.77,19409.21,WellsFargo2,57,3
7,19409.21,191.04,104.81,86.23,19322.98,WellsFargo2,57,3
8,19322.98,191.04,104.34,86.7,19236.28,WellsFargo2,57,3
9,19236.28,626.37,103.88,522.49,18713.79,WellsFargo2,57,3
10,18713.79,1608.66,101.05,1507.61,17206.18,WellsFargo2,57,3
11,17206.18,1608.66,92.91,1515.75,15690.43,WellsFargo2,57,3
12,15690.43,1608.66,84.73,1523.93,14166.5,WellsFargo2,57,3
13,14166.5,1608.66,76.5,1532.16,12634.34,WellsFargo2,57,3
14,12634.34,1608.66,68.23,1540.43,11093.91,WellsFargo2,57,3
15,11093.91,1608.66,59.91,1548.75,9545.16,WellsFargo2,57,3
16,9545.16,1608.66,51.54,1557.12,7988.04,WellsFargo2,57,3
17,7988.04,1608.66,43.14,1565.52,6422.52,WellsFargo2,57,3
18,6422.52,1608.66,34.68,1573.98,4848.54,WellsFargo2,57,3
19,4848.54,1608.66,26.18,1582.48,3266.06,WellsFargo2,57,3
20,3266.06,1608.66,17.64,1591.02,1675.04,WellsFargo2,57,3
21,1675.04,1608.66,9.05,1599.61,75.43,WellsFargo2,57,3
22,75.43,1608.66,0.41,1608.25,-1532.82,WellsFargo2,57,3
0,4000.0,70.0,16.0,54.0,3946.0,testing,57,4
1,3946.0,70.0,15.78,54.22,3891.78,testing,57,4
2,3891.78,70.0,15.57,54.43,3837.35,testing,57,4
3,3837.35,70.0,15.35,54.65,3782.7,testing,57,4
4,3782.7,70.0,15.13,54.87,3727.83,testing,57,4
5,3727.83,70.0,14.91,55.09,3672.74,testing,57,4
6,3672.74,70.0,14.69,55.31,3617.43,testing,57,4
7,3617.43,70.0,14.47,55.53,3561.9,testing,57,4
8,3561.9,70.0,14.25,55.75,3506.15,testing,57,4
9,3506.15,70.0,14.02,55.98,3450.17,testing,57,4
10,3450.17,70.0,13.8,56.2,3393.97,testing,57,4
11,3393.97,70.0,13.58,56.42,3337.55,testing,57,4
12,3337.55,70.0,13.35,56.65,3280.9,testing,57,4
13,3280.9,70.0,13.12,56.88,3224.02,testing,57,4
14,3224.02,70.0,12.9,57.1,3166.92,testing,57,4
15,3166.92,70.0,12.67,57.33,3109.59,testing,57,4
16,3109.59,70.0,12.44,57.56,3052.03,testing,57,4
17,3052.03,70.0,12.21,57.79,2994.24,testing,57,4
18,2994.24,70.0,11.98,58.02,2936.22,testing,57,4
19,2936.22,70.0,11.74,58.26,2877.96,testing,57,4
20,2877.96,70.0,11.51,58.49,2819.47,testing,57,4
21,2819.47,70.0,11.28,58.72,2760.75,testing,57,4
22,2760.75,1602.82,11.04,1591.78,1168.97,testing,57,4
23,1168.97,1678.66,4.68,1673.98,-505.01,testing,57,4
0,180000.0,1331.44,594.0,737.44,179262.56,mortgage,57,5
1,179262.56,1331.44,591.57,739.87,178522.69,mortgage,57,5
2,178522.69,1331.44,589.12,742.32,177780.37,mortgage,57,5
3,177780.37,1331.44,586.68,744.76,177035.61,mortgage,57,5
4,177035.61,1331.44,584.22,747.22,176288.39,mortgage,57,5
5,176288.39,1331.44,581.75,749.69,175538.7,mortgage,57,5
6,175538.7,1331.44,579.28,752.16,174786.54,mortgage,57,5
7,174786.54,1331.44,576.8,754.64,174031.9,mortgage,57,5
8,174031.9,1331.44,574.31,757.13,173274.77,mortgage,57,5
9,173274.77,1331.44,571.81,759.63,172515.14,mortgage,57,5
10,172515.14,1331.44,569.3,762.14,171753.0,mortgage,57,5
11,171753.0,1331.44,566.78,764.66,170988.34,mortgage,57,5
12,170988.34,1331.44,564.26,767.18,170221.16,mortgage,57,5
13,170221.16,1331.44,561.73,769.71,169451.45,mortgage,57,5
14,169451.45,1331.44,559.19,772.25,168679.2,mortgage,57,5
15,168679.2,1331.44,556.64,774.8,167904.4,mortgage,57,5
16,167904.4,1331.44,554.08,777.36,167127.04,mortgage,57,5
17,167127.04,1331.44,551.52,779.92,166347.12,mortgage,57,5
18,166347.12,1331.44,548.95,782.49,165564.63,mortgage,57,5
19,165564.63,1331.44,546.36,785.08,164779.55,mortgage,57,5
20,164779.55,1331.44,543.77,787.67,163991.88,mortgage,57,5
21,163991.88,1331.44,541.17,790.27,163201.61,mortgage,57,5
22,163201.61,1331.44,538.57,792.87,162408.74,mortgage,57,5
23,162408.74,1836.45,535.95,1300.5,161108.24,mortgage,57,5
24,161108.24,3010.1,531.66,2478.44,158629.8,mortgage,57,5
25,158629.8,3010.1,523.48,2486.62,156143.18,mortgage,57,5
26,156143.18,3010.1,515.27,2494.83,153648.35,mortgage,57,5
27,153648.35,3010.1,507.04,2503.06,151145.29,mortgage,57,5
28,151145.29,3010.1,498.78,2511.32,148633.97,mortgage,57,5
29,148633.97,3010.1,490.49,2519.61,146114.36,mortgage,57,5
30,146114.36,3010.1,482.18,2527.92,143586.44,mortgage,57,5
31,143586.44,3010.1,473.84,2536.26,141050.18,mortgage,57,5
32,141050.18,3010.1,465.47,2544.63,138505.55,mortgage,57,5
33,138505.55,3010.1,457.07,2553.03,135952.52,mortgage,57,5
34,135952.52,3010.1,448.64,2561.46,133391.06,mortgage,57,5
35,133391.06,3010.1,440.19,2569.91,130821.15,mortgage,57,5
36,130821.15,3010.1,431.71,2578.39,128242.76,mortgage,57,5
37,128242.76,3010.1,423.2,2586.9,125655.86,mortgage,57,5
38,125655.86,3010.1,414.66,2595.44,123060.42,mortgage,57,5
39,123060.42,3010.1,406.1,2604.0,120456.42,mortgage,57,5
40,120456.42,3010.1,397.51,2612.59,117843.83,mortgage,57,5
41,117843.83,3010.1,388.88,2621.22,115222.61,mortgage,57,5
42,115222.61,3010.1,380.23,2629.87,112592.74,mortgage,57,5
43,112592.74,3010.1,371.56,2638.54,109954.2,mortgage,57,5
44,109954.2,3010.1,362.85,2647.25,107306.95,mortgage,57,5
45,107306.95,3010.1,354.11,2655.99,104650.96,mortgage,57,5
46,104650.96,3010.1,345.35,2664.75,101986.21,mortgage,57,5
47,101986.21,3010.1,336.55,2673.55,99312.66,mortgage,57,5
48,99312.66,3010.1,327.73,2682.37,96630.29,mortgage,57,5
49,96630.29,3010.1,318.88,2691.22,93939.07,mortgage,57,5
50,93939.07,3010.1,310.0,2700.1,91238.97,mortgage,57,5
51,91238.97,3010.1,301.09,2709.01,88529.96,mortgage,57,5
52,88529.96,3010.1,292.15,2717.95,85812.01,mortgage,57,5
53,85812.01,3010.1,283.18,2726.92,83085.09,mortgage,57,5
54,83085.09,3010.1,274.18,2735.92,80349.17,mortgage,57,5
55,80349.17,3010.1,265.15,2744.95,77604.22,mortgage,57,5
56,77604.22,3010.1,256.09,2754.01,74850.21,mortgage,57,5
57,74850.21,3010.1,247.01,2763.09,72087.12,mortgage,57,5
58,72087.12,3010.1,237.89,2772.21,69314.91,mortgage,57,5
59,69314.91,3010.1,228.74,2781.36,66533.55,mortgage,57,5
60,66533.55,3010.1,219.56,2790.54,63743.01,mortgage,57,5
61,63743.01,3010.1,210.35,2799.75,60943.26,mortgage,57,5
62,60943.26,3010.1,201.11,2808.99,58134.27,mortgage,57,5
63,58134.27,3010.1,191.84,2818.26,55316.01,mortgage,57,5
64,55316.01,3010.1,182.54,2827.56,52488.45,mortgage,57,5
65,52488.45,3010.1,173.21,2836.89,49651.56,mortgage,57,5
66,49651.56,3010.1,163.85,2846.25,46805.31,mortgage,57,5
67,46805.31,3010.1,154.46,2855.64,43949.67,mortgage,57,5
68,43949.67,3010.1,145.03,2865.07,41084.6,mortgage,57,5
69,41084.6,3010.1,135.58,2874.52,38210.08,mortgage,57,5
70,38210.08,3010.1,126.09,2884.01,35326.07,mortgage,57,5
71,35326.07,3010.1,116.58,2893.52,32432.55,mortgage,57,5
72,32432.55,3010.1,107.03,2903.07,29529.48,mortgage,57,5
73,29529.48,3010.1,97.45,2912.65,26616.83,mortgage,57,5
74,26616.83,3010.1,87.84,2922.26,23694.57,mortgage,57,5
75,23694.57,3010.1,78.19,2931.91,20762.66,mortgage,57,5
76,20762.66,3010.1,68.52,2941.58,17821.08,mortgage,57,5
77,17821.08,3010.1,58.81,2951.29,14869.79,mortgage,57,5
78,14869.79,3010.1,49.07,2961.03,11908.76,mortgage,57,5
79,11908.76,3010.1,39.3,2970.8,8937.96,mortgage,57,5
80,8937.96,3010.1,29.5,2980.6,5957.36,mortgage,57,5
81,5957.36,3010.1,19.66,2990.44,2966.92,mortgage,57,5
82,2966.92,3010.1,9.79,3000.31,-33.39,mortgage,57,5
0,8250.57,1084.62,53.63,1030.99,7219.58,WellsFargo1,58,1
1,7219.58,1084.62,46.93,1037.69,6181.89,WellsFargo1,58,1
2,6181.89,1084.62,40.18,1044.44,5137.45,WellsFargo1,58,1
3,5137.45,1084.62,33.39,1051.23,4086.22,WellsFargo1,58,1
4,4086.22,1084.62,26.56,1058.06,3028.16,WellsFargo1,58,1
5,3028.16,1084.62,19.68,1064.94,1963.22,WellsFargo1,58,1
6,1963.22,1084.62,12.76,1071.86,891.36,WellsFargo1,58,1
7,891.36,1084.62,5.79,1078.83,-187.47,WellsFargo1,58,1
0,5000.0,333.0,36.0,297.0,4703.0,Car,58,2
1,4703.0,333.0,33.86,299.14,4403.86,Car,58,2
2,4403.86,333.0,31.71,301.29,4102.57,Car,58,2
3,4102.57,333.0,29.54,303.46,3799.11,Car,58,2
4,3799.11,333.0,27.35,305.65,3493.46,Car,58,2
5,3493.46,333.0,25.15,307.85,3185.61,Car,58,2
6,3185.61,333.0,22.94,310.06,2875.55,Car,58,2
7,2875.55,520.47,20.7,499.77,2375.78,Car,58,2
8,2375.78,1417.62,17.11,1400.51,975.27,Car,58,2
9,975.27,1417.62,7.02,1410.6,-435.33,Car,58,2
0,20000.0,191.04,108.0,83.04,19916.96,WellsFargo2,58,3
1,19916.96,191.04,107.55,83.49,19833.47,WellsFargo2,58,3
2,19833.47,191.04,107.1,83.94,19749.53,WellsFargo2,58,3
3,19749.53,191.04,106.65,84.39,19665.14,WellsFargo2,58,3
4,19665.14,191.04,106.19,84.85,19580.29,WellsFargo2,58,3
5,19580.29,191.04,105.73,85.31,19494.98,WellsFargo2,58,3
6,19494.98,191.04,105.27,85.77,19409.21,WellsFargo2,58,3
7,19409.21,191.04,104.81,86.23,19322.98,WellsFargo2,58,3
8,19322.98,191.04,104.34,86.7,19236.28,WellsFargo2,58,3
9,19236.28,626.37,103.88,522.49,18713.79,WellsFargo2,58,3
10,18713.79,1608.66,101.05,1507.61,17206.18,WellsFargo2,58,3
11,17206.18,1608.66,92.91,1515.75,15690.43,WellsFargo2,58,3
12,15690.43,1608.66,84.73,1523.93,14166.5,WellsFargo2,58,3
13,14166.5,1608.66,76.5,1532.16,12634.34,WellsFargo2,58,3
14,12634.34,1608.66,68.23,1540.43,11093.91,WellsFargo2,58,3
15,11093.91,1608.66,59.91,1548.75,9545.16,WellsFargo2,58,3
16,9545.16,1608.66,51.54,1557.12,7988.04,WellsFargo2,58,3
17,7988.04,1608.66,43.14,1565.52,6422.52,WellsFargo2,58,3
18,6422.52,1608.66,34.68,1573.98,4848.54,WellsFargo2,58,3
19,4848.54,1608.66,26.18,1582.48,3266.06,WellsFargo2,58,3
20,3266.06,1608.66,17.64,1591.02,1675.04,WellsFargo2,58,3
21,1675.04,1608.66,9.05,1599.61,75.43,WellsFargo2,58,3
22,75.43,1608.66,0.41,1608.25,-1532.82,WellsFargo2,58,3
0,180000.0,1331.44,594.0,737.44,179262.56,mortgage,58,4
1,179262.56,1331.44,591.57,739.87,178522.69,mortgage,58,4
2,178522.69,1331.44,589.12,742.32,177780.37,mortgage,58,4
3,177780.37,1331.44,586.68,744.76,177035.61,mortgage,58,4
4,177035.61,1331.44,584.22,747.22,176288.39,mortgage,58,4
5,176288.39,1331.44,581.75,749.69,175538.7,mortgage,58,4
6,175538.7,1331.44,579.28,752.16,174786.54,mortgage,58,4
7,174786.54,1331.44,576.8,754.64,174031.9,mortgage,58,4
8,174031.9,1331.44,574.31,757.13,173274.77,mortgage,58,4
9,173274.77,1331.44,571.81,759.63,172515.14,mortgage,58,4
10,172515.14,1331.44,569.3,762.14,171753.0,mortgage,58,4
11,171753.0,1331.44,566.78,764.66,170988.34,mortgage,58,4
12,170988.34,1331.44,564.26,767.18,170221.16,mortgage,58,4
13,170221.16,1331.44,561.73,769.71,169451.45,mortgage,58,4
14,169451.45,1331.44,559.19,772.25,168679.2,mortgage,58,4
15,168679.2,1331.44,556.64,774.8,167904.4,mortgage,58,4
16,167904.4,1331.44,554.08,777.36,167127.04,mortgage,58,4
17,167127.04,1331.44,551.52,779.92,166347.12,mortgage,58,4
18,166347.12,1331.44,548.95,782.49,165564.63,mortgage,58,4
19,165564.63,1331.44,546.36,785.08,164779.55,mortgage,58,4
20,164779.55,1331.44,543.77,787.67,163991.88,mortgage,58,4
21,163991.88,1331.44,541.17,790.27,163201.61,mortgage,58,4
22,163201.61,2864.26,538.57,2325.69,160875.92,mortgage,58,4
23,160875.92,2940.1,530.89,2409.21,158466.71,mortgage,58,4
24,158466.71,2940.1,522.94,2417.16,156049.55,mortgage,58,4
25,156049.55,2940.1,514.96,2425.14,153624.41,mortgage,58,4
26,153624.41,2940.1,506.96,2433.14,151191.27,mortgage,58,4
27,151191.27,2940.1,498.93,2441.17,148750.1,mortgage,58,4
28,148750.1,2940.1,490.88,2449.22,146300.88,mortgage,58,4
29,146300.88,2940.1,482.79,2457.31,143843.57,mortgage,58,4
30,143843.57,2940.1,474.68,2465.42,141378.15,mortgage,58,4
31,141378.15,2940.1,466.55,2473.55,138904.6,mortgage,58,4
32,138904.6,2940.1,458.39,2481.71,136422.89,mortgage,58,4
33,136422.89,2940.1,450.2,2489.9,133932.99,mortgage,58,4
34,133932.99,2940.1,441.98,2498.12,131434.87,mortgage,58,4
35,131434.87,2940.1,433.74,2506.36,128928.51,mortgage,58,4
36,128928.51,2940.1,425.46,2514.64,126413.87,mortgage,58,4
37,126413.87,2940.1,417.17,2522.93,123890.94,mortgage,58,4
38,123890.94,2940.1,408.84,2531.26,121359.68,mortgage,58,4
39,121359.68,2940.1,400.49,2539.61,118820.07,mortgage,58,4
40,118820.07,2940.1,392.11,2547.99,116272.08,mortgage,58,4
41,116272.08,2940.1,383.7,2556.4,113715.68,mortgage,58,4
42,113715.68,2940.1,375.26,2564.84,111150.84,mortgage,58,4
43,111150.84,2940.1,366.8,2573.3,108577.54,mortgage,58,4
44,108577.54,2940.1,358.31,2581.79,105995.75,mortgage,58,4
45,105995.75,2940.1,349.79,2590.31,103405.44,mortgage,58,4
46,103405.44,2940.1,341.24,2598.86,100806.58,mortgage,58,4
47,100806.58,2940.1,332.66,2607.44,98199.14,mortgage,58,4
48,98199.14,2940.1,324.06,2616.04,95583.1,mortgage,58,4
49,95583.1,2940.1,315.42,2624.68,92958.42,mortgage,58,4
50,92958.42,2940.1,306.76,2633.34,90325.08,mortgage,58,4
51,90325.08,2940.1,298.07,2642.03,87683.05,mortgage,58,4
52,87683.05,2940.1,289.35,2650.75,85032.3,mortgage,58,4
53,85032.3,2940.1,280.61,2659.49,82372.81,mortgage,58,4
54,82372.81,2940.1,271.83,2668.27,79704.54,mortgage,58,4
55,79704.54,2940.1,263.02,2677.08,77027.46,mortgage,58,4
56,77027.46,2940.1,254.19,2685.91,74341.55,mortgage,58,4
57,74341.55,2940.1,245.33,2694.77,71646.78,mortgage,58,4
58,71646.78,2940.1,236.43,2703.67,68943.11,mortgage,58,4
59,68943.11,2940.1,227.51,2712.59,66230.52,mortgage,58,4
60,66230.52,2940.1,218.56,2721.54,63508.98,mortgage,58,4
61,63508.98,2940.1,209.58,2730.52,60778.46,mortgage,58,4
62,60778.46,2940.1,200.57,2739.53,58038.93,mortgage,58,4
63,58038.93,2940.1,191.53,2748.57,55290.36,mortgage,58,4
64,55290.36,2940.1,182.46,2757.64,52532.72,mortgage,58,4
65,52532.72,2940.1,173.36,2766.74,49765.98,mortgage,58,4
66,49765.98,2940.1,164.23,2775.87,46990.11,mortgage,58,4
67,46990.11,2940.1,155.07,2785.03,44205.08,mortgage,58,4
68,44205.08,2940.1,145.88,2794.22,41410.86,mortgage,58,4
69,41410.86,2940.1,136.66,2803.44,38607.42,mortgage,58,4
70,38607.42,2940.1,127.4,2812.7,35794.72,mortgage,58,4
71,35794.72,2940.1,118.12,2821.98,32972.74,mortgage,58,4
72,32972.74,2940.1,108.81,2831.29,30141.45,mortgage,58,4
73,30141.45,2940.1,99.47,2840.63,27300.82,mortgage,58,4
74,27300.82,2940.1,90.09,2850.01,24450.81,mortgage,58,4
75,24450.81,2940.1,80.69,2859.41,21591.4,mortgage,58,4
76,21591.4,2940.1,71.25,2868.85,18722.55,mortgage,58,4
77,18722.55,2940.1,61.78,2878.32,15844.23,mortgage,58,4
78,15844.23,2940.1,52.29,2887.81,12956.42,mortgage,58,4
79,12956.42,2940.1,42.76,2897.34,10059.08,mortgage,58,4
80,10059.08,2940.1,33.19,2906.91,7152.17,mortgage,58,4
81,7152.17,2940.1,23.6,2916.5,4235.67,mortgage,58,4
82,4235.67,2940.1,13.98,2926.12,1309.55,mortgage,58,4
83,1309.55,2940.1,4.32,2935.78,-1626.23,mortgage,58,4
0,4000.0,70.0,16.0,54.0,3946.0,testing,58,5
1,3946.0,70.0,15.78,54.22,3891.78,testing,58,5
2,3891.78,70.0,15.57,54.43,3837.35,testing,58,5
3,3837.35,70.0,15.35,54.65,3782.7,testing,58,5
4,3782.7,70.0,15.13,54.87,3727.83,testing,58,5
5,3727.83,70.0,14.91,55.09,3672.74,testing,58,5
6,3672.74,70.0,14.69,55.31,3617.43,testing,58,5
7,3617.43,70.0,14.47,55.53,3561.9,testing,58,5
8,3561.9,70.0,14.25,55.75,3506.15,testing,58,5
9,3506.15,70.0,14.02,55.98,3450.17,testing,58,5
10,3450.17,70.0,13.8,56.2,3393.97,testing,58,5
11,3393.97,70.0,13.58,56.42,3337.55,testing,58,5
12,3337.55,70.0,13.35,56.65,3280.9,testing,58,5
13,3280.9,70.0,13.12,56.88,3224.02,testing,58,5
14,3224.02,70.0,12.9,57.1,3166.92,testing,58,5
15,3166.92,70.0,12.67,57.33,3109.59,testing,58,5
16,3109.59,70.0,12.44,57.56,3052.03,testing,58,5
17,3052.03,70.0,12.21,57.79,2994.24,testing,58,5
18,2994.24,70.0,11.98,58.02,2936.22,testing,58,5
19,2936.22,70.0,11.74,58.26,2877.96,testing,58,5
20,2877.96,70.0,11.51,58.49,2819.47,testing,58,5
21,2819.47,70.0,11.28,58.72,2760.75,testing,58,5
22,2760.75,70.0,11.04,58.96,2701.79,testing,58,5
23,2701.79,70.0,10.81,59.19,2642.6,testing,58,5
24,2642.6,70.0,10.57,59.43,2583.17,testing,58,5
25,2583.17,70.0,10.33,59.67,2523.5,testing,58,5
26,2523.5,70.0,10.09,59.91,2463.59,testing,58,5
27,2463.59,70.0,9.85,60.15,2403.44,testing,58,5
28,2403.44,70.0,9.61,60.39,2343.05,testing,58,5
29,2343.05,70.0,9.37,60.63,2282.42,testing,58,5
30,2282.42,70.0,9.13,60.87,2221.55,testing,58,5
31,2221.55,70.0,8.89,61.11,2160.44,testing,58,5
32,2160.44,70.0,8.64,61.36,2099.08,testing,58,5
33,2099.08,70.0,8.4,61.6,2037.48,testing,58,5
34,2037.48,70.0,8.15,61.85,1975.63,testing,58,5
35,1975.63,70.0,7.9,62.1,1913.53,testing,58,5
36,1913.53,70.0,7.65,62.35,1851.18,testing,58,5
37,1851.18,70.0,7.4,62.6,1788.58,testing,58,5
38,1788.58,70.0,7.15,62.85,1725.73,testing,58,5
39,1725.73,70.0,6.9,63.1,1662.63,testing,58,5
40,1662.63,70.0,6.65,63.35,1599.28,testing,58,5
41,1599.28,70.0,6.4,63.6,1535.68,testing,58,5
42,1535.68,70.0,6.14,63.86,1471.82,testing,58,5
43,1471.82,70.0,5.89,64.11,1407.71,testing,58,5
44,1407.71,70.0,5.63,64.37,1343.34,testing,58,5
45,1343.34,70.0,5.37,64.63,1278.71,testing,58,5
46,1278.71,70.0,5.11,64.89,1213.82,testing,58,5
47,1213.82,70.0,4.86,65.14,1148.68,testing,58,5
48,1148.68,70.0,4.59,65.41,1083.27,testing,58,5
49,1083.27,70.0,4.33,65.67,1017.6,testing,58,5
50,1017.6,70.0,4.07,65.93,951.67,testing,58,5
51,951.67,70.0,3.81,66.19,885.48,testing,58,5
52,885.48,70.0,3.54,66.46,819.02,testing,58,5
53,819.02,70.0,3.28,66.72,752.3,testing,58,5
54,752.3,70.0,3.01,66.99,685.31,testing,58,5
55,685.31,70.0,2.74,67.26,618.05,testing,58,5
56,618.05,70.0,2.47,67.53,550.52,testing,58,5
57,550.52,70.0,2.2,67.8,482.72,testing,58,5
58,482.72,70.0,1.93,68.07,414.65,testing,58,5
59,414.65,70.0,1.66,68.34,346.31,testing,58,5
60,346.31,70.0,1.39,68.61,277.7,testing,58,5
61,277.7,70.0,1.11,68.89,208.81,testing,58,5
62,208.81,70.0,0.84,69.16,139.65,testing,58,5
63,139.65,70.0,0.56,69.44,70.21,testing,58,5
64,70.21,70.0,0.28,69.72,0.49,testing,58,5
65,0.49,70.0,0.0,70.0,-69.51,testing,58,5
0,8250.57,1084.62,53.63,1030.99,7219.58,WellsFargo1,59,1
1,7219.58,1084.62,46.93,1037.69,6181.89,WellsFargo1,59,1
2,6181.89,1084.62,40.18,1044.44,5137.45,WellsFargo1,59,1
3,5137.45,1084.62,33.39,1051.23,4086.22,WellsFargo1,59,1
4,4086.22,1084.62,26.56,1058.06,3028.16,WellsFargo1,59,1
5,3028.16,1084.62,19.68,1064.94,1963.22,WellsFargo1,59,1
6,1963.22,1084.62,12.76,1071.86,891.36,WellsFargo1,59,1
7,891.36,1084.62,5.79,1078.83,-187.47,WellsFargo1,59,1
0,5000.0,333.0,36.0,297.0,4703.0,Car,59,2
1,4703.0,333.0,33.86,299.14,4403.86,Car,59,2
2,4403.86,333.0,31.71,301.29,4102.57,Car,59,2
3,4102.57,333.0,29.54,303.46,3799.11,Car,59,2
4,3799.11,333.0,27.35,305.65,3493.46,Car,59,2
5,3493.46,333.0,25.15,307.85,3185.61,Car,59,2
6,3185.61,333.0,22.94,310.06,2875.55,Car,59,2
7,2875.55,520.47,20.7,499.77,2375.78,Car,59,2
8,2375.78,1417.62,17.11,1400.51,975.27,Car,59,2
9,975.27,1417.62,7.02,1410.6,-435.33,Car,59,2
0,180000.0,1331.44,594.0,737.44,179262.56,mortgage,59,3
1,179262.56,1331.44,591.57,739.87,178522.69,mortgage,59,3
2,178522.69,1331.44,589.12,742.32,177780.37,mortgage,59,3
3,177780.37,1331.44,586.68,744.76,177035.61,mortgage,59,3
4,177035.61,1331.44,584.22,747.22,176288.39,mortgage,59,3
5,176288.39,1331.44,581.75,749.69,175538.7,mortgage,59,3
6,175538.7,1331.44,579.28,752.16,174786.54,mortgage,59,3
7,174786.54,1331.44,576.8,754.64,174031.9,mortgage,59,3
8,174031.9,1331.44,574.31,757.13,173274.77,mortgage,59,3
9,173274.77,1766.77,571.81,1194.96,172079.81,mortgage,59,3
10,172079.81,2749.06,567.86,2181.2,169898.61,mortgage,59,3
11,169898.61,2749.06,560.67,2188.39,167710.22,mortgage,59,3
12,167710.22,2749.06,553.44,2195.62,165514.6,mortgage,59,3
13,165514.6,2749.06,546.2,2202.86,163311.74,mortgage,59,3
14,163311.74,2749.06,538.93,2210.13,161101.61,mortgage,59,3
15,161101.61,2749.06,531.64,2217.42,158884.19,mortgage,59,3
16,158884.19,2749.06,524.32,2224.74,156659.45,mortgage,59,3
17,156659.45,2749.06,516.98,2232.08,154427.37,mortgage,59,3
18,154427.37,2749.06,509.61,2239.45,152187.92,mortgage,59,3
19,152187.92,2749.06,502.22,2246.84,149941.08,mortgage,59,3
20,149941.08,2749.06,494.81,2254.25,147686.83,mortgage,59,3
21,147686.83,2749.06,487.37,2261.69,145425.14,mortgage,59,3
22,145425.14,2749.06,479.9,2269.16,143155.98,mortgage,59,3
23,143155.98,2749.06,472.41,2276.65,140879.33,mortgage,59,3
24,140879.33,2749.06,464.9,2284.16,138595.17,mortgage,59,3
25,138595.17,2749.06,457.36,2291.7,136303.47,mortgage,59,3
26,136303.47,2749.06,449.8,2299.26,134004.21,mortgage,59,3
27,134004.21,2749.06,442.21,2306.85,131697.36,mortgage,59,3
28,131697.36,2749.06,434.6,2314.46,129382.9,mortgage,59,3
29,129382.9,2749.06,426.96,2322.1,127060.8,mortgage,59,3
30,127060.8,2749.06,419.3,2329.76,124731.04,mortgage,59,3
31,124731.04,2749.06,411.61,2337.45,122393.59,mortgage,59,3
32,122393.59,2749.06,403.9,2345.16,120048.43,mortgage,59,3
33,120048.43,2749.06,396.16,2352.9,117695.53,mortgage,59,3
34,117695.53,2749.06,388.4,2360.66,115334.87,mortgage,59,3
35,115334.87,2749.06,380.61,2368.45,112966.42,mortgage,59,3
36,112966.42,2749.06,372.79,2376.27,110590.15,mortgage,59,3
37,110590.15,2749.06,364.95,2384.11,108206.04,mortgage,59,3
38,108206.04,2749.06,357.08,2391.98,105814.06,mortgage,59,3
39,105814.06,2749.06,349.19,2399.87,103414.19,mortgage,59,3
40,103414.19,2749.06,341.27,2407.79,101006.4,mortgage,59,3
41,101006.4,2749.06,333.32,2415.74,98590.66,mortgage,59,3
42,98590.66,2749.06,325.35,2423.71,96166.95,mortgage,59,3
43,96166.95,2749.06,317.35,2431.71,93735.24,mortgage,59,3
44,93735.24,2749.06,309.33,2439.73,91295.51,mortgage,59,3
45,91295.51,2749.06,301.28,2447.78,88847.73,mortgage,59,3
46,88847.73,2749.06,293.2,2455.86,86391.87,mortgage,59,3
47,86391.87,2749.06,285.09,2463.97,83927.9,mortgage,59,3
48,83927.9,2749.06,276.96,2472.1,81455.8,mortgage,59,3
49,81455.8,2749.06,268.8,2480.26,78975.54,mortgage,59,3
50,78975.54,2749.06,260.62,2488.44,76487.1,mortgage,59,3
51,76487.1,2749.06,252.41,2496.65,73990.45,mortgage,59,3
52,73990.45,2749.06,244.17,2504.89,71485.56,mortgage,59,3
53,71485.56,2749.06,235.9,2513.16,68972.4,mortgage,59,3
54,68972.4,2749.06,227.61,2521.45,66450.95,mortgage,59,3
55,66450.95,2749.06,219.29,2529.77,63921.18,mortgage,59,3
56,63921.18,2749.06,210.94,2538.12,61383.06,mortgage,59,3
57,61383.06,2749.06,202.56,2546.5,58836.56,mortgage,59,3
58,58836.56,2749.06,194.16,2554.9,56281.66,mortgage,59,3
59,56281.66,2749.06,185.73,2563.33,53718.33,mortgage,59,3
60,53718.33,2749.06,177.27,2571.79,51146.54,mortgage,59,3
61,51146.54,2749.06,168.78,2580.28,48566.26,mortgage,59,3
62,48566.26,2749.06,160.27,2588.79,45977.47,mortgage,59,3
63,45977.47,2749.06,151.73,2597.33,43380.14,mortgage,59,3
64,43380.14,2749.06,143.15,2605.91,40774.23,mortgage,59,3
65,40774.23,2749.06,134.55,2614.51,38159.72,mortgage,59,3
66,38159.72,2749.06,125.93,2623.13,35536.59,mortgage,59,3
67,35536.59,2749.06,117.27,2631.79,32904.8,mortgage,59,3
68,32904.8,2749.06,108.59,2640.47,30264.33,mortgage,59,3
69,30264.33,2749.06,99.87,2649.19,27615.14,mortgage,59,3
70,27615.14,2749.06,91.13,2657.93,24957.21,mortgage,59,3
71,24957.21,2749.06,82.36,2666.7,22290.51,mortgage,59,3
72,22290.51,2749.06,73.56,2675.5,19615.01,mortgage,59,3
73,19615.01,2749.06,64.73,2684.33,16930.68,mortgage,59,3
74,16930.68,2749.06,55.87,2693.19,14237.49,mortgage,59,3
75,14237.49,2749.06,46.98,2702.08,11535.41,mortgage,59,3
76,11535.41,2749.06,38.07,2710.99,8824.42,mortgage,59,3
77,8824.42,2749.06,29.12,2719.94,6104.48,mortgage,59,3
78,6104.48,2749.06,20.14,2728.92,3375.56,mortgage,59,3
79,3375.56,2749.06,11.14,2737.92,637.64,mortgage,59,3
80,637.64,2749.06,2.1,2746.96,-2109.32,mortgage,59,3
0,4000.0,70.0,16.0,54.0,3946.0,testing,59,4
1,3946.0,70.0,15.78,54.22,3891.78,testing,59,4
2,3891.78,70.0,15.57,54.43,3837.35,testing,59,4
3,3837.35,70.0,15.35,54.65,3782.7,testing,59,4
4,3782.7,70.0,15.13,54.87,3727.83,testing,59,4
5,3727.83,70.0,14.91,55.09,3672.74,testing,59,4
6,3672.74,70.0,14.69,55.31,3617.43,testing,59,4
7,3617.43,70.0,14.47,55.53,3561.9,testing,59,4
8,3561.9,70.0,14.25,55.75,3506.15,testing,59,4
9,3506.15,70.0,14.02,55.98,3450.17,testing,59,4
10,3450.17,70.0,13.8,56.2,3393.97,testing,59,4
11,3393.97,70.0,13.58,56.42,3337.55,testing,59,4
12,3337.55,70.0,13.35,56.65,3280.9,testing,59,4
13,3280.9,70.0,13.12,56.88,3224.02,testing,59,4
14,3224.02,70.0,12.9,57.1,3166.92,testing,59,4
15,3166.92,70.0,12.67,57.33,3109.59,testing,59,4
16,3109.59,70.0,12.44,57.56,3052.03,testing,59,4
17,3052.03,70.0,12.21,57.79,2994.24,testing,59,4
18,2994.24,70.0,11.98,58.02,2936.22,testing,59,4
19,2936.22,70.0,11.74,58.26,2877.96,testing,59,4
20,2877.96,70.0,11.51,58.49,2819.47,testing,59,4
21,2819.47,70.0,11.28,58.72,2760.75,testing,59,4
22,2760.75,70.0,11.04,58.96,2701.79,testing,59,4
23,2701.79,70.0,10.81,59.19,2642.6,testing,59,4
24,2642.6,70.0,10.57,59.43,2583.17,testing,59,4
25,2583.17,70.0,10.33,59.67,2523.5,testing,59,4
26,2523.5,70.0,10.09,59.91,2463.59,testing,59,4
27,2463.59,70.0,9.85,60.15,2403.44,testing,59,4
28,2403.44,70.0,9.61,60.39,2343.05,testing,59,4
29,2343.05,70.0,9.37,60.63,2282.42,testing,59,4
30,2282.42,70.0,9.13,60.87,2221.55,testing,59,4
31,2221.55,70.0,8.89,61.11,2160.44,testing,59,4
32,2160.44,70.0,8.64,61.36,2099.08,testing,59,4
33,2099.08,70.0,8.4,61.6,2037.48,testing,59,4
34,2037.48,70.0,8.15,61.85,1975.63,testing,59,4
35,1975.63,70.0,7.9,62.1,1913.53,testing,59,4
36,1913.53,70.0,7.65,62.35,1851.18,testing,59,4
37,1851.18,70.0,7.4,62.6,1788.58,testing,59,4
38,1788.58,70.0,7.15,62.85,1725.73,testing,59,4
39,1725.73,70.0,6.9,63.1,1662.63,testing,59,4
40,1662.63,70.0,6.65,63.35,1599.28,testing,59,4
41,1599.28,70.0,6.4,63.6,1535.68,testing,59,4
42,1535.68,70.0,6.14,63.86,1471.82,testing,59,4
43,1471.82,70.0,5.89,64.11,1407.71,testing,59,4
44,1407.71,70.0,5.63,64.37,1343.34,testing,59,4
45,1343.34,70.0,5.37,64.63,1278.71,testing,59,4
46,1278.71,70.0,5.11,64.89,1213.82,testing,59,4
47,1213.82,70.0,4.86,65.14,1148.68,testing,59,4
48,1148.68,70.0,4.59,65.41,1083.27,testing,59,4
49,1083.27,70.0,4.33,65.67,1017.6,testing,59,4
50,1017.6,70.0,4.07,65.93,951.67,testing,59,4
51,951.67,70.0,3.81,66.19,885.48,testing,59,4
52,885.48,70.0,3.54,66.46,819.02,testing,59,4
53,819.02,70.0,3.28,66.72,752.3,testing,59,4
54,752.3,70.0,3.01,66.99,685.31,testing,59,4
55,685.31,70.0,2.74,67.26,618.05,testing,59,4
56,618.05,70.0,2.47,67.53,550.52,testing,59,4
57,550.52,70.0,2.2,67.8,482.72,testing,59,4
58,482.72,70.0,1.93,68.07,414.65,testing,59,4
59,414.65,70.0,1.66,68.34,346.31,testing,59,4
60,346.31,70.0,1.39,68.61,277.7,testing,59,4
61,277.7,70.0,1.11,68.89,208.81,testing,59,4
62,208.81,70.0,0.84,69.16,139.65,testing,59,4
63,139.65,70.0,0.56,69.44,70.21,testing,59,4
64,70.21,70.0,0.28,69.72,0.49,testing,59,4
65,0.49,70.0,0.0,70.0,-69.51,testing,59,4
0,20000.0,191.04,108.0,83.04,19916.96,WellsFargo2,59,5
1,19916.96,191.04,107.55,83.49,19833.47,WellsFargo2,59,5
2,19833.47,191.04,107.1,83.94,19749.53,WellsFargo2,59,5
3,19749.53,191.04,106.65,84.39,19665.14,WellsFargo2,59,5
4,19665.14,191.04,106.19,84.85,19580.29,WellsFargo2,59,5
5,19580.29,191.04,105.73,85.31,19494.98,WellsFargo2,59,5
6,19494.98,191.04,105.27,85.77,19409.21,WellsFargo2,59,5
7,19409.21,191.04,104.81,86.23,19322.98,WellsFargo2,59,5
8,19322.98,191.04,104.34,86.7,19236.28,WellsFargo2,59,5
9,19236.28,191.04,103.88,87.16,19149.12,WellsFargo2,59,5
10,19149.12,191.04,103.41,87.63,19061.49,WellsFargo2,59,5
11,19061.49,191.04,102.93,88.11,18973.38,WellsFargo2,59,5
12,18973.38,191.04,102.46,88.58,18884.8,WellsFargo2,59,5
13,18884.8,191.04,101.98,89.06,18795.74,WellsFargo2,59,5
14,18795.74,191.04,101.5,89.54,18706.2,WellsFargo2,59,5
15,18706.2,191.04,101.01,90.03,18616.17,WellsFargo2,59,5
16,18616.17,191.04,100.53,90.51,18525.66,WellsFargo2,59,5
17,18525.66,191.04,100.04,91.0,18434.66,WellsFargo2,59,5
18,18434.66,191.04,99.55,91.49,18343.17,WellsFargo2,59,5
19,18343.17,191.04,99.05,91.99,18251.18,WellsFargo2,59,5
20,18251.18,191.04,98.56,92.48,18158.7,WellsFargo2,59,5
21,18158.7,191.04,98.06,92.98,18065.72,WellsFargo2,59,5
22,18065.72,191.04,97.55,93.49,17972.23,WellsFargo2,59,5
23,17972.23,191.04,97.05,93.99,17878.24,WellsFargo2,59,5
24,17878.24,191.04,96.54,94.5,17783.74,WellsFargo2,59,5
25,17783.74,191.04,96.03,95.01,17688.73,WellsFargo2,59,5
26,17688.73,191.04,95.52,95.52,17593.21,WellsFargo2,59,5
27,17593.21,191.04,95.0,96.04,17497.17,WellsFargo2,59,5
28,17497.17,191.04,94.48,96.56,17400.61,WellsFargo2,59,5
29,17400.61,191.04,93.96,97.08,17303.53,WellsFargo2,59,5
30,17303.53,191.04,93.44,97.6,17205.93,WellsFargo2,59,5
31,17205.93,191.04,92.91,98.13,17107.8,WellsFargo2,59,5
32,17107.8,191.04,92.38,98.66,17009.14,WellsFargo2,59,5
33,17009.14,191.04,91.85,99.19,16909.95,WellsFargo2,59,5
34,16909.95,191.04,91.31,99.73,16810.22,WellsFargo2,59,5
35,16810.22,191.04,90.78,100.26,16709.96,WellsFargo2,59,5
36,16709.96,191.04,90.23,100.81,16609.15,WellsFargo2,59,5
37,16609.15,191.04,89.69,101.35,16507.8,WellsFargo2,59,5
38,16507.8,191.04,89.14,101.9,16405.9,WellsFargo2,59,5
39,16405.9,191.04,88.59,102.45,16303.45,WellsFargo2,59,5
40,16303.45,191.04,88.04,103.0,16200.45,WellsFargo2,59,5
41,16200.45,191.04,87.48,103.56,16096.89,WellsFargo2,59,5
42,16096.89,191.04,86.92,104.12,15992.77,WellsFargo2,59,5
43,15992.77,191.04,86.36,104.68,15888.09,WellsFargo2,59,5
44,15888.09,191.04,85.8,105.24,15782.85,WellsFargo2,59,5
45,15782.85,191.04,85.23,105.81,15677.04,WellsFargo2,59,5
46,15677.04,191.04,84.66,106.38,15570.66,WellsFargo2,59,5
47,15570.66,191.04,84.08,106.96,15463.7,WellsFargo2,59,5
48,15463.7,191.04,83.5,107.54,15356.16,WellsFargo2,59,5
49,15356.16,191.04,82.92,108.12,15248.04,WellsFargo2,59,5
50,15248.04,191.04,82.34,108.7,15139.34,WellsFargo2,59,5
51,15139.34,191.04,81.75,109.29,15030.05,WellsFargo2,59,5
52,15030.05,191.04,81.16,109.88,14920.17,WellsFargo2,59,5
53,14920.17,191.04,80.57,110.47,14809.7,WellsFargo2,59,5
54,14809.7,191.04,79.97,111.07,14698.63,WellsFargo2,59,5
55,14698.63,191.04,79.37,111.67,14586.96,WellsFargo2,59,5
56,14586.96,191.04,78.77,112.27,14474.69,WellsFargo2,59,5
57,14474.69,191.04,78.16,112.88,14361.81,WellsFargo2,59,5
58,14361.81,191.04,77.55,113.49,14248.32,WellsFargo2,59,5
59,14248.32,191.04,76.94,114.1,14134.22,WellsFargo2,59,5
60,14134.22,191.04,76.32,114.72,14019.5,WellsFargo2,59,5
61,14019.5,191.04,75.71,115.33,13904.17,WellsFargo2,59,5
62,13904.17,191.04,75.08,115.96,13788.21,WellsFargo2,59,5
63,13788.21,191.04,74.46,116.58,13671.63,WellsFargo2,59,5
64,13671.63,191.04,73.83,117.21,13554.42,WellsFargo2,59,5
65,13554.42,260.55,73.19,187.36,13367.06,WellsFargo2,59,5
66,13367.06,3010.1,72.18,2937.92,10429.14,WellsFargo2,59,5
67,10429.14,3010.1,56.32,2953.78,7475.36,WellsFargo2,59,5
68,7475.36,3010.1,40.37,2969.73,4505.63,WellsFargo2,59,5
69,4505.63,3010.1,24.33,2985.77,1519.86,WellsFargo2,59,5
70,1519.86,3010.1,8.21,3001.89,-1482.03,WellsFargo2,59,5
0,8250.57,1084.62,53.63,1030.99,7219.58,WellsFargo1,60,1
1,7219.58,1084.62,46.93,1037.69,6181.89,WellsFargo1,60,1
2,6181.89,1084.62,40.18,1044.44,5137.45,WellsFargo1,60,1
3,5137.45,1084.62,33.39,1051.23,4086.22,WellsFargo1,60,1
4,4086.22,1084.62,26.56,1058.06,3028.16,WellsFargo1,60,1
5,3028.16,1084.62,19.68,1064.94,1963.22,WellsFargo1,60,1
6,1963.22,1084.62,12.76,1071.86,891.36,WellsFargo1,60,1
7,891.36,1084.62,5.79,1078.83,-187.47,WellsFargo1,60,1
0,5000.0,333.0,36.0,297.0,4703.0,Car,60,2
1,4703.0,333.0,33.86,299.14,4403.86,Car,60,2
2,4403.86,333.0,31.71,301.29,4102.57,Car,60,2
3,4102.57,333.0,29.54,303.46,3799.11,Car,60,2
4,3799.11,333.0,27.35,305.65,3493.46,Car,60,2
5,3493.46,333.0,25.15,307.85,3185.61,Car,60,2
6,3185.61,333.0,22.94,310.06,2875.55,Car,60,2
7,2875.55,520.47,20.7,499.77,2375.78,Car,60,2
8,2375.78,1417.62,17.11,1400.51,975.27,Car,60,2
9,975.27,1417.62,7.02,1410.6,-435.33,Car,60,2
0,180000.0,1331.44,594.0,737.44,179262.56,mortgage,60,3
1,179262.56,1331.44,591.57,739.87,178522.69,mortgage,60,3
2,178522.69,1331.44,589.12,742.32,177780.37,mortgage,60,3
3,177780.37,1331.44,586.68,744.76,177035.61,mortgage,60,3
4,177035.61,1331.44,584.22,747.22,176288.39,mortgage,60,3
5,176288.39,1331.44,581.75,749.69,175538.7,mortgage,60,3
6,175538.7,1331.44,579.28,752.16,174786.54,mortgage,60,3
7,174786.54,1331.44,576.8,754.64,174031.9,mortgage,60,3
8,174031.9,1331.44,574.31,757.13,173274.77,mortgage,60,3
9,173274.77,1766.77,571.81,1194.96,172079.81,mortgage,60,3
10,172079.81,2749.06,567.86,2181.2,169898.61,mortgage,60,3
11,169898.61,2749.06,560.67,2188.39,167710.22,mortgage,60,3
12,167710.22,2749.06,553.44,2195.62,165514.6,mortgage,60,3
13,165514.6,2749.06,546.2,2202.86,163311.74,mortgage,60,3
14,163311.74,2749.06,538.93,2210.13,161101.61,mortgage,60,3
15,161101.61,2749.06,531.64,2217.42,158884.19,mortgage,60,3
16,158884.19,2749.06,524.32,2224.74,156659.45,mortgage,60,3
17,156659.45,2749.06,516.98,2232.08,154427.37,mortgage,60,3
18,154427.37,2749.06,509.61,2239.45,152187.92,mortgage,60,3
19,152187.92,2749.06,502.22,2246.84,149941.08,mortgage,60,3
20,149941.08,2749.06,494.81,2254.25,147686.83,mortgage,60,3
21,147686.83,2749.06,487.37,2261.69,145425.14,mortgage,60,3
22,145425.14,2749.06,479.9,2269.16,143155.98,mortgage,60,3
23,143155.98,2749.06,472.41,2276.65,140879.33,mortgage,60,3
24,140879.33,2749.06,464.9,2284.16,138595.17,mortgage,60,3
25,138595.17,2749.06,457.36,2291.7,136303.47,mortgage,60,3
26,136303.47,2749.06,449.8,2299.26,134004.21,mortgage,60,3
27,134004.21,2749.06,442.21,2306.85,131697.36,mortgage,60,3
28,131697.36,2749.06,434.6,2314.46,129382.9,mortgage,60,3
29,129382.9,2749.06,426.96,2322.1,127060.8,mortgage,60,3
30,127060.8,2749.06,419.3,2329.76,124731.04,mortgage,60,3
31,124731.04,2749.06,411.61,2337.45,122393.59,mortgage,60,3
32,122393.59,2749.06,403.9,2345.16,120048.43,mortgage,60,3
33,120048.43,2749.06,396.16,2352.9,117695.53,mortgage,60,3
34,117695.53,2749.06,388.4,2360.66,115334.87,mortgage,60,3
35,115334.87,2749.06,380.61,2368.45,112966.42,mortgage,60,3
36,112966.42,2749.06,372.79,2376.27,110590.15,mortgage,60,3
37,110590.15,2749.06,364.95,2384.11,108206.04,mortgage,60,3
38,108206.04,2749.06,357.08,2391.98,105814.06,mortgage,60,3
39,105814.06,2749.06,349.19,2399.87,103414.19,mortgage,60,3
40,103414.19,2749.06,341.27,2407.79,101006.4,mortgage,60,3
41,101006.4,2749.06,333.32,2415.74,98590.66,mortgage,60,3
42,98590.66,2749.06,325.35,2423.71,96166.95,mortgage,60,3
43,96166.95,2749.06,317.35,2431.71,93735.24,mortgage,60,3
44,93735.24,2749.06,309.33,2439.73,91295.51,mortgage,60,3
45,91295.51,2749.06,301.28,2447.78,88847.73,mortgage,60,3
46,88847.73,2749.06,293.2,2455.86,86391.87,mortgage,60,3
47,86391.87,2749.06,285.09,2463.97,83927.9,mortgage,60,3
48,83927.9,2749.06,276.96,2472.1,81455.8,mortgage,60,3
49,81455.8,2749.06,268.8,2480.26,78975.54,mortgage,60,3
50,78975.54,2749.06,260.62,2488.44,76487.1,mortgage,60,3
51,76487.1,2749.06,252.41,2496.65,73990.45,mortgage,60,3
52,73990.45,2749.06,244.17,2504.89,71485.56,mortgage,60,3
53,71485.56,2749.06,235.9,2513.16,68972.4,mortgage,60,3
54,68972.4,2749.06,227.61,2521.45,66450.95,mortgage,60,3
55,66450.95,2749.06,219.29,2529.77,63921.18,mortgage,60,3
56,63921.18,2749.06,210.94,2538.12,61383.06,mortgage,60,3
57,61383.06,2749.06,202.56,2546.5,58836.56,mortgage,60,3
58,58836.56,2749.06,194.16,2554.9,56281.66,mortgage,60,3
59,56281.66,2749.06,185.73,2563.33,53718.33,mortgage,60,3
60,53718.33,2749.06,177.27,2571.79,51146.54,mortgage,60,3
61,51146.54,2749.06,168.78,2580.28,48566.26,mortgage,60,3
62,48566.26,2749.06,160.27,2588.79,45977.47,mortgage,60,3
63,45977.47,2749.06,151.73,2597.33,43380.14,mortgage,60,3
64,43380.14,2749.06,143.15,2605.91,40774.23,mortgage,60,3
65,40774.23,2749.06,134.55,2614.51,38159.72,mortgage,60,3
66,38159.72,2749.06,125.93,2623.13,35536.59,mortgage,60,3
67,35536.59,2749.06,117.27,2631.79,32904.8,mortgage,60,3
68,32904.8,2749.06,108.59,2640.47,30264.33,mortgage,60,3
69,30264.33,2749.06,99.87,2649.19,27615.14,mortgage,60,3
70,27615.14,2749.06,91.13,2657.93,24957.21,mortgage,60,3
71,24957.21,2749.06,82.36,2666.7,22290.51,mortgage,60,3
72,22290.51,2749.06,73.56,2675.5,19615.01,mortgage,60,3
73,19615.01,2749.06,64.73,2684.33,16930.68,mortgage,60,3
74,16930.68,2749.06,55.87,2693.19,14237.49,mortgage,60,3
75,14237.49,2749.06,46.98,2702.08,11535.41,mortgage,60,3
76,11535.41,2749.06,38.07,2710.99,8824.42,mortgage,60,3
77,8824.42,2749.06,29.12,2719.94,6104.48,mortgage,60,3
78,6104.48,2749.06,20.14,2728.92,3375.56,mortgage,60,3
79,3375.56,2749.06,11.14,2737.92,637.64,mortgage,60,3
80,637.64,2749.06,2.1,2746.96,-2109.32,mortgage,60,3
0,20000.0,191.04,108.0,83.04,19916.96,WellsFargo2,60,4
1,19916.96,191.04,107.55,83.49,19833.47,WellsFargo2,60,4
2,19833.47,191.04,107.1,83.94,19749.53,WellsFargo2,60,4
3,19749.53,191.04,106.65,84.39,19665.14,WellsFargo2,60,4
4,19665.14,191.04,106.19,84.85,19580.29,WellsFargo2,60,4
5,19580.29,191.04,105.73,85.31,19494.98,WellsFargo2,60,4
6,19494.98,191.04,105.27,85.77,19409.21,WellsFargo2,60,4
7,19409.21,191.04,104.81,86.23,19322.98,WellsFargo2,60,4
8,19322.98,191.04,104.34,86.7,19236.28,WellsFargo2,60,4
9,19236.28,191.04,103.88,87.16,19149.12,WellsFargo2,60,4
10,19149.12,191.04,103.41,87.63,19061.49,WellsFargo2,60,4
11,19061.49,191.04,102.93,88.11,18973.38,WellsFargo2,60,4
12,18973.38,191.04,102.46,88.58,18884.8,WellsFargo2,60,4
13,18884.8,191.04,101.98,89.06,18795.74,WellsFargo2,60,4
14,18795.74,191.04,101.5,89.54,18706.2,WellsFargo2,60,4
15,18706.2,191.04,101.01,90.03,18616.17,WellsFargo2,60,4
16,18616.17,191.04,100.53,90.51,18525.66,WellsFargo2,60,4
17,18525.66,191.04,100.04,91.0,18434.66,WellsFargo2,60,4
18,18434.66,191.04,99.55,91.49,18343.17,WellsFargo2,60,4
19,18343.17,191.04,99.05,91.99,18251.18,WellsFargo2,60,4
20,18251.18,191.04,98.56,92.48,18158.7,WellsFargo2,60,4
21,18158.7,191.04,98.06,92.98,18065.72,WellsFargo2,60,4
22,18065.72,191.04,97.55,93.49,17972.23,WellsFargo2,60,4
23,17972.23,191.04,97.05,93.99,17878.24,WellsFargo2,60,4
24,17878.24,191.04,96.54,94.5,17783.74,WellsFargo2,60,4
25,17783.74,191.04,96.03,95.01,17688.73,WellsFargo2,60,4
26,17688.73,191.04,95.52,95.52,17593.21,WellsFargo2,60,4
27,17593.21,191.04,95.0,96.04,17497.17,WellsFargo2,60,4
28,17497.17,191.04,94.48,96.56,17400.61,WellsFargo2,60,4
29,17400.61,191.04,93.96,97.08,17303.53,WellsFargo2,60,4
30,17303.53,191.04,93.44,97.6,17205.93,WellsFargo2,60,4
31,17205.93,191.04,92.91,98.13,17107.8,WellsFargo2,60,4
32,17107.8,191.04,92.38,98.66,17009.14,WellsFargo2,60,4
33,17009.14,191.04,91.85,99.19,16909.95,WellsFargo2,60,4
34,16909.95,191.04,91.31,99.73,16810.22,WellsFargo2,60,4
35,16810.22,191.04,90.78,100.26,16709.96,WellsFargo2,60,4
36,16709.96,191.04,90.23,100.81,16609.15,WellsFargo2,60,4
37,16609.15,191.04,89.69,101.35,16507.8,WellsFargo2,60,4
38,16507.8,191.04,89.14,101.9,16405.9,WellsFargo2,60,4
39,16405.9,191.04,88.59,102.45,16303.45,WellsFargo2,60,4
40,16303.45,191.04,88.04,103.0,16200.45,WellsFargo2,60,4
41,16200.45,191.04,87.48,103.56,16096.89,WellsFargo2,60,4
42,16096.89,191.04,86.92,104.12,15992.77,WellsFargo2,60,4
43,15992.77,191.04,86.36,104.68,15888.09,WellsFargo2,60,4
44,15888.09,191.04,85.8,105.24,15782.85,WellsFargo2,60,4
45,15782.85,191.04,85.23,105.81,15677.04,WellsFargo2,60,4
46,15677.04,191.04,84.66,106.38,15570.66,WellsFargo2,60,4
47,15570.66,191.04,84.08,106.96,15463.7,WellsFargo2,60,4
48,15463.7,191.04,83.5,107.54,15356.16,WellsFargo2,60,4
49,15356.16,191.04,82.92,108.12,15248.04,WellsFargo2,60,4
50,15248.04,191.04,82.34,108.7,15139.34,WellsFargo2,60,4
51,15139.34,191.04,81.75,109.29,15030.05,WellsFargo2,60,4
52,15030.05,191.04,81.16,109.88,14920.17,WellsFargo2,60,4
53,14920.17,191.04,80.57,110.47,14809.7,WellsFargo2,60,4
54,14809.7,191.04,79.97,111.07,14698.63,WellsFargo2,60,4
55,14698.63,191.04,79.37,111.67,14586.96,WellsFargo2,60,4
56,14586.96,191.04,78.77,112.27,14474.69,WellsFargo2,60,4
57,14474.69,191.04,78.16,112.88,14361.81,WellsFargo2,60,4
58,14361.81,191.04,77.55,113.49,14248.32,WellsFargo2,60,4
59,14248.32,191.04,76.94,114.1,14134.22,WellsFargo2,60,4
60,14134.22,191.04,76.32,114.72,14019.5,WellsFargo2,60,4
61,14019.5,191.04,75.71,115.33,13904.17,WellsFargo2,60,4
62,13904.17,191.04,75.08,115.96,13788.21,WellsFargo2,60,4
63,13788.21,191.04,74.46,116.58,13671.63,WellsFargo2,60,4
64,13671.63,191.04,73.83,117.21,13554.42,WellsFargo2,60,4
65,13554.42,191.04,73.19,117.85,13436.57,WellsFargo2,60,4
66,13436.57,191.04,72.56,118.48,13318.09,WellsFargo2,60,4
67,13318.09,191.04,71.92,119.12,13198.97,WellsFargo2,60,4
68,13198.97,191.04,71.27,119.77,13079.2,WellsFargo2,60,4
69,13079.2,191.04,70.63,120.41,12958.79,WellsFargo2,60,4
70,12958.79,191.04,69.98,121.06,12837.73,WellsFargo2,60,4
71,12837.73,191.04,69.32,121.72,12716.01,WellsFargo2,60,4
72,12716.01,191.04,68.67,122.37,12593.64,WellsFargo2,60,4
73,12593.64,191.04,68.01,123.03,12470.61,WellsFargo2,60,4
74,12470.61,191.04,67.34,123.7,12346.91,WellsFargo2,60,4
75,12346.91,191.04,66.67,124.37,12222.54,WellsFargo2,60,4
76,12222.54,191.04,66.0,125.04,12097.5,WellsFargo2,60,4
77,12097.5,191.04,65.33,125.71,11971.79,WellsFargo2,60,4
78,11971.79,191.04,64.65,126.39,11845.4,WellsFargo2,60,4
79,11845.4,191.04,63.97,127.07,11718.33,WellsFargo2,60,4
80,11718.33,2300.36,63.28,2237.08,9481.25,WellsFargo2,60,4
81,9481.25,2940.1,51.2,2888.9,6592.35,WellsFargo2,60,4
82,6592.35,2940.1,35.6,2904.5,3687.85,WellsFargo2,60,4
83,3687.85,2940.1,19.91,2920.19,767.66,WellsFargo2,60,4
84,767.66,2940.1,4.15,2935.95,-2168.29,WellsFargo2,60,4
0,4000.0,70.0,16.0,54.0,3946.0,testing,60,5
1,3946.0,70.0,15.78,54.22,3891.78,testing,60,5
2,3891.78,70.0,15.57,54.43,3837.35,testing,60,5
3,3837.35,70.0,15.35,54.65,3782.7,testing,60,5
4,3782.7,70.0,15.13,54.87,3727.83,testing,60,5
5,3727.83,70.0,14.91,55.09,3672.74,testing,60,5
6,3672.74,70.0,14.69,55.31,3617.43,testing,60,5
7,3617.43,70.0,14.47,55.53,3561.9,testing,60,5
8,3561.9,70.0,14.25,55.75,3506.15,testing,60,5
9,3506.15,70.0,14.02,55.98,3450.17,testing,60,5
10,3450.17,70.0,13.8,56.2,3393.97,testing,60,5
11,3393.97,70.0,13.58,56.42,3337.55,testing,60,5
12,3337.55,70.0,13.35,56.65,3280.9,testing,60,5
13,3280.9,70.0,13.12,56.88,3224.02,testing,60,5
14,3224.02,70.0,12.9,57.1,3166.92,testing,60,5
15,3166.92,70.0,12.67,57.33,3109.59,testing,60,5
16,3109.59,70.0,12.44,57.56,3052.03,testing,60,5
17,3052.03,70.0,12.21,57.79,2994.24,testing,60,5
18,2994.24,70.0,11.98,58.02,2936.22,testing,60,5
19,2936.22,70.0,11.74,58.26,2877.96,testing,60,5
20,2877.96,70.0,11.51,58.49,2819.47,testing,60,5
21,2819.47,70.0,11.28,58.72,2760.75,testing,60,5
22,2760.75,70.0,11.04,58.96,2701.79,testing,60,5
23,2701.79,70.0,10.81,59.19,2642.6,testing,60,5
24,2642.6,70.0,10.57,59.43,2583.17,testing,60,5
25,2583.17,70.0,10.33,59.67,2523.5,testing,60,5
26,2523.5,70.0,10.09,59.91,2463.59,testing,60,5
27,2463.59,70.0,9.85,60.15,2403.44,testing,60,5
28,2403.44,70.0,9.61,60.39,2343.05,testing,60,5
29,2343.05,70.0,9.37,60.63,2282.42,testing,60,5
30,2282.42,70.0,9.13,60.87,2221.55,testing,60,5
31,2221.55,70.0,8.89,61.11,2160.44,testing,60,5
32,2160.44,70.0,8.64,61.36,2099.08,testing,60,5
33,2099.08,70.0,8.4,61.6,2037.48,testing,60,5
34,2037.48,70.0,8.15,61.85,1975.63,testing,60,5
35,1975.63,70.0,7.9,62.1,1913.53,testing,60,5
36,1913.53,70.0,7.65,62.35,1851.18,testing,60,5
37,1851.18,70.0,7.4,62.6,1788.58,testing,60,5
38,1788.58,70.0,7.15,62.85,1725.73,testing,60,5
39,1725.73,70.0,6.9,63.1,1662.63,testing,60,5
40,1662.63,70.0,6.65,63.35,1599.28,testing,60,5
41,1599.28,70.0,6.4,63.6,1535.68,testing,60,5
42,1535.68,70.0,6.14,63.86,1471.82,testing,60,5
43,1471.82,70.0,5.89,64.11,1407.71,testing,60,5
44,1407.71,70.0,5.63,64.37,1343.34,testing,60,5
45,1343.34,70.0,5.37,64.63,1278.71,testing,60,5
46,1278.71,70.0,5.11,64.89,1213.82,testing,60,5
47,1213.82,70.0,4.86,65.14,1148.68,testing,60,5
48,1148.68,70.0,4.59,65.41,1083.27,testing,60,5
49,1083.27,70.0,4.33,65.67,1017.6,testing,60,5
50,1017.6,70.0,4.07,65.93,951.67,testing,60,5
51,951.67,70.0,3.81,66.19,885.48,testing,60,5
52,885.48,70.0,3.54,66.46,819.02,testing,60,5
53,819.02,70.0,3.28,66.72,752.3,testing,60,5
54,752.3,70.0,3.01,66.99,685.31,testing,60,5
55,685.31,70.0,2.74,67.26,618.05,testing,60,5
56,618.05,70.0,2.47,67.53,550.52,testing,60,5
57,550.52,70.0,2.2,67.8,482.72,testing,60,5
58,482.72,70.0,1.93,68.07,414.65,testing,60,5
59,414.65,70.0,1.66,68.34,346.31,testing,60,5
60,346.31,70.0,1.39,68.61,277.7,testing,60,5
61,277.7,70.0,1.11,68.89,208.81,testing,60,5
62,208.81,70.0,0.84,69.16,139.65,testing,60,5
63,139.65,70.0,0.56,69.44,70.21,testing,60,5
64,70.21,70.0,0.28,69.72,0.49,testing,60,5
65,0.49,70.0,0.0,70.0,-69.51,testing,60,5
0,8250.57,1084.62,53.63,1030.99,7219.58,WellsFargo1,61,1
1,7219.58,1084.62,46.93,1037.69,6181.89,WellsFargo1,61,1
2,6181.89,1084.62,40.18,1044.44,5137.45,WellsFargo1,61,1
3,5137.45,1084.62,33.39,1051.23,4086.22,WellsFargo1,61,1
4,4086.22,1084.62,26.56,1058.06,3028.16,WellsFargo1,61,1
5,3028.16,1084.62,19.68,1064.94,1963.22,WellsFargo1,61,1
6,1963.22,1084.62,12.76,1071.86,891.36,WellsFargo1,61,1
7,891.36,1084.62,5.79,1078.83,-187.47,WellsFargo1,61,1
0,20000.0,191.04,108.0,83.04,19916.96,WellsFargo2,61,2
1,19916.96,191.04,107.55,83.49,19833.47,WellsFargo2,61,2
2,19833.47,191.04,107.1,83.94,19749.53,WellsFargo2,61,2
3,19749.53,191.04,106.65,84.39,19665.14,WellsFargo2,61,2
4,19665.14,191.04,106.19,84.85,19580.29,WellsFargo2,61,2
5,19580.29,191.04,105.73,85.31,19494.98,WellsFargo2,61,2
6,19494.98,191.04,105.27,85.77,19409.21,WellsFargo2,61,2
7,19409.21,378.51,104.81,273.7,19135.51,WellsFargo2,61,2
8,19135.51,1275.66,103.33,1172.33,17963.18,WellsFargo2,61,2
9,17963.18,1275.66,97.0,1178.66,16784.52,WellsFargo2,61,2
10,16784.52,1275.66,90.64,1185.02,15599.5,WellsFargo2,61,2
11,15599.5,1275.66,84.24,1191.42,14408.08,WellsFargo2,61,2
12,14408.08,1275.66,77.8,1197.86,13210.22,WellsFargo2,61,2
13,13210.22,1275.66,71.34,1204.32,12005.9,WellsFargo2,61,2
14,12005.9,1275.66,64.83,1210.83,10795.07,WellsFargo2,61,2
15,10795.07,1275.66,58.29,1217.37,9577.7,WellsFargo2,61,2
16,9577.7,1275.66,51.72,1223.94,8353.76,WellsFargo2,61,2
17,8353.76,1275.66,45.11,1230.55,7123.21,WellsFargo2,61,2
18,7123.21,1275.66,38.47,1237.19,5886.02,WellsFargo2,61,2
19,5886.02,1275.66,31.78,1243.88,4642.14,WellsFargo2,61,2
20,4642.14,1275.66,25.07,1250.59,3391.55,WellsFargo2,61,2
21,3391.55,1275.66,18.31,1257.35,2134.2,WellsFargo2,61,2
22,2134.2,1275.66,11.52,1264.14,870.06,WellsFargo2,61,2
23,870.06,1275.66,4.7,1270.96,-400.9,WellsFargo2,61,2
0,4000.0,70.0,16.0,54.0,3946.0,testing,61,3
1,3946.0,70.0,15.78,54.22,3891.78,testing,61,3
2,3891.78,70.0,15.57,54.43,3837.35,testing,61,3
3,3837.35,70.0,15.35,54.65,3782.7,testing,61,3
4,3782.7,70.0,15.13,54.87,3727.83,testing,61,3
5,3727.83,70.0,14.91,55.09,3672.74,testing,61,3
6,3672.74,70.0,14.69,55.31,3617.43,testing,61,3
7,3617.43,70.0,14.47,55.53,3561.9,testing,61,3
8,3561.9,70.0,14.25,55.75,3506.15,testing,61,3
9,3506.15,70.0,14.02,55.98,3450.17,testing,61,3
10,3450.17,70.0,13.8,56.2,3393.97,testing,61,3
11,3393.97,70.0,13.58,56.42,3337.55,testing,61,3
12,3337.55,70.0,13.35,56.65,3280.9,testing,61,3
13,3280.9,70.0,13.12,56.88,3224.02,testing,61,3
14,3224.02,70.0,12.9,57.1,3166.92,testing,61,3
15,3166.92,70.0,12.67,57.33,3109.59,testing,61,3
16,3109.59,70.0,12.44,57.56,3052.03,testing,61,3
17,3052.03,70.0,12.21,57.79,2994.24,testing,61,3
18,2994.24,70.0,11.98,58.02,2936.22,testing,61,3
19,2936.22,70.0,11.74,58.26,2877.96,testing,61,3
20,2877.96,70.0,11.51,58.49,2819.47,testing,61,3
21,2819.47,70.0,11.28,58.72,2760.75,testing,61,3
22,2760.75,70.0,11.04,58.96,2701.79,testing,61,3
23,2701.79,470.9,10.81,460.09,2241.7,testing,61,3
24,2241.7,1345.66,8.97,1336.69,905.01,testing,61,3
25,905.01,1345.66,3.62,1342.04,-437.03,testing,61,3
0,5000.0,333.0,36.0,297.0,4703.0,Car,61,4
1,4703.0,333.0,33.86,299.14,4403.86,Car,61,4
2,4403.86,333.0,31.71,301.29,4102.57,Car,61,4
3,4102.57,333.0,29.54,303.46,3799.11,Car,61,4
4,3799.11,333.0,27.35,305.65,3493.46,Car,61,4
5,3493.46,333.0,25.15,307.85,3185.61,Car,61,4
6,3185.61,333.0,22.94,310.06,2875.55,Car,61,4
7,2875.55,333.0,20.7,312.3,2563.25,Car,61,4
8,2563.25,333.0,18.46,314.54,2248.71,Car,61,4
9,2248.71,333.0,16.19,316.81,1931.9,Car,61,4
10,1931.9,333.0,13.91,319.09,1612.81,Car,61,4
11,1612.81,333.0,11.61,321.39,1291.42,Car,61,4
12,1291.42,333.0,9.3,323.7,967.72,Car,61,4
13,967.72,333.0,6.97,326.03,641.69,Car,61,4
14,641.69,333.0,4.62,328.38,313.31,Car,61,4
15,313.31,333.0,2.26,330.74,-17.43,Car,61,4
0,180000.0,1331.44,594.0,737.44,179262.56,mortgage,61,5
1,179262.56,1331.44,591.57,739.87,178522.69,mortgage,61,5
2,178522.69,1331.44,589.12,742.32,177780.37,mortgage,61,5
3,177780.37,1331.44,586.68,744.76,177035.61,mortgage,61,5
4,177035.61,1331.44,584.22,747.22,176288.39,mortgage,61,5
5,176288.39,1331.44,581.75,749.69,175538.7,mortgage,61,5
6,175538.7,1331.44,579.28,752.16,174786.54,mortgage,61,5
7,174786.54,1331.44,576.8,754.64,174031.9,mortgage,61,5
8,174031.9,1331.44,574.31,757.13,173274.77,mortgage,61,5
9,173274.77,1331.44,571.81,759.63,172515.14,mortgage,61,5
10,172515.14,1331.44,569.3,762.14,171753.0,mortgage,61,5
11,171753.0,1331.44,566.78,764.66,170988.34,mortgage,61,5
12,170988.34,1331.44,564.26,767.18,170221.16,mortgage,61,5
13,170221.16,1331.44,561.73,769.71,169451.45,mortgage,61,5
14,169451.45,1331.44,559.19,772.25,168679.2,mortgage,61,5
15,168679.2,1348.87,556.64,792.23,167886.97,mortgage,61,5
16,167886.97,3010.1,554.03,2456.07,165430.9,mortgage,61,5
17,165430.9,3010.1,545.92,2464.18,162966.72,mortgage,61,5
18,162966.72,3010.1,537.79,2472.31,160494.41,mortgage,61,5
19,160494.41,3010.1,529.63,2480.47,158013.94,mortgage,61,5
20,158013.94,3010.1,521.45,2488.65,155525.29,mortgage,61,5
21,155525.29,3010.1,513.23,2496.87,153028.42,mortgage,61,5
22,153028.42,3010.1,504.99,2505.11,150523.31,mortgage,61,5
23,150523.31,3010.1,496.73,2513.37,148009.94,mortgage,61,5
24,148009.94,3010.1,488.43,2521.67,145488.27,mortgage,61,5
25,145488.27,3010.1,480.11,2529.99,142958.28,mortgage,61,5
26,142958.28,3010.1,471.76,2538.34,140419.94,mortgage,61,5
27,140419.94,3010.1,463.39,2546.71,137873.23,mortgage,61,5
28,137873.23,3010.1,454.98,2555.12,135318.11,mortgage,61,5
29,135318.11,3010.1,446.55,2563.55,132754.56,mortgage,61,5
30,132754.56,3010.1,438.09,2572.01,130182.55,mortgage,61,5
31,130182.55,3010.1,429.6,2580.5,127602.05,mortgage,61,5
32,127602.05,3010.1,421.09,2589.01,125013.04,mortgage,61,5
33,125013.04,3010.1,412.54,2597.56,122415.48,mortgage,61,5
34,122415.48,3010.1,403.97,2606.13,119809.35,mortgage,61,5
35,119809.35,3010.1,395.37,2614.73,117194.62,mortgage,61,5
36,117194.62,3010.1,386.74,2623.36,114571.26,mortgage,61,5
37,114571.26,3010.1,378.09,2632.01,111939.25,mortgage,61,5
38,111939.25,3010.1,369.4,2640.7,109298.55,mortgage,61,5
39,109298.55,3010.1,360.69,2649.41,106649.14,mortgage,61,5
40,106649.14,3010.1,351.94,2658.16,103990.98,mortgage,61,5
41,103990.98,3010.1,343.17,2666.93,101324.05,mortgage,61,5
42,101324.05,3010.1,334.37,2675.73,98648.32,mortgage,61,5
43,98648.32,3010.1,325.54,2684.56,95963.76,mortgage,61,5
44,95963.76,3010.1,316.68,2693.42,93270.34,mortgage,61,5
45,93270.34,3010.1,307.79,2702.31,90568.03,mortgage,61,5
46,90568.03,3010.1,298.87,2711.23,87856.8,mortgage,61,5
47,87856.8,3010.1,289.93,2720.17,85136.63,mortgage,61,5
48,85136.63,3010.1,280.95,2729.15,82407.48,mortgage,61,5
49,82407.48,3010.1,271.94,2738.16,79669.32,mortgage,61,5
50,79669.32,3010.1,262.91,2747.19,76922.13,mortgage,61,5
51,76922.13,3010.1,253.84,2756.26,74165.87,mortgage,61,5
52,74165.87,3010.1,244.75,2765.35,71400.52,mortgage,61,5
53,71400.52,3010.1,235.62,2774.48,68626.04,mortgage,61,5
54,68626.04,3010.1,226.47,2783.63,65842.41,mortgage,61,5
55,65842.41,3010.1,217.28,2792.82,63049.59,mortgage,61,5
56,63049.59,3010.1,208.06,2802.04,60247.55,mortgage,61,5
57,60247.55,3010.1,198.82,2811.28,57436.27,mortgage,61,5
58,57436.27,3010.1,189.54,2820.56,54615.71,mortgage,61,5
59,54615.71,3010.1,180.23,2829.87,51785.84,mortgage,61,5
60,51785.84,3010.1,170.89,2839.21,48946.63,mortgage,61,5
61,48946.63,3010.1,161.52,2848.58,46098.05,mortgage,61,5
62,46098.05,3010.1,152.12,2857.98,43240.07,mortgage,61,5
63,43240.07,3010.1,142.69,2867.41,40372.66,mortgage,61,5
64,40372.66,3010.1,133.23,2876.87,37495.79,mortgage,61,5
65,37495.79,3010.1,123.74,2886.36,34609.43,mortgage,61,5
66,34609.43,3010.1,114.21,2895.89,31713.54,mortgage,61,5
67,31713.54,3010.1,104.65,2905.45,28808.09,mortgage,61,5
68,28808.09,3010.1,95.07,2915.03,25893.06,mortgage,61,5
69,25893.06,3010.1,85.45,2924.65,22968.41,mortgage,61,5
70,22968.41,3010.1,75.8,2934.3,20034.11,mortgage,61,5
71,20034.11,3010.1,66.11,2943.99,17090.12,mortgage,61,5
72,17090.12,3010.1,56.4,2953.7,14136.42,mortgage,61,5
73,14136.42,3010.1,46.65,2963.45,11172.97,mortgage,61,5
74,11172.97,3010.1,36.87,2973.23,8199.74,mortgage,61,5
75,8199.74,3010.1,27.06,2983.04,5216.7,mortgage,61,5
76,5216.7,3010.1,17.22,2992.88,2223.82,mortgage,61,5
77,2223.82,3010.1,7.34,3002.76,-778.94,mortgage,61,5
0,8250.57,1084.62,53.63,1030.99,7219.58,WellsFargo1,62,1
1,7219.58,1084.62,46.93,1037.69,6181.89,WellsFargo1,62,1
2,6181.89,1084.62,40.18,1044.44,5137.45,WellsFargo1,62,1
3,5137.45,1084.62,33.39,1051.23,4086.22,WellsFargo1,62,1
4,4086.22,1084.62,26.56,1058.06,3028.16,WellsFargo1,62,1
5,3028.16,1084.62,19.68,1064.94,1963.22,WellsFargo1,62,1
6,1963.22,1084.62,12.76,1071.86,891.36,WellsFargo1,62,1
7,891.36,1084.62,5.79,1078.83,-187.47,WellsFargo1,62,1
0,20000.0,191.04,108.0,83.04,19916.96,WellsFargo2,62,2
1,19916.96,191.04,107.55,83.49,19833.47,WellsFargo2,62,2
2,19833.47,191.04,107.1,83.94,19749.53,WellsFargo2,62,2
3,19749.53,191.04,106.65,84.39,19665.14,WellsFargo2,62,2
4,19665.14,191.04,106.19,84.85,19580.29,WellsFargo2,62,2
5,19580.29,191.04,105.73,85.31,19494.98,WellsFargo2,62,2
6,19494.98,191.04,105.27,85.77,19409.21,WellsFargo2,62,2
7,19409.21,378.51,104.81,273.7,19135.51,WellsFargo2,62,2
8,19135.51,1275.66,103.33,1172.33,17963.18,WellsFargo2,62,2
9,17963.18,1275.66,97.0,1178.66,16784.52,WellsFargo2,62,2
10,16784.52,1275.66,90.64,1185.02,15599.5,WellsFargo2,62,2
11,15599.5,1275.66,84.24,1191.42,14408.08,WellsFargo2,62,2
12,14408.08,1275.66,77.8,1197.86,13210.22,WellsFargo2,62,2
13,13210.22,1275.66,71.34,1204.32,12005.9,WellsFargo2,62,2
14,12005.9,1275.66,64.83,1210.83,10795.07,WellsFargo2,62,2
15,10795.07,1275.66,58.29,1217.37,9577.7,WellsFargo2,62,2
16,9577.7,1275.66,51.72,1223.94,8353.76,WellsFargo2,62,2
17,8353.76,1275.66,45.11,1230.55,7123.21,WellsFargo2,62,2
18,7123.21,1275.66,38.47,1237.19,5886.02,WellsFargo2,62,2
19,5886.02,1275.66,31.78,1243.88,4642.14,WellsFargo2,62,2
20,4642.14,1275.66,25.07,1250.59,3391.55,WellsFargo2,62,2
21,3391.55,1275.66,18.31,1257.35,2134.2,WellsFargo2,62,2
22,2134.2,1275.66,11.52,1264.14,870.06,WellsFargo2,62,2
23,870.06,1275.66,4.7,1270.96,-400.9,WellsFargo2,62,2
0,4000.0,70.0,16.0,54.0,3946.0,testing,62,3
1,3946.0,70.0,15.78,54.22,3891.78,testing,62,3
2,3891.78,70.0,15.57,54.43,3837.35,testing,62,3
3,3837.35,70.0,15.35,54.65,3782.7,testing,62,3
4,3782.7,70.0,15.13,54.87,3727.83,testing,62,3
5,3727.83,70.0,14.91,55.09,3672.74,testing,62,3
6,3672.74,70.0,14.69,55.31,3617.43,testing,62,3
7,3617.43,70.0,14.47,55.53,3561.9,testing,62,3
8,3561.9,70.0,14.25,55.75,3506.15,testing,62,3
9,3506.15,70.0,14.02,55.98,3450.17,testing,62,3
10,3450.17,70.0,13.8,56.2,3393.97,testing,62,3
11,3393.97,70.0,13.58,56.42,3337.55,testing,62,3
12,3337.55,70.0,13.35,56.65,3280.9,testing,62,3
13,3280.9,70.0,13.12,56.88,3224.02,testing,62,3
14,3224.02,70.0,12.9,57.1,3166.92,testing,62,3
15,3166.92,70.0,12.67,57.33,3109.59,testing,62,3
16,3109.59,70.0,12.44,57.56,3052.03,testing,62,3
17,3052.03,70.0,12.21,57.79,2994.24,testing,62,3
18,2994.24,70.0,11.98,58.02,2936.22,testing,62,3
19,2936.22,70.0,11.74,58.26,2877.96,testing,62,3
20,2877.96,70.0,11.51,58.49,2819.47,testing,62,3
21,2819.47,70.0,11.28,58.72,2760.75,testing,62,3
22,2760.75,70.0,11.04,58.96,2701.79,testing,62,3
23,2701.79,470.9,10.81,460.09,2241.7,testing,62,3
24,2241.7,1345.66,8.97,1336.69,905.01,testing,62,3
25,905.01,1345.66,3.62,1342.04,-437.03,testing,62,3
0,180000.0,1331.44,594.0,737.44,179262.56,mortgage,62,4
1,179262.56,1331.44,591.57,739.87,178522.69,mortgage,62,4
2,178522.69,1331.44,589.12,742.32,177780.37,mortgage,62,4
3,177780.37,1331.44,586.68,744.76,177035.61,mortgage,62,4
4,177035.61,1331.44,584.22,747.22,176288.39,mortgage,62,4
5,176288.39,1331.44,581.75,749.69,175538.7,mortgage,62,4
6,175538.7,1331.44,579.28,752.16,174786.54,mortgage,62,4
7,174786.54,1331.44,576.8,754.64,174031.9,mortgage,62,4
8,174031.9,1331.44,574.31,757.13,173274.77,mortgage,62,4
9,173274.77,1331.44,571.81,759.63,172515.14,mortgage,62,4
10,172515.14,1331.44,569.3,762.14,171753.0,mortgage,62,4
11,171753.0,1331.44,566.78,764.66,170988.34,mortgage,62,4
12,170988.34,1331.44,564.26,767.18,170221.16,mortgage,62,4
13,170221.16,1331.44,561.73,769.71,169451.45,mortgage,62,4
14,169451.45,1331.44,559.19,772.25,168679.2,mortgage,62,4
15,168679.2,1331.44,556.64,774.8,167904.4,mortgage,62,4
16,167904.4,1331.44,554.08,777.36,167127.04,mortgage,62,4
17,167127.04,1331.44,551.52,779.92,166347.12,mortgage,62,4
18,166347.12,1331.44,548.95,782.49,165564.63,mortgage,62,4
19,165564.63,1331.44,546.36,785.08,164779.55,mortgage,62,4
20,164779.55,1331.44,543.77,787.67,163991.88,mortgage,62,4
21,163991.88,1331.44,541.17,790.27,163201.61,mortgage,62,4
22,163201.61,1331.44,538.57,792.87,162408.74,mortgage,62,4
23,162408.74,1331.44,535.95,795.49,161613.25,mortgage,62,4
24,161613.25,1331.44,533.32,798.12,160815.13,mortgage,62,4
25,160815.13,1768.47,530.69,1237.78,159577.35,mortgage,62,4
26,159577.35,2677.1,526.61,2150.49,157426.86,mortgage,62,4
27,157426.86,2677.1,519.51,2157.59,155269.27,mortgage,62,4
28,155269.27,2677.1,512.39,2164.71,153104.56,mortgage,62,4
29,153104.56,2677.1,505.25,2171.85,150932.71,mortgage,62,4
30,150932.71,2677.1,498.08,2179.02,148753.69,mortgage,62,4
31,148753.69,2677.1,490.89,2186.21,146567.48,mortgage,62,4
32,146567.48,2677.1,483.67,2193.43,144374.05,mortgage,62,4
33,144374.05,2677.1,476.43,2200.67,142173.38,mortgage,62,4
34,142173.38,2677.1,469.17,2207.93,139965.45,mortgage,62,4
35,139965.45,2677.1,461.89,2215.21,137750.24,mortgage,62,4
36,137750.24,2677.1,454.58,2222.52,135527.72,mortgage,62,4
37,135527.72,2677.1,447.24,2229.86,133297.86,mortgage,62,4
38,133297.86,2677.1,439.88,2237.22,131060.64,mortgage,62,4
39,131060.64,2677.1,432.5,2244.6,128816.04,mortgage,62,4
40,128816.04,2677.1,425.09,2252.01,126564.03,mortgage,62,4
41,126564.03,2677.1,417.66,2259.44,124304.59,mortgage,62,4
42,124304.59,2677.1,410.21,2266.89,122037.7,mortgage,62,4
43,122037.7,2677.1,402.72,2274.38,119763.32,mortgage,62,4
44,119763.32,2677.1,395.22,2281.88,117481.44,mortgage,62,4
45,117481.44,2677.1,387.69,2289.41,115192.03,mortgage,62,4
46,115192.03,2677.1,380.13,2296.97,112895.06,mortgage,62,4
47,112895.06,2677.1,372.55,2304.55,110590.51,mortgage,62,4
48,110590.51,2677.1,364.95,2312.15,108278.36,mortgage,62,4
49,108278.36,2677.1,357.32,2319.78,105958.58,mortgage,62,4
50,105958.58,2677.1,349.66,2327.44,103631.14,mortgage,62,4
51,103631.14,2677.1,341.98,2335.12,101296.02,mortgage,62,4
52,101296.02,2677.1,334.28,2342.82,98953.2,mortgage,62,4
53,98953.2,2677.1,326.55,2350.55,96602.65,mortgage,62,4
54,96602.65,2677.1,318.79,2358.31,94244.34,mortgage,62,4
55,94244.34,2677.1,311.01,2366.09,91878.25,mortgage,62,4
56,91878.25,2677.1,303.2,2373.9,89504.35,mortgage,62,4
57,89504.35,2677.1,295.36,2381.74,87122.61,mortgage,62,4
58,87122.61,2677.1,287.5,2389.6,84733.01,mortgage,62,4
59,84733.01,2677.1,279.62,2397.48,82335.53,mortgage,62,4
60,82335.53,2677.1,271.71,2405.39,79930.14,mortgage,62,4
61,79930.14,2677.1,263.77,2413.33,77516.81,mortgage,62,4
62,77516.81,2677.1,255.81,2421.29,75095.52,mortgage,62,4
63,75095.52,2677.1,247.82,2429.28,72666.24,mortgage,62,4
64,72666.24,2677.1,239.8,2437.3,70228.94,mortgage,62,4
65,70228.94,2677.1,231.76,2445.34,67783.6,mortgage,62,4
66,67783.6,2677.1,223.69,2453.41,65330.19,mortgage,62,4
67,65330.19,2677.1,215.59,2461.51,62868.68,mortgage,62,4
68,62868.68,2677.1,207.47,2469.63,60399.05,mortgage,62,4
69,60399.05,2677.1,199.32,2477.78,57921.27,mortgage,62,4
70,57921.27,2677.1,191.14,2485.96,55435.31,mortgage,62,4
71,55435.31,2677.1,182.94,2494.16,52941.15,mortgage,62,4
72,52941.15,2677.1,174.71,2502.39,50438.76,mortgage,62,4
73,50438.76,2677.1,166.45,2510.65,47928.11,mortgage,62,4
74,47928.11,2677.1,158.16,2518.94,45409.17,mortgage,62,4
75,45409.17,2677.1,149.85,2527.25,42881.92,mortgage,62,4
76,42881.92,2677.1,141.51,2535.59,40346.33,mortgage,62,4
77,40346.33,2677.1,133.14,2543.96,37802.37,mortgage,62,4
78,37802.37,2677.1,124.75,2552.35,35250.02,mortgage,62,4
79,35250.02,2677.1,116.33,2560.77,32689.25,mortgage,62,4
80,32689.25,2677.1,107.87,2569.23,30120.02,mortgage,62,4
81,30120.02,2677.1,99.4,2577.7,27542.32,mortgage,62,4
82,27542.32,2677.1,90.89,2586.21,24956.11,mortgage,62,4
83,24956.11,2677.1,82.36,2594.74,22361.37,mortgage,62,4
84,22361.37,2677.1,73.79,2603.31,19758.06,mortgage,62,4
85,19758.06,2677.1,65.2,2611.9,17146.16,mortgage,62,4
86,17146.16,2677.1,56.58,2620.52,14525.64,mortgage,62,4
87,14525.64,2677.1,47.93,2629.17,11896.47,mortgage,62,4
88,11896.47,2677.1,39.26,2637.84,9258.63,mortgage,62,4
89,9258.63,2677.1,30.55,2646.55,6612.08,mortgage,62,4
90,6612.08,2677.1,21.82,2655.28,3956.8,mortgage,62,4
91,3956.8,2677.1,13.06,2664.04,1292.76,mortgage,62,4
92,1292.76,2677.1,4.27,2672.83,-1380.07,mortgage,62,4
0,5000.0,333.0,36.0,297.0,4703.0,Car,62,5
1,4703.0,333.0,33.86,299.14,4403.86,Car,62,5
2,4403.86,333.0,31.71,301.29,4102.57,Car,62,5
3,4102.57,333.0,29.54,303.46,3799.11,Car,62,5
4,3799.11,333.0,27.35,305.65,3493.46,Car,62,5
5,3493.46,333.0,25.15,307.85,3185.61,Car,62,5
6,3185.61,333.0,22.94,310.06,2875.55,Car,62,5
7,2875.55,333.0,20.7,312.3,2563.25,Car,62,5
8,2563.25,333.0,18.46,314.54,2248.71,Car,62,5
9,2248.71,333.0,16.19,316.81,1931.9,Car,62,5
10,1931.9,333.0,13.91,319.09,1612.81,Car,62,5
11,1612.81,333.0,11.61,321.39,1291.42,Car,62,5
12,1291.42,333.0,9.3,323.7,967.72,Car,62,5
13,967.72,333.0,6.97,326.03,641.69,Car,62,5
14,641.69,333.0,4.62,328.38,313.31,Car,62,5
15,313.31,333.0,2.26,330.74,-17.43,Car,62,5
0,8250.57,1084.62,53.63,1030.99,7219.58,WellsFargo1,63,1
1,7219.58,1084.62,46.93,1037.69,6181.89,WellsFargo1,63,1
2,6181.89,1084.62,40.18,1044.44,5137.45,WellsFargo1,63,1
3,5137.45,1084.62,33.39,1051.23,4086.22,WellsFargo1,63,1
4,4086.22,1084.62,26.56,1058.06,3028.16,WellsFargo1,63,1
5,3028.16,1084.62,19.68,1064.94,1963.22,WellsFargo1,63,1
6,1963.22,1084.62,12.76,1071.86,891.36,WellsFargo1,63,1
7,891.36,1084.62,5.79,1078.83,-187.47,WellsFargo1,63,1
0,20000.0,191.04,108.0,83.04,19916.96,WellsFargo2,63,2
1,19916.96,191.04,107.55,83.49,19833.47,WellsFargo2,63,2
2,19833.47,191.04,107.1,83.94,19749.53,WellsFargo2,63,2
3,19749.53,191.04,106.65,84.39,19665.14,WellsFargo2,63,2
4,19665.14,191.04,106.19,84.85,19580.29,WellsFargo2,63,2
5,19580.29,191.04,105.73,85.31,19494.98,WellsFargo2,63,2
6,19494.98,191.04,105.27,85.77,19409.21,WellsFargo2,63,2
7,19409.21,378.51,104.81,273.7,19135.51,WellsFargo2,63,2
8,19135.51,1275.66,103.33,1172.33,17963.18,WellsFargo2,63,2
9,17963.18,1275.66,97.0,1178.66,16784.52,WellsFargo2,63,2
10,16784.52,1275.66,90.64,1185.02,15599.5,WellsFargo2,63,2
11,15599.5,1275.66,84.24,1191.42,14408.08,WellsFargo2,63,2
12,14408.08,1275.66,77.8,1197.86,13210.22,WellsFargo2,63,2
13,13210.22,1275.66,71.34,1204.32,12005.9,WellsFargo2,63,2
14,12005.9,1275.66,64.83,1210.83,10795.07,WellsFargo2,63,2
15,10795.07,1275.66,58.29,1217.37,9577.7,WellsFargo2,63,2
16,9577.7,1275.66,51.72,1223.94,8353.76,WellsFargo2,63,2
17,8353.76,1275.66,45.11,1230.55,7123.21,WellsFargo2,63,2
18,7123.21,1275.66,38.47,1237.19,5886.02,WellsFargo2,63,2
19,5886.02,1275.66,31.78,1243.88,4642.14,WellsFargo2,63,2
20,4642.14,1275.66,25.07,1250.59,3391.55,WellsFargo2,63,2
21,3391.55,1275.66,18.31,1257.35,2134.2,WellsFargo2,63,2
22,2134.2,1275.66,11.52,1264.14,870.06,WellsFargo2,63,2
23,870.06,1275.66,4.7,1270.96,-400.9,WellsFargo2,63,2
0,5000.0,333.0,36.0,297.0,4703.0,Car,63,3
1,4703.0,333.0,33.86,299.14,4403.86,Car,63,3
2,4403.86,333.0,31.71,301.29,4102.57,Car,63,3
3,4102.57,333.0,29.54,303.46,3799.11,Car,63,3
4,3799.11,333.0,27.35,305.65,3493.46,Car,63,3
5,3493.46,333.0,25.15,307.85,3185.61,Car,63,3
6,3185.61,333.0,22.94,310.06,2875.55,Car,63,3
7,2875.55,333.0,20.7,312.3,2563.25,Car,63,3
8,2563.25,333.0,18.46,314.54,2248.71,Car,63,3
9,2248.71,333.0,16.19,316.81,1931.9,Car,63,3
10,1931.9,333.0,13.91,319.09,1612.81,Car,63,3
11,1612.81,333.0,11.61,321.39,1291.42,Car,63,3
12,1291.42,333.0,9.3,323.7,967.72,Car,63,3
13,967.72,333.0,6.97,326.03,641.69,Car,63,3
14,641.69,333.0,4.62,328.38,313.31,Car,63,3
15,313.31,333.0,2.26,330.74,-17.43,Car,63,3
0,4000.0,70.0,16.0,54.0,3946.0,testing,63,4
1,3946.0,70.0,15.78,54.22,3891.78,testing,63,4
2,3891.78,70.0,15.57,54.43,3837.35,testing,63,4
3,3837.35,70.0,15.35,54.65,3782.7,testing,63,4
4,3782.7,70.0,15.13,54.87,3727.83,testing,63,4
5,3727.83,70.0,14.91,55.09,3672.74,testing,63,4
6,3672.74,70.0,14.69,55.31,3617.43,testing,63,4
7,3617.43,70.0,14.47,55.53,3561.9,testing,63,4
8,3561.9,70.0,14.25,55.75,3506.15,testing,63,4
9,3506.15,70.0,14.02,55.98,3450.17,testing,63,4
10,3450.17,70.0,13.8,56.2,3393.97,testing,63,4
11,3393.97,70.0,13.58,56.42,3337.55,testing,63,4
12,3337.55,70.0,13.35,56.65,3280.9,testing,63,4
13,3280.9,70.0,13.12,56.88,3224.02,testing,63,4
14,3224.02,70.0,12.9,57.1,3166.92,testing,63,4
15,3166.92,87.43,12.67,74.76,3092.16,testing,63,4
16,3092.16,1678.66,12.37,1666.29,1425.87,testing,63,4
17,1425.87,1678.66,5.7,1672.96,-247.09,testing,63,4
0,180000.0,1331.44,594.0,737.44,179262.56,mortgage,63,5
1,179262.56,1331.44,591.57,739.87,178522.69,mortgage,63,5
2,178522.69,1331.44,589.12,742.32,177780.37,mortgage,63,5
3,177780.37,1331.44,586.68,744.76,177035.61,mortgage,63,5
4,177035.61,1331.44,584.22,747.22,176288.39,mortgage,63,5
5,176288.39,1331.44,581.75,749.69,175538.7,mortgage,63,5
6,175538.7,1331.44,579.28,752.16,174786.54,mortgage,63,5
7,174786.54,1331.44,576.8,754.64,174031.9,mortgage,63,5
8,174031.9,1331.44,574.31,757.13,173274.77,mortgage,63,5
9,173274.77,1331.44,571.81,759.63,172515.14,mortgage,63,5
10,172515.14,1331.44,569.3,762.14,171753.0,mortgage,63,5
11,171753.0,1331.44,566.78,764.66,170988.34,mortgage,63,5
12,170988.34,1331.44,564.26,767.18,170221.16,mortgage,63,5
13,170221.16,1331.44,561.73,769.71,169451.45,mortgage,63,5
14,169451.45,1331.44,559.19,772.25,168679.2,mortgage,63,5
15,168679.2,1331.44,556.64,774.8,167904.4,mortgage,63,5
16,167904.4,1331.44,554.08,777.36,167127.04,mortgage,63,5
17,167127.04,1578.53,551.52,1027.01,166100.03,mortgage,63,5
18,166100.03,3010.1,548.13,2461.97,163638.06,mortgage,63,5
19,163638.06,3010.1,540.01,2470.09,161167.97,mortgage,63,5
20,161167.97,3010.1,531.85,2478.25,158689.72,mortgage,63,5
21,158689.72,3010.1,523.68,2486.42,156203.3,mortgage,63,5
22,156203.3,3010.1,515.47,2494.63,153708.67,mortgage,63,5
23,153708.67,3010.1,507.24,2502.86,151205.81,mortgage,63,5
24,151205.81,3010.1,498.98,2511.12,148694.69,mortgage,63,5
25,148694.69,3010.1,490.69,2519.41,146175.28,mortgage,63,5
26,146175.28,3010.1,482.38,2527.72,143647.56,mortgage,63,5
27,143647.56,3010.1,474.04,2536.06,141111.5,mortgage,63,5
28,141111.5,3010.1,465.67,2544.43,138567.07,mortgage,63,5
29,138567.07,3010.1,457.27,2552.83,136014.24,mortgage,63,5
30,136014.24,3010.1,448.85,2561.25,133452.99,mortgage,63,5
31,133452.99,3010.1,440.39,2569.71,130883.28,mortgage,63,5
32,130883.28,3010.1,431.91,2578.19,128305.09,mortgage,63,5
33,128305.09,3010.1,423.41,2586.69,125718.4,mortgage,63,5
34,125718.4,3010.1,414.87,2595.23,123123.17,mortgage,63,5
35,123123.17,3010.1,406.31,2603.79,120519.38,mortgage,63,5
36,120519.38,3010.1,397.71,2612.39,117906.99,mortgage,63,5
37,117906.99,3010.1,389.09,2621.01,115285.98,mortgage,63,5
38,115285.98,3010.1,380.44,2629.66,112656.32,mortgage,63,5
39,112656.32,3010.1,371.77,2638.33,110017.99,mortgage,63,5
40,110017.99,3010.1,363.06,2647.04,107370.95,mortgage,63,5
41,107370.95,3010.1,354.32,2655.78,104715.17,mortgage,63,5
42,104715.17,3010.1,345.56,2664.54,102050.63,mortgage,63,5
43,102050.63,3010.1,336.77,2673.33,99377.3,mortgage,63,5
44,99377.3,3010.1,327.95,2682.15,96695.15,mortgage,63,5
45,96695.15,3010.1,319.09,2691.01,94004.14,mortgage,63,5
46,94004.14,3010.1,310.21,2699.89,91304.25,mortgage,63,5
47,91304.25,3010.1,301.3,2708.8,88595.45,mortgage,63,5
48,88595.45,3010.1,292.36,2717.74,85877.71,mortgage,63,5
49,85877.71,3010.1,283.4,2726.7,83151.01,mortgage,63,5
50,83151.01,3010.1,274.4,2735.7,80415.31,mortgage,63,5
51,80415.31,3010.1,265.37,2744.73,77670.58,mortgage,63,5
52,77670.58,3010.1,256.31,2753.79,74916.79,mortgage,63,5
53,74916.79,3010.1,247.23,2762.87,72153.92,mortgage,63,5
54,72153.92,3010.1,238.11,2771.99,69381.93,mortgage,63,5
55,69381.93,3010.1,228.96,2781.14,66600.79,mortgage,63,5
56,66600.79,3010.1,219.78,2790.32,63810.47,mortgage,63,5
57,63810.47,3010.1,210.57,2799.53,61010.94,mortgage,63,5
58,61010.94,3010.1,201.34,2808.76,58202.18,mortgage,63,5
59,58202.18,3010.1,192.07,2818.03,55384.15,mortgage,63,5
60,55384.15,3010.1,182.77,2827.33,52556.82,mortgage,63,5
61,52556.82,3010.1,173.44,2836.66,49720.16,mortgage,63,5
62,49720.16,3010.1,164.08,2846.02,46874.14,mortgage,63,5
63,46874.14,3010.1,154.68,2855.42,44018.72,mortgage,63,5
64,44018.72,3010.1,145.26,2864.84,41153.88,mortgage,63,5
65,41153.88,3010.1,135.81,2874.29,38279.59,mortgage,63,5
66,38279.59,3010.1,126.32,2883.78,35395.81,mortgage,63,5
67,35395.81,3010.1,116.81,2893.29,32502.52,mortgage,63,5
68,32502.52,3010.1,107.26,2902.84,29599.68,mortgage,63,5
69,29599.68,3010.1,97.68,2912.42,26687.26,mortgage,63,5
70,26687.26,3010.1,88.07,2922.03,23765.23,mortgage,63,5
71,23765.23,3010.1,78.43,2931.67,20833.56,mortgage,63,5
72,20833.56,3010.1,68.75,2941.35,17892.21,mortgage,63,5
73,17892.21,3010.1,59.04,2951.06,14941.15,mortgage,63,5
74,14941.15,3010.1,49.31,2960.79,11980.36,mortgage,63,5
75,11980.36,3010.1,39.54,2970.56,9009.8,mortgage,63,5
76,9009.8,3010.1,29.73,2980.37,6029.43,mortgage,63,5
77,6029.43,3010.1,19.9,2990.2,3039.23,mortgage,63,5
78,3039.23,3010.1,10.03,3000.07,39.16,mortgage,63,5
79,39.16,3010.1,0.13,3009.97,-2970.81,mortgage,63,5
0,8250.57,1084.62,53.63,1030.99,7219.58,WellsFargo1,64,1
1,7219.58,1084.62,46.93,1037.69,6181.89,WellsFargo1,64,1
2,6181.89,1084.62,40.18,1044.44,5137.45,WellsFargo1,64,1
3,5137.45,1084.62,33.39,1051.23,4086.22,WellsFargo1,64,1
4,4086.22,1084.62,26.56,1058.06,3028.16,WellsFargo1,64,1
5,3028.16,1084.62,19.68,1064.94,1963.22,WellsFargo1,64,1
6,1963.22,1084.62,12.76,1071.86,891.36,WellsFargo1,64,1
7,891.36,1084.62,5.79,1078.83,-187.47,WellsFargo1,64,1
0,20000.0,191.04,108.0,83.04,19916.96,WellsFargo2,64,2
1,19916.96,191.04,107.55,83.49,19833.47,WellsFargo2,64,2
2,19833.47,191.04,107.1,83.94,19749.53,WellsFargo2,64,2
3,19749.53,191.04,106.65,84.39,19665.14,WellsFargo2,64,2
4,19665.14,191.04,106.19,84.85,19580.29,WellsFargo2,64,2
5,19580.29,191.04,105.73,85.31,19494.98,WellsFargo2,64,2
6,19494.98,191.04,105.27,85.77,19409.21,WellsFargo2,64,2
7,19409.21,378.51,104.81,273.7,19135.51,WellsFargo2,64,2
8,19135.51,1275.66,103.33,1172.33,17963.18,WellsFargo2,64,2
9,17963.18,1275.66,97.0,1178.66,16784.52,WellsFargo2,64,2
10,16784.52,1275.66,90.64,1185.02,15599.5,WellsFargo2,64,2
11,15599.5,1275.66,84.24,1191.42,14408.08,WellsFargo2,64,2
12,14408.08,1275.66,77.8,1197.86,13210.22,WellsFargo2,64,2
13,13210.22,1275.66,71.34,1204.32,12005.9,WellsFargo2,64,2
14,12005.9,1275.66,64.83,1210.83,10795.07,WellsFargo2,64,2
15,10795.07,1275.66,58.29,1217.37,9577.7,WellsFargo2,64,2
16,9577.7,1275.66,51.72,1223.94,8353.76,WellsFargo2,64,2
17,8353.76,1275.66,45.11,1230.55,7123.21,WellsFargo2,64,2
18,7123.21,1275.66,38.47,1237.19,5886.02,WellsFargo2,64,2
19,5886.02,1275.66,31.78,1243.88,4642.14,WellsFargo2,64,2
20,4642.14,1275.66,25.07,1250.59,3391.55,WellsFargo2,64,2
21,3391.55,1275.66,18.31,1257.35,2134.2,WellsFargo2,64,2
22,2134.2,1275.66,11.52,1264.14,870.06,WellsFargo2,64,2
23,870.06,1275.66,4.7,1270.96,-400.9,WellsFargo2,64,2
0,5000.0,333.0,36.0,297.0,4703.0,Car,64,3
1,4703.0,333.0,33.86,299.14,4403.86,Car,64,3
2,4403.86,333.0,31.71,301.29,4102.57,Car,64,3
3,4102.57,333.0,29.54,303.46,3799.11,Car,64,3
4,3799.11,333.0,27.35,305.65,3493.46,Car,64,3
5,3493.46,333.0,25.15,307.85,3185.61,Car,64,3
6,3185.61,333.0,22.94,310.06,2875.55,Car,64,3
7,2875.55,333.0,20.7,312.3,2563.25,Car,64,3
8,2563.25,333.0,18.46,314.54,2248.71,Car,64,3
9,2248.71,333.0,16.19,316.81,1931.9,Car,64,3
10,1931.9,333.0,13.91,319.09,1612.81,Car,64,3
11,1612.81,333.0,11.61,321.39,1291.42,Car,64,3
12,1291.42,333.0,9.3,323.7,967.72,Car,64,3
13,967.72,333.0,6.97,326.03,641.69,Car,64,3
14,641.69,333.0,4.62,328.38,313.31,Car,64,3
15,313.31,333.0,2.26,330.74,-17.43,Car,64,3
0,180000.0,1331.44,594.0,737.44,179262.56,mortgage,64,4
1,179262.56,1331.44,591.57,739.87,178522.69,mortgage,64,4
2,178522.69,1331.44,589.12,742.32,177780.37,mortgage,64,4
3,177780.37,1331.44,586.68,744.76,177035.61,mortgage,64,4
4,177035.61,1331.44,584.22,747.22,176288.39,mortgage,64,4
5,176288.39,1331.44,581.75,749.69,175538.7,mortgage,64,4
6,175538.7,1331.44,579.28,752.16,174786.54,mortgage,64,4
7,174786.54,1331.44,576.8,754.64,174031.9,mortgage,64,4
8,174031.9,1331.44,574.31,757.13,173274.77,mortgage,64,4
9,173274.77,1331.44,571.81,759.63,172515.14,mortgage,64,4
10,172515.14,1331.44,569.3,762.14,171753.0,mortgage,64,4
11,171753.0,1331.44,566.78,764.66,170988.34,mortgage,64,4
12,170988.34,1331.44,564.26,767.18,170221.16,mortgage,64,4
13,170221.16,1331.44,561.73,769.71,169451.45,mortgage,64,4
14,169451.45,1331.44,559.19,772.25,168679.2,mortgage,64,4
15,168679.2,1348.87,556.64,792.23,167886.97,mortgage,64,4
16,167886.97,2940.1,554.03,2386.07,165500.9,mortgage,64,4
17,165500.9,2940.1,546.15,2393.95,163106.95,mortgage,64,4
18,163106.95,2940.1,538.25,2401.85,160705.1,mortgage,64,4
19,160705.1,2940.1,530.33,2409.77,158295.33,mortgage,64,4
20,158295.33,2940.1,522.37,2417.73,155877.6,mortgage,64,4
21,155877.6,2940.1,514.4,2425.7,153451.9,mortgage,64,4
22,153451.9,2940.1,506.39,2433.71,151018.19,mortgage,64,4
23,151018.19,2940.1,498.36,2441.74,148576.45,mortgage,64,4
24,148576.45,2940.1,490.3,2449.8,146126.65,mortgage,64,4
25,146126.65,2940.1,482.22,2457.88,143668.77,mortgage,64,4
26,143668.77,2940.1,474.11,2465.99,141202.78,mortgage,64,4
27,141202.78,2940.1,465.97,2474.13,138728.65,mortgage,64,4
28,138728.65,2940.1,457.8,2482.3,136246.35,mortgage,64,4
29,136246.35,2940.1,449.61,2490.49,133755.86,mortgage,64,4
30,133755.86,2940.1,441.39,2498.71,131257.15,mortgage,64,4
31,131257.15,2940.1,433.15,2506.95,128750.2,mortgage,64,4
32,128750.2,2940.1,424.88,2515.22,126234.98,mortgage,64,4
33,126234.98,2940.1,416.58,2523.52,123711.46,mortgage,64,4
34,123711.46,2940.1,408.25,2531.85,121179.61,mortgage,64,4
35,121179.61,2940.1,399.89,2540.21,118639.4,mortgage,64,4
36,118639.4,2940.1,391.51,2548.59,116090.81,mortgage,64,4
37,116090.81,2940.1,383.1,2557.0,113533.81,mortgage,64,4
38,113533.81,2940.1,374.66,2565.44,110968.37,mortgage,64,4
39,110968.37,2940.1,366.2,2573.9,108394.47,mortgage,64,4
40,108394.47,2940.1,357.7,2582.4,105812.07,mortgage,64,4
41,105812.07,2940.1,349.18,2590.92,103221.15,mortgage,64,4
42,103221.15,2940.1,340.63,2599.47,100621.68,mortgage,64,4
43,100621.68,2940.1,332.05,2608.05,98013.63,mortgage,64,4
44,98013.63,2940.1,323.44,2616.66,95396.97,mortgage,64,4
45,95396.97,2940.1,314.81,2625.29,92771.68,mortgage,64,4
46,92771.68,2940.1,306.15,2633.95,90137.73,mortgage,64,4
47,90137.73,2940.1,297.45,2642.65,87495.08,mortgage,64,4
48,87495.08,2940.1,288.73,2651.37,84843.71,mortgage,64,4
49,84843.71,2940.1,279.98,2660.12,82183.59,mortgage,64,4
50,82183.59,2940.1,271.21,2668.89,79514.7,mortgage,64,4
51,79514.7,2940.1,262.4,2677.7,76837.0,mortgage,64,4
52,76837.0,2940.1,253.56,2686.54,74150.46,mortgage,64,4
53,74150.46,2940.1,244.7,2695.4,71455.06,mortgage,64,4
54,71455.06,2940.1,235.8,2704.3,68750.76,mortgage,64,4
55,68750.76,2940.1,226.88,2713.22,66037.54,mortgage,64,4
56,66037.54,2940.1,217.92,2722.18,63315.36,mortgage,64,4
57,63315.36,2940.1,208.94,2731.16,60584.2,mortgage,64,4
58,60584.2,2940.1,199.93,2740.17,57844.03,mortgage,64,4
59,57844.03,2940.1,190.89,2749.21,55094.82,mortgage,64,4
60,55094.82,2940.1,181.81,2758.29,52336.53,mortgage,64,4
61,52336.53,2940.1,172.71,2767.39,49569.14,mortgage,64,4
62,49569.14,2940.1,163.58,2776.52,46792.62,mortgage,64,4
63,46792.62,2940.1,154.42,2785.68,44006.94,mortgage,64,4
64,44006.94,2940.1,145.22,2794.88,41212.06,mortgage,64,4
65,41212.06,2940.1,136.0,2804.1,38407.96,mortgage,64,4
66,38407.96,2940.1,126.75,2813.35,35594.61,mortgage,64,4
67,35594.61,2940.1,117.46,2822.64,32771.97,mortgage,64,4
68,32771.97,2940.1,108.15,2831.95,29940.02,mortgage,64,4
69,29940.02,2940.1,98.8,2841.3,27098.72,mortgage,64,4
70,27098.72,2940.1,89.43,2850.67,24248.05,mortgage,64,4
71,24248.05,2940.1,80.02,2860.08,21387.97,mortgage,64,4
72,21387.97,2940.1,70.58,2869.52,18518.45,mortgage,64,4
73,18518.45,2940.1,61.11,2878.99,15639.46,mortgage,64,4
74,15639.46,2940.1,51.61,2888.49,12750.97,mortgage,64,4
75,12750.97,2940.1,42.08,2898.02,9852.95,mortgage,64,4
76,9852.95,2940.1,32.51,2907.59,6945.36,mortgage,64,4
77,6945.36,2940.1,22.92,2917.18,4028.18,mortgage,64,4
78,4028.18,2940.1,13.29,2926.81,1101.37,mortgage,64,4
79,1101.37,2940.1,3.63,2936.47,-1835.1,mortgage,64,4
0,4000.0,70.0,16.0,54.0,3946.0,testing,64,5
1,3946.0,70.0,15.78,54.22,3891.78,testing,64,5
2,3891.78,70.0,15.57,54.43,3837.35,testing,64,5
3,3837.35,70.0,15.35,54.65,3782.7,testing,64,5
4,3782.7,70.0,15.13,54.87,3727.83,testing,64,5
5,3727.83,70.0,14.91,55.09,3672.74,testing,64,5
6,3672.74,70.0,14.69,55.31,3617.43,testing,64,5
7,3617.43,70.0,14.47,55.53,3561.9,testing,64,5
8,3561.9,70.0,14.25,55.75,3506.15,testing,64,5
9,3506.15,70.0,14.02,55.98,3450.17,testing,64,5
10,3450.17,70.0,13.8,56.2,3393.97,testing,64,5
11,3393.97,70.0,13.58,56.42,3337.55,testing,64,5
12,3337.55,70.0,13.35,56.65,3280.9,testing,64,5
13,3280.9,70.0,13.12,56.88,3224.02,testing,64,5
14,3224.02,70.0,12.9,57.1,3166.92,testing,64,5
15,3166.92,70.0,12.67,57.33,3109.59,testing,64,5
16,3109.59,70.0,12.44,57.56,3052.03,testing,64,5
17,3052.03,70.0,12.21,57.79,2994.24,testing,64,5
18,2994.24,70.0,11.98,58.02,2936.22,testing,64,5
19,2936.22,70.0,11.74,58.26,2877.96,testing,64,5
20,2877.96,70.0,11.51,58.49,2819.47,testing,64,5
21,2819.47,70.0,11.28,58.72,2760.75,testing,64,5
22,2760.75,70.0,11.04,58.96,2701.79,testing,64,5
23,2701.79,70.0,10.81,59.19,2642.6,testing,64,5
24,2642.6,70.0,10.57,59.43,2583.17,testing,64,5
25,2583.17,70.0,10.33,59.67,2523.5,testing,64,5
26,2523.5,70.0,10.09,59.91,2463.59,testing,64,5
27,2463.59,70.0,9.85,60.15,2403.44,testing,64,5
28,2403.44,70.0,9.61,60.39,2343.05,testing,64,5
29,2343.05,70.0,9.37,60.63,2282.42,testing,64,5
30,2282.42,70.0,9.13,60.87,2221.55,testing,64,5
31,2221.55,70.0,8.89,61.11,2160.44,testing,64,5
32,2160.44,70.0,8.64,61.36,2099.08,testing,64,5
33,2099.08,70.0,8.4,61.6,2037.48,testing,64,5
34,2037.48,70.0,8.15,61.85,1975.63,testing,64,5
35,1975.63,70.0,7.9,62.1,1913.53,testing,64,5
36,1913.53,70.0,7.65,62.35,1851.18,testing,64,5
37,1851.18,70.0,7.4,62.6,1788.58,testing,64,5
38,1788.58,70.0,7.15,62.85,1725.73,testing,64,5
39,1725.73,70.0,6.9,63.1,1662.63,testing,64,5
40,1662.63,70.0,6.65,63.35,1599.28,testing,64,5
41,1599.28,70.0,6.4,63.6,1535.68,testing,64,5
42,1535.68,70.0,6.14,63.86,1471.82,testing,64,5
43,1471.82,70.0,5.89,64.11,1407.71,testing,64,5
44,1407.71,70.0,5.63,64.37,1343.34,testing,64,5
45,1343.34,70.0,5.37,64.63,1278.71,testing,64,5
46,1278.71,70.0,5.11,64.89,1213.82,testing,64,5
47,1213.82,70.0,4.86,65.14,1148.68,testing,64,5
48,1148.68,70.0,4.59,65.41,1083.27,testing,64,5
49,1083.27,70.0,4.33,65.67,1017.6,testing,64,5
50,1017.6,70.0,4.07,65.93,951.67,testing,64,5
51,951.67,70.0,3.81,66.19,885.48,testing,64,5
52,885.48,70.0,3.54,66.46,819.02,testing,64,5
53,819.02,70.0,3.28,66.72,752.3,testing,64,5
54,752.3,70.0,3.01,66.99,685.31,testing,64,5
55,685.31,70.0,2.74,67.26,618.05,testing,64,5
56,618.05,70.0,2.47,67.53,550.52,testing,64,5
57,550.52,70.0,2.2,67.8,482.72,testing,64,5
58,482.72,70.0,1.93,68.07,414.65,testing,64,5
59,414.65,70.0,1.66,68.34,346.31,testing,64,5
60,346.31,70.0,1.39,68.61,277.7,testing,64,5
61,277.7,70.0,1.11,68.89,208.81,testing,64,5
62,208.81,70.0,0.84,69.16,139.65,testing,64,5
63,139.65,70.0,0.56,69.44,70.21,testing,64,5
64,70.21,70.0,0.28,69.72,0.49,testing,64,5
65,0.49,70.0,0.0,70.0,-69.51,testing,64,5
0,8250.57,1084.62,53.63,1030.99,7219.58,WellsFargo1,65,1
1,7219.58,1084.62,46.93,1037.69,6181.89,WellsFargo1,65,1
2,6181.89,1084.62,40.18,1044.44,5137.45,WellsFargo1,65,1
3,5137.45,1084.62,33.39,1051.23,4086.22,WellsFargo1,65,1
4,4086.22,1084.62,26.56,1058.06,3028.16,WellsFargo1,65,1
5,3028.16,1084.62,19.68,1064.94,1963.22,WellsFargo1,65,1
6,1963.22,1084.62,12.76,1071.86,891.36,WellsFargo1,65,1
7,891.36,1084.62,5.79,1078.83,-187.47,WellsFargo1,65,1
0,20000.0,191.04,108.0,83.04,19916.96,WellsFargo2,65,2
1,19916.96,191.04,107.55,83.49,19833.47,WellsFargo2,65,2
2,19833.47,191.04,107.1,83.94,19749.53,WellsFargo2,65,2
3,19749.53,191.04,106.65,84.39,19665.14,WellsFargo2,65,2
4,19665.14,191.04,106.19,84.85,19580.29,WellsFargo2,65,2
5,19580.29,191.04,105.73,85.31,19494.98,WellsFargo2,65,2
6,19494.98,191.04,105.27,85.77,19409.21,WellsFargo2,65,2
7,19409.21,378.51,104.81,273.7,19135.51,WellsFargo2,65,2
8,19135.51,1275.66,103.33,1172.33,17963.18,WellsFargo2,65,2
9,17963.18,1275.66,97.0,1178.66,16784.52,WellsFargo2,65,2
10,16784.52,1275.66,90.64,1185.02,15599.5,WellsFargo2,65,2
11,15599.5,1275.66,84.24,1191.42,14408.08,WellsFargo2,65,2
12,14408.08,1275.66,77.8,1197.86,13210.22,WellsFargo2,65,2
13,13210.22,1275.66,71.34,1204.32,12005.9,WellsFargo2,65,2
14,12005.9,1275.66,64.83,1210.83,10795.07,WellsFargo2,65,2
15,10795.07,1275.66,58.29,1217.37,9577.7,WellsFargo2,65,2
16,9577.7,1275.66,51.72,1223.94,8353.76,WellsFargo2,65,2
17,8353.76,1275.66,45.11,1230.55,7123.21,WellsFargo2,65,2
18,7123.21,1275.66,38.47,1237.19,5886.02,WellsFargo2,65,2
19,5886.02,1275.66,31.78,1243.88,4642.14,WellsFargo2,65,2
20,4642.14,1275.66,25.07,1250.59,3391.55,WellsFargo2,65,2
21,3391.55,1275.66,18.31,1257.35,2134.2,WellsFargo2,65,2
22,2134.2,1275.66,11.52,1264.14,870.06,WellsFargo2,65,2
23,870.06,1275.66,4.7,1270.96,-400.9,WellsFargo2,65,2
0,180000.0,1331.44,594.0,737.44,179262.56,mortgage,65,3
1,179262.56,1331.44,591.57,739.87,178522.69,mortgage,65,3
2,178522.69,1331.44,589.12,742.32,177780.37,mortgage,65,3
3,177780.37,1331.44,586.68,744.76,177035.61,mortgage,65,3
4,177035.61,1331.44,584.22,747.22,176288.39,mortgage,65,3
5,176288.39,1331.44,581.75,749.69,175538.7,mortgage,65,3
6,175538.7,1331.44,579.28,752.16,174786.54,mortgage,65,3
7,174786.54,1331.44,576.8,754.64,174031.9,mortgage,65,3
8,174031.9,1331.44,574.31,757.13,173274.77,mortgage,65,3
9,173274.77,1331.44,571.81,759.63,172515.14,mortgage,65,3
10,172515.14,1331.44,569.3,762.14,171753.0,mortgage,65,3
11,171753.0,1331.44,566.78,764.66,170988.34,mortgage,65,3
12,170988.34,1331.44,564.26,767.18,170221.16,mortgage,65,3
13,170221.16,1331.44,561.73,769.71,169451.45,mortgage,65,3
14,169451.45,1331.44,559.19,772.25,168679.2,mortgage,65,3
15,168679.2,1331.44,556.64,774.8,167904.4,mortgage,65,3
16,167904.4,1331.44,554.08,777.36,167127.04,mortgage,65,3
17,167127.04,1331.44,551.52,779.92,166347.12,mortgage,65,3
18,166347.12,1331.44,548.95,782.49,165564.63,mortgage,65,3
19,165564.63,1331.44,546.36,785.08,164779.55,mortgage,65,3
20,164779.55,1331.44,543.77,787.67,163991.88,mortgage,65,3
21,163991.88,1331.44,541.17,790.27,163201.61,mortgage,65,3
22,163201.61,1331.44,538.57,792.87,162408.74,mortgage,65,3
23,162408.74,1732.34,535.95,1196.39,161212.35,mortgage,65,3
24,161212.35,2607.1,532.0,2075.1,159137.25,mortgage,65,3
25,159137.25,2607.1,525.15,2081.95,157055.3,mortgage,65,3
26,157055.3,2607.1,518.28,2088.82,154966.48,mortgage,65,3
27,154966.48,2607.1,511.39,2095.71,152870.77,mortgage,65,3
28,152870.77,2607.1,504.47,2102.63,150768.14,mortgage,65,3
29,150768.14,2607.1,497.53,2109.57,148658.57,mortgage,65,3
30,148658.57,2607.1,490.57,2116.53,146542.04,mortgage,65,3
31,146542.04,2607.1,483.59,2123.51,144418.53,mortgage,65,3
32,144418.53,2607.1,476.58,2130.52,142288.01,mortgage,65,3
33,142288.01,2607.1,469.55,2137.55,140150.46,mortgage,65,3
34,140150.46,2607.1,462.5,2144.6,138005.86,mortgage,65,3
35,138005.86,2607.1,455.42,2151.68,135854.18,mortgage,65,3
36,135854.18,2607.1,448.32,2158.78,133695.4,mortgage,65,3
37,133695.4,2607.1,441.19,2165.91,131529.49,mortgage,65,3
38,131529.49,2607.1,434.05,2173.05,129356.44,mortgage,65,3
39,129356.44,2607.1,426.88,2180.22,127176.22,mortgage,65,3
40,127176.22,2607.1,419.68,2187.42,124988.8,mortgage,65,3
41,124988.8,2607.1,412.46,2194.64,122794.16,mortgage,65,3
42,122794.16,2607.1,405.22,2201.88,120592.28,mortgage,65,3
43,120592.28,2607.1,397.95,2209.15,118383.13,mortgage,65,3
44,118383.13,2607.1,390.66,2216.44,116166.69,mortgage,65,3
45,116166.69,2607.1,383.35,2223.75,113942.94,mortgage,65,3
46,113942.94,2607.1,376.01,2231.09,111711.85,mortgage,65,3
47,111711.85,2607.1,368.65,2238.45,109473.4,mortgage,65,3
48,109473.4,2607.1,361.26,2245.84,107227.56,mortgage,65,3
49,107227.56,2607.1,353.85,2253.25,104974.31,mortgage,65,3
50,104974.31,2607.1,346.42,2260.68,102713.63,mortgage,65,3
51,102713.63,2607.1,338.95,2268.15,100445.48,mortgage,65,3
52,100445.48,2607.1,331.47,2275.63,98169.85,mortgage,65,3
53,98169.85,2607.1,323.96,2283.14,95886.71,mortgage,65,3
54,95886.71,2607.1,316.43,2290.67,93596.04,mortgage,65,3
55,93596.04,2607.1,308.87,2298.23,91297.81,mortgage,65,3
56,91297.81,2607.1,301.28,2305.82,88991.99,mortgage,65,3
57,88991.99,2607.1,293.67,2313.43,86678.56,mortgage,65,3
58,86678.56,2607.1,286.04,2321.06,84357.5,mortgage,65,3
59,84357.5,2607.1,278.38,2328.72,82028.78,mortgage,65,3
60,82028.78,2607.1,270.69,2336.41,79692.37,mortgage,65,3
61,79692.37,2607.1,262.98,2344.12,77348.25,mortgage,65,3
62,77348.25,2607.1,255.25,2351.85,74996.4,mortgage,65,3
63,74996.4,2607.1,247.49,2359.61,72636.79,mortgage,65,3
64,72636.79,2607.1,239.7,2367.4,70269.39,mortgage,65,3
65,70269.39,2607.1,231.89,2375.21,67894.18,mortgage,65,3
66,67894.18,2607.1,224.05,2383.05,65511.13,mortgage,65,3
67,65511.13,2607.1,216.19,2390.91,63120.22,mortgage,65,3
68,63120.22,2607.1,208.3,2398.8,60721.42,mortgage,65,3
69,60721.42,2607.1,200.38,2406.72,58314.7,mortgage,65,3
70,58314.7,2607.1,192.44,2414.66,55900.04,mortgage,65,3
71,55900.04,2607.1,184.47,2422.63,53477.41,mortgage,65,3
72,53477.41,2607.1,176.48,2430.62,51046.79,mortgage,65,3
73,51046.79,2607.1,168.45,2438.65,48608.14,mortgage,65,3
74,48608.14,2607.1,160.41,2446.69,46161.45,mortgage,65,3
75,46161.45,2607.1,152.33,2454.77,43706.68,mortgage,65,3
76,43706.68,2607.1,144.23,2462.87,41243.81,mortgage,65,3
77,41243.81,2607.1,136.1,2471.0,38772.81,mortgage,65,3
78,38772.81,2607.1,127.95,2479.15,36293.66,mortgage,65,3
79,36293.66,2607.1,119.77,2487.33,33806.33,mortgage,65,3
80,33806.33,2607.1,111.56,2495.54,31310.79,mortgage,65,3
81,31310.79,2607.1,103.33,2503.77,28807.02,mortgage,65,3
82,28807.02,2607.1,95.06,2512.04,26294.98,mortgage,65,3
83,26294.98,2607.1,86.77,2520.33,23774.65,mortgage,65,3
84,23774.65,2607.1,78.46,2528.64,21246.01,mortgage,65,3
85,21246.01,2607.1,70.11,2536.99,18709.02,mortgage,65,3
86,18709.02,2607.1,61.74,2545.36,16163.66,mortgage,65,3
87,16163.66,2607.1,53.34,2553.76,13609.9,mortgage,65,3
88,13609.9,2607.1,44.91,2562.19,11047.71,mortgage,65,3
89,11047.71,2607.1,36.46,2570.64,8477.07,mortgage,65,3
90,8477.07,2607.1,27.97,2579.13,5897.94,mortgage,65,3
91,5897.94,2607.1,19.46,2587.64,3310.3,mortgage,65,3
92,3310.3,2607.1,10.92,2596.18,714.12,mortgage,65,3
93,714.12,2607.1,2.36,2604.74,-1890.62,mortgage,65,3
0,4000.0,70.0,16.0,54.0,3946.0,testing,65,4
1,3946.0,70.0,15.78,54.22,3891.78,testing,65,4
2,3891.78,70.0,15.57,54.43,3837.35,testing,65,4
3,3837.35,70.0,15.35,54.65,3782.7,testing,65,4
4,3782.7,70.0,15.13,54.87,3727.83,testing,65,4
5,3727.83,70.0,14.91,55.09,3672.74,testing,65,4
6,3672.74,70.0,14.69,55.31,3617.43,testing,65,4
7,3617.43,70.0,14.47,55.53,3561.9,testing,65,4
8,3561.9,70.0,14.25,55.75,3506.15,testing,65,4
9,3506.15,70.0,14.02,55.98,3450.17,testing,65,4
10,3450.17,70.0,13.8,56.2,3393.97,testing,65,4
11,3393.97,70.0,13.58,56.42,3337.55,testing,65,4
12,3337.55,70.0,13.35,56.65,3280.9,testing,65,4
13,3280.9,70.0,13.12,56.88,3224.02,testing,65,4
14,3224.02,70.0,12.9,57.1,3166.92,testing,65,4
15,3166.92,70.0,12.67,57.33,3109.59,testing,65,4
16,3109.59,70.0,12.44,57.56,3052.03,testing,65,4
17,3052.03,70.0,12.21,57.79,2994.24,testing,65,4
18,2994.24,70.0,11.98,58.02,2936.22,testing,65,4
19,2936.22,70.0,11.74,58.26,2877.96,testing,65,4
20,2877.96,70.0,11.51,58.49,2819.47,testing,65,4
21,2819.47,70.0,11.28,58.72,2760.75,testing,65,4
22,2760.75,70.0,11.04,58.96,2701.79,testing,65,4
23,2701.79,70.0,10.81,59.19,2642.6,testing,65,4
24,2642.6,70.0,10.57,59.43,2583.17,testing,65,4
25,2583.17,70.0,10.33,59.67,2523.5,testing,65,4
26,2523.5,70.0,10.09,59.91,2463.59,testing,65,4
27,2463.59,70.0,9.85,60.15,2403.44,testing,65,4
28,2403.44,70.0,9.61,60.39,2343.05,testing,65,4
29,2343.05,70.0,9.37,60.63,2282.42,testing,65,4
30,2282.42,70.0,9.13,60.87,2221.55,testing,65,4
31,2221.55,70.0,8.89,61.11,2160.44,testing,65,4
32,2160.44,70.0,8.64,61.36,2099.08,testing,65,4
33,2099.08,70.0,8.4,61.6,2037.48,testing,65,4
34,2037.48,70.0,8.15,61.85,1975.63,testing,65,4
35,1975.63,70.0,7.9,62.1,1913.53,testing,65,4
36,1913.53,70.0,7.65,62.35,1851.18,testing,65,4
37,1851.18,70.0,7.4,62.6,1788.58,testing,65,4
38,1788.58,70.0,7.15,62.85,1725.73,testing,65,4
39,1725.73,70.0,6.9,63.1,1662.63,testing,65,4
40,1662.63,70.0,6.65,63.35,1599.28,testing,65,4
41,1599.28,70.0,6.4,63.6,1535.68,testing,65,4
42,1535.68,70.0,6.14,63.86,1471.82,testing,65,4
43,1471.82,70.0,5.89,64.11,1407.71,testing,65,4
44,1407.71,70.0,5.63,64.37,1343.34,testing,65,4
45,1343.34,70.0,5.37,64.63,1278.71,testing,65,4
46,1278.71,70.0,5.11,64.89,1213.82,testing,65,4
47,1213.82,70.0,4.86,65.14,1148.68,testing,65,4
48,1148.68,70.0,4.59,65.41,1083.27,testing,65,4
49,1083.27,70.0,4.33,65.67,1017.6,testing,65,4
50,1017.6,70.0,4.07,65.93,951.67,testing,65,4
51,951.67,70.0,3.81,66.19,885.48,testing,65,4
52,885.48,70.0,3.54,66.46,819.02,testing,65,4
53,819.02,70.0,3.28,66.72,752.3,testing,65,4
54,752.3,70.0,3.01,66.99,685.31,testing,65,4
55,685.31,70.0,2.74,67.26,618.05,testing,65,4
56,618.05,70.0,2.47,67.53,550.52,testing,65,4
57,550.52,70.0,2.2,67.8,482.72,testing,65,4
58,482.72,70.0,1.93,68.07,414.65,testing,65,4
59,414.65,70.0,1.66,68.34,346.31,testing,65,4
60,346.31,70.0,1.39,68.61,277.7,testing,65,4
61,277.7,70.0,1.11,68.89,208.81,testing,65,4
62,208.81,70.0,0.84,69.16,139.65,testing,65,4
63,139.65,70.0,0.56,69.44,70.21,testing,65,4
64,70.21,70.0,0.28,69.72,0.49,testing,65,4
65,0.49,70.0,0.0,70.0,-69.51,testing,65,4
0,5000.0,333.0,36.0,297.0,4703.0,Car,65,5
1,4703.0,333.0,33.86,299.14,4403.86,Car,65,5
2,4403.86,333.0,31.71,301.29,4102.57,Car,65,5
3,4102.57,333.0,29.54,303.46,3799.11,Car,65,5
4,3799.11,333.0,27.35,305.65,3493.46,Car,65,5
5,3493.46,333.0,25.15,307.85,3185.61,Car,65,5
6,3185.61,333.0,22.94,310.06,2875.55,Car,65,5
7,2875.55,333.0,20.7,312.3,2563.25,Car,65,5
8,2563.25,333.0,18.46,314.54,2248.71,Car,65,5
9,2248.71,333.0,16.19,316.81,1931.9,Car,65,5
10,1931.9,333.0,13.91,319.09,1612.81,Car,65,5
11,1612.81,333.0,11.61,321.39,1291.42,Car,65,5
12,1291.42,333.0,9.3,323.7,967.72,Car,65,5
13,967.72,333.0,6.97,326.03,641.69,Car,65,5
14,641.69,333.0,4.62,328.38,313.31,Car,65,5
15,313.31,333.0,2.26,330.74,-17.43,Car,65,5
0,8250.57,1084.62,53.63,1030.99,7219.58,WellsFargo1,66,1
1,7219.58,1084.62,46.93,1037.69,6181.89,WellsFargo1,66,1
2,6181.89,1084.62,40.18,1044.44,5137.45,WellsFargo1,66,1
3,5137.45,1084.62,33.39,1051.23,4086.22,WellsFargo1,66,1
4,4086.22,1084.62,26.56,1058.06,3028.16,WellsFargo1,66,1
5,3028.16,1084.62,19.68,1064.94,1963.22,WellsFargo1,66,1
6,1963.22,1084.62,12.76,1071.86,891.36,WellsFargo1,66,1
7,891.36,1084.62,5.79,1078.83,-187.47,WellsFargo1,66,1
0,20000.0,191.04,108.0,83.04,19916.96,WellsFargo2,66,2
1,19916.96,191.04,107.55,83.49,19833.47,WellsFargo2,66,2
2,19833.47,191.04,107.1,83.94,19749.53,WellsFargo2,66,2
3,19749.53,191.04,106.65,84.39,19665.14,WellsFargo2,66,2
4,19665.14,191.04,106.19,84.85,19580.29,WellsFargo2,66,2
5,19580.29,191.04,105.73,85.31,19494.98,WellsFargo2,66,2
6,19494.98,191.04,105.27,85.77,19409.21,WellsFargo2,66,2
7,19409.21,378.51,104.81,273.7,19135.51,WellsFargo2,66,2
8,19135.51,1275.66,103.33,1172.33,17963.18,WellsFargo2,66,2
9,17963.18,1275.66,97.0,1178.66,16784.52,WellsFargo2,66,2
10,16784.52,1275.66,90.64,1185.02,15599.5,WellsFargo2,66,2
11,15599.5,1275.66,84.24,1191.42,14408.08,WellsFargo2,66,2
12,14408.08,1275.66,77.8,1197.86,13210.22,WellsFargo2,66,2
13,13210.22,1275.66,71.34,1204.32,12005.9,WellsFargo2,66,2
14,12005.9,1275.66,64.83,1210.83,10795.07,WellsFargo2,66,2
15,10795.07,1275.66,58.29,1217.37,9577.7,WellsFargo2,66,2
16,9577.7,1275.66,51.72,1223.94,8353.76,WellsFargo2,66,2
17,8353.76,1275.66,45.11,1230.55,7123.21,WellsFargo2,66,2
18,7123.21,1275.66,38.47,1237.19,5886.02,WellsFargo2,66,2
19,5886.02,1275.66,31.78,1243.88,4642.14,WellsFargo2,66,2
20,4642.14,1275.66,25.07,1250.59,3391.55,WellsFargo2,66,2
21,3391.55,1275.66,18.31,1257.35,2134.2,WellsFargo2,66,2
22,2134.2,1275.66,11.52,1264.14,870.06,WellsFargo2,66,2
23,870.06,1275.66,4.7,1270.96,-400.9,WellsFargo2,66,2
0,180000.0,1331.44,594.0,737.44,179262.56,mortgage,66,3
1,179262.56,1331.44,591.57,739.87,178522.69,mortgage,66,3
2,178522.69,1331.44,589.12,742.32,177780.37,mortgage,66,3
3,177780.37,1331.44,586.68,744.76,177035.61,mortgage,66,3
4,177035.61,1331.44,584.22,747.22,176288.39,mortgage,66,3
5,176288.39,1331.44,581.75,749.69,175538.7,mortgage,66,3
6,175538.7,1331.44,579.28,752.16,174786.54,mortgage,66,3
7,174786.54,1331.44,576.8,754.64,174031.9,mortgage,66,3
8,174031.9,1331.44,574.31,757.13,173274.77,mortgage,66,3
9,173274.77,1331.44,571.81,759.63,172515.14,mortgage,66,3
10,172515.14,1331.44,569.3,762.14,171753.0,mortgage,66,3
11,171753.0,1331.44,566.78,764.66,170988.34,mortgage,66,3
12,170988.34,1331.44,564.26,767.18,170221.16,mortgage,66,3
13,170221.16,1331.44,561.73,769.71,169451.45,mortgage,66,3
14,169451.45,1331.44,559.19,772.25,168679.2,mortgage,66,3
15,168679.2,1331.44,556.64,774.8,167904.4,mortgage,66,3
16,167904.4,1331.44,554.08,777.36,167127.04,mortgage,66,3
17,167127.04,1331.44,551.52,779.92,166347.12,mortgage,66,3
18,166347.12,1331.44,548.95,782.49,165564.63,mortgage,66,3
19,165564.63,1331.44,546.36,785.08,164779.55,mortgage,66,3
20,164779.55,1331.44,543.77,787.67,163991.88,mortgage,66,3
21,163991.88,1331.44,541.17,790.27,163201.61,mortgage,66,3
22,163201.61,1331.44,538.57,792.87,162408.74,mortgage,66,3
23,162408.74,1732.34,535.95,1196.39,161212.35,mortgage,66,3
24,161212.35,2607.1,532.0,2075.1,159137.25,mortgage,66,3
25,159137.25,2607.1,525.15,2081.95,157055.3,mortgage,66,3
26,157055.3,2607.1,518.28,2088.82,154966.48,mortgage,66,3
27,154966.48,2607.1,511.39,2095.71,152870.77,mortgage,66,3
28,152870.77,2607.1,504.47,2102.63,150768.14,mortgage,66,3
29,150768.14,2607.1,497.53,2109.57,148658.57,mortgage,66,3
30,148658.57,2607.1,490.57,2116.53,146542.04,mortgage,66,3
31,146542.04,2607.1,483.59,2123.51,144418.53,mortgage,66,3
32,144418.53,2607.1,476.58,2130.52,142288.01,mortgage,66,3
33,142288.01,2607.1,469.55,2137.55,140150.46,mortgage,66,3
34,140150.46,2607.1,462.5,2144.6,138005.86,mortgage,66,3
35,138005.86,2607.1,455.42,2151.68,135854.18,mortgage,66,3
36,135854.18,2607.1,448.32,2158.78,133695.4,mortgage,66,3
37,133695.4,2607.1,441.19,2165.91,131529.49,mortgage,66,3
38,131529.49,2607.1,434.05,2173.05,129356.44,mortgage,66,3
39,129356.44,2607.1,426.88,2180.22,127176.22,mortgage,66,3
40,127176.22,2607.1,419.68,2187.42,124988.8,mortgage,66,3
41,124988.8,2607.1,412.46,2194.64,122794.16,mortgage,66,3
42,122794.16,2607.1,405.22,2201.88,120592.28,mortgage,66,3
43,120592.28,2607.1,397.95,2209.15,118383.13,mortgage,66,3
44,118383.13,2607.1,390.66,2216.44,116166.69,mortgage,66,3
45,116166.69,2607.1,383.35,2223.75,113942.94,mortgage,66,3
46,113942.94,2607.1,376.01,2231.09,111711.85,mortgage,66,3
47,111711.85,2607.1,368.65,2238.45,109473.4,mortgage,66,3
48,109473.4,2607.1,361.26,2245.84,107227.56,mortgage,66,3
49,107227.56,2607.1,353.85,2253.25,104974.31,mortgage,66,3
50,104974.31,2607.1,346.42,2260.68,102713.63,mortgage,66,3
51,102713.63,2607.1,338.95,2268.15,100445.48,mortgage,66,3
52,100445.48,2607.1,331.47,2275.63,98169.85,mortgage,66,3
53,98169.85,2607.1,323.96,2283.14,95886.71,mortgage,66,3
54,95886.71,2607.1,316.43,2290.67,93596.04,mortgage,66,3
55,93596.04,2607.1,308.87,2298.23,91297.81,mortgage,66,3
56,91297.81,2607.1,301.28,2305.82,88991.99,mortgage,66,3
57,88991.99,2607.1,293.67,2313.43,86678.56,mortgage,66,3
58,86678.56,2607.1,286.04,2321.06,84357.5,mortgage,66,3
59,84357.5,2607.1,278.38,2328.72,82028.78,mortgage,66,3
60,82028.78,2607.1,270.69,2336.41,79692.37,mortgage,66,3
61,79692.37,2607.1,262.98,2344.12,77348.25,mortgage,66,3
62,77348.25,2607.1,255.25,2351.85,74996.4,mortgage,66,3
63,74996.4,2607.1,247.49,2359.61,72636.79,mortgage,66,3
64,72636.79,2607.1,239.7,2367.4,70269.39,mortgage,66,3
65,70269.39,2607.1,231.89,2375.21,67894.18,mortgage,66,3
66,67894.18,2607.1,224.05,2383.05,65511.13,mortgage,66,3
67,65511.13,2607.1,216.19,2390.91,63120.22,mortgage,66,3
68,63120.22,2607.1,208.3,2398.8,60721.42,mortgage,66,3
69,60721.42,2607.1,200.38,2406.72,58314.7,mortgage,66,3
70,58314.7,2607.1,192.44,2414.66,55900.04,mortgage,66,3
71,55900.04,2607.1,184.47,2422.63,53477.41,mortgage,66,3
72,53477.41,2607.1,176.48,2430.62,51046.79,mortgage,66,3
73,51046.79,2607.1,168.45,2438.65,48608.14,mortgage,66,3
74,48608.14,2607.1,160.41,2446.69,46161.45,mortgage,66,3
75,46161.45,2607.1,152.33,2454.77,43706.68,mortgage,66,3
76,43706.68,2607.1,144.23,2462.87,41243.81,mortgage,66,3
77,41243.81,2607.1,136.1,2471.0,38772.81,mortgage,66,3
78,38772.81,2607.1,127.95,2479.15,36293.66,mortgage,66,3
79,36293.66,2607.1,119.77,2487.33,33806.33,mortgage,66,3
80,33806.33,2607.1,111.56,2495.54,31310.79,mortgage,66,3
81,31310.79,2607.1,103.33,2503.77,28807.02,mortgage,66,3
82,28807.02,2607.1,95.06,2512.04,26294.98,mortgage,66,3
83,26294.98,2607.1,86.77,2520.33,23774.65,mortgage,66,3
84,23774.65,2607.1,78.46,2528.64,21246.01,mortgage,66,3
85,21246.01,2607.1,70.11,2536.99,18709.02,mortgage,66,3
86,18709.02,2607.1,61.74,2545.36,16163.66,mortgage,66,3
87,16163.66,2607.1,53.34,2553.76,13609.9,mortgage,66,3
88,13609.9,2607.1,44.91,2562.19,11047.71,mortgage,66,3
89,11047.71,2607.1,36.46,2570.64,8477.07,mortgage,66,3
90,8477.07,2607.1,27.97,2579.13,5897.94,mortgage,66,3
91,5897.94,2607.1,19.46,2587.64,3310.3,mortgage,66,3
92,3310.3,2607.1,10.92,2596.18,714.12,mortgage,66,3
93,714.12,2607.1,2.36,2604.74,-1890.62,mortgage,66,3
0,5000.0,333.0,36.0,297.0,4703.0,Car,66,4
1,4703.0,333.0,33.86,299.14,4403.86,Car,66,4
2,4403.86,333.0,31.71,301.29,4102.57,Car,66,4
3,4102.57,333.0,29.54,303.46,3799.11,Car,66,4
4,3799.11,333.0,27.35,305.65,3493.46,Car,66,4
5,3493.46,333.0,25.15,307.85,3185.61,Car,66,4
6,3185.61,333.0,22.94,310.06,2875.55,Car,66,4
7,2875.55,333.0,20.7,312.3,2563.25,Car,66,4
8,2563.25,333.0,18.46,314.54,2248.71,Car,66,4
9,2248.71,333.0,16.19,316.81,1931.9,Car,66,4
10,1931.9,333.0,13.91,319.09,1612.81,Car,66,4
11,1612.81,333.0,11.61,321.39,1291.42,Car,66,4
12,1291.42,333.0,9.3,323.7,967.72,Car,66,4
13,967.72,333.0,6.97,326.03,641.69,Car,66,4
14,641.69,333.0,4.62,328.38,313.31,Car,66,4
15,313.31,333.0,2.26,330.74,-17.43,Car,66,4
0,4000.0,70.0,16.0,54.0,3946.0,testing,66,5
1,3946.0,70.0,15.78,54.22,3891.78,testing,66,5
2,3891.78,70.0,15.57,54.43,3837.35,testing,66,5
3,3837.35,70.0,15.35,54.65,3782.7,testing,66,5
4,3782.7,70.0,15.13,54.87,3727.83,testing,66,5
5,3727.83,70.0,14.91,55.09,3672.74,testing,66,5
6,3672.74,70.0,14.69,55.31,3617.43,testing,66,5
7,3617.43,70.0,14.47,55.53,3561.9,testing,66,5
8,3561.9,70.0,14.25,55.75,3506.15,testing,66,5
9,3506.15,70.0,14.02,55.98,3450.17,testing,66,5
10,3450.17,70.0,13.8,56.2,3393.97,testing,66,5
11,3393.97,70.0,13.58,56.42,3337.55,testing,66,5
12,3337.55,70.0,13.35,56.65,3280.9,testing,66,5
13,3280.9,70.0,13.12,56.88,3224.02,testing,66,5
14,3224.02,70.0,12.9,57.1,3166.92,testing,66,5
15,3166.92,87.43,12.67,74.76,3092.16,testing,66,5
16,3092.16,3010.1,12.37,2997.73,94.43,testing,66,5
17,94.43,3010.1,0.38,3009.72,-2915.29,testing,66,5
0,8250.57,1084.62,53.63,1030.99,7219.58,WellsFargo1,67,1
1,7219.58,1084.62,46.93,1037.69,6181.89,WellsFargo1,67,1
2,6181.89,1084.62,40.18,1044.44,5137.45,WellsFargo1,67,1
3,5137.45,1084.62,33.39,1051.23,4086.22,WellsFargo1,67,1
4,4086.22,1084.62,26.56,1058.06,3028.16,WellsFargo1,67,1
5,3028.16,1084.62,19.68,1064.94,1963.22,WellsFargo1,67,1
6,1963.22,1084.62,12.76,1071.86,891.36,WellsFargo1,67,1
7,891.36,1084.62,5.79,1078.83,-187.47,WellsFargo1,67,1
0,180000.0,1331.44,594.0,737.44,179262.56,mortgage,67,2
1,179262.56,1331.44,591.57,739.87,178522.69,mortgage,67,2
2,178522.69,1331.44,589.12,742.32,177780.37,mortgage,67,2
3,177780.37,1331.44,586.68,744.76,177035.61,mortgage,67,2
4,177035.61,1331.44,584.22,747.22,176288.39,mortgage,67,2
5,176288.39,1331.44,581.75,749.69,175538.7,mortgage,67,2
6,175538.7,1331.44,579.28,752.16,174786.54,mortgage,67,2
7,174786.54,1518.91,576.8,942.11,173844.43,mortgage,67,2
8,173844.43,2416.06,573.69,1842.37,172002.06,mortgage,67,2
9,172002.06,2416.06,567.61,1848.45,170153.61,mortgage,67,2
10,170153.61,2416.06,561.51,1854.55,168299.06,mortgage,67,2
11,168299.06,2416.06,555.39,1860.67,166438.39,mortgage,67,2
12,166438.39,2416.06,549.25,1866.81,164571.58,mortgage,67,2
13,164571.58,2416.06,543.09,1872.97,162698.61,mortgage,67,2
14,162698.61,2416.06,536.91,1879.15,160819.46,mortgage,67,2
15,160819.46,2416.06,530.7,1885.36,158934.1,mortgage,67,2
16,158934.1,2416.06,524.48,1891.58,157042.52,mortgage,67,2
17,157042.52,2416.06,518.24,1897.82,155144.7,mortgage,67,2
18,155144.7,2416.06,511.98,1904.08,153240.62,mortgage,67,2
19,153240.62,2416.06,505.69,1910.37,151330.25,mortgage,67,2
20,151330.25,2416.06,499.39,1916.67,149413.58,mortgage,67,2
21,149413.58,2416.06,493.06,1923.0,147490.58,mortgage,67,2
22,147490.58,2416.06,486.72,1929.34,145561.24,mortgage,67,2
23,145561.24,2416.06,480.35,1935.71,143625.53,mortgage,67,2
24,143625.53,2416.06,473.96,1942.1,141683.43,mortgage,67,2
25,141683.43,2416.06,467.56,1948.5,139734.93,mortgage,67,2
26,139734.93,2416.06,461.13,1954.93,137780.0,mortgage,67,2
27,137780.0,2416.06,454.67,1961.39,135818.61,mortgage,67,2
28,135818.61,2416.06,448.2,1967.86,133850.75,mortgage,67,2
29,133850.75,2416.06,441.71,1974.35,131876.4,mortgage,67,2
30,131876.4,2416.06,435.19,1980.87,129895.53,mortgage,67,2
31,129895.53,2416.06,428.66,1987.4,127908.13,mortgage,67,2
32,127908.13,2416.06,422.1,1993.96,125914.17,mortgage,67,2
33,125914.17,2416.06,415.52,2000.54,123913.63,mortgage,67,2
34,123913.63,2416.06,408.91,2007.15,121906.48,mortgage,67,2
35,121906.48,2416.06,402.29,2013.77,119892.71,mortgage,67,2
36,119892.71,2416.06,395.65,2020.41,117872.3,mortgage,67,2
37,117872.3,2416.06,388.98,2027.08,115845.22,mortgage,67,2
38,115845.22,2416.06,382.29,2033.77,113811.45,mortgage,67,2
39,113811.45,2416.06,375.58,2040.48,111770.97,mortgage,67,2
40,111770.97,2416.06,368.84,2047.22,109723.75,mortgage,67,2
41,109723.75,2416.06,362.09,2053.97,107669.78,mortgage,67,2
42,107669.78,2416.06,355.31,2060.75,105609.03,mortgage,67,2
43,105609.03,2416.06,348.51,2067.55,103541.48,mortgage,67,2
44,103541.48,2416.06,341.69,2074.37,101467.11,mortgage,67,2
45,101467.11,2416.06,334.84,2081.22,99385.89,mortgage,67,2
46,99385.89,2416.06,327.97,2088.09,97297.8,mortgage,67,2
47,97297.8,2416.06,321.08,2094.98,95202.82,mortgage,67,2
48,95202.82,2416.06,314.17,2101.89,93100.93,mortgage,67,2
49,93100.93,2416.06,307.23,2108.83,90992.1,mortgage,67,2
50,90992.1,2416.06,300.27,2115.79,88876.31,mortgage,67,2
51,88876.31,2416.06,293.29,2122.77,86753.54,mortgage,67,2
52,86753.54,2416.06,286.29,2129.77,84623.77,mortgage,67,2
53,84623.77,2416.06,279.26,2136.8,82486.97,mortgage,67,2
54,82486.97,2416.06,272.21,2143.85,80343.12,mortgage,67,2
55,80343.12,2416.06,265.13,2150.93,78192.19,mortgage,67,2
56,78192.19,2416.06,258.03,2158.03,76034.16,mortgage,67,2
57,76034.16,2416.06,250.91,2165.15,73869.01,mortgage,67,2
58,73869.01,2416.06,243.77,2172.29,71696.72,mortgage,67,2
59,71696.72,2416.06,236.6,2179.46,69517.26,mortgage,67,2
60,69517.26,2416.06,229.41,2186.65,67330.61,mortgage,67,2
61,67330.61,2416.06,222.19,2193.87,65136.74,mortgage,67,2
62,65136.74,2416.06,214.95,2201.11,62935.63,mortgage,67,2
63,62935.63,2416.06,207.69,2208.37,60727.26,mortgage,67,2
64,60727.26,2416.06,200.4,2215.66,58511.6,mortgage,67,2
65,58511.6,2416.06,193.09,2222.97,56288.63,mortgage,67,2
66,56288.63,2416.06,185.75,2230.31,54058.32,mortgage,67,2
67,54058.32,2416.06,178.39,2237.67,51820.65,mortgage,67,2
68,51820.65,2416.06,171.01,2245.05,49575.6,mortgage,67,2
69,49575.6,2416.06,163.6,2252.46,47323.14,mortgage,67,2
70,47323.14,2416.06,156.17,2259.89,45063.25,mortgage,67,2
71,45063.25,2416.06,148.71,2267.35,42795.9,mortgage,67,2
72,42795.9,2416.06,141.23,2274.83,40521.07,mortgage,67,2
73,40521.07,2416.06,133.72,2282.34,38238.73,mortgage,67,2
74,38238.73,2416.06,126.19,2289.87,35948.86,mortgage,67,2
75,35948.86,2416.06,118.63,2297.43,33651.43,mortgage,67,2
76,33651.43,2416.06,111.05,2305.01,31346.42,mortgage,67,2
77,31346.42,2416.06,103.44,2312.62,29033.8,mortgage,67,2
78,29033.8,2416.06,95.81,2320.25,26713.55,mortgage,67,2
79,26713.55,2416.06,88.15,2327.91,24385.64,mortgage,67,2
80,24385.64,2416.06,80.47,2335.59,22050.05,mortgage,67,2
81,22050.05,2416.06,72.77,2343.29,19706.76,mortgage,67,2
82,19706.76,2416.06,65.03,2351.03,17355.73,mortgage,67,2
83,17355.73,2416.06,57.27,2358.79,14996.94,mortgage,67,2
84,14996.94,2416.06,49.49,2366.57,12630.37,mortgage,67,2
85,12630.37,2416.06,41.68,2374.38,10255.99,mortgage,67,2
86,10255.99,2416.06,33.84,2382.22,7873.77,mortgage,67,2
87,7873.77,2416.06,25.98,2390.08,5483.69,mortgage,67,2
88,5483.69,2416.06,18.1,2397.96,3085.73,mortgage,67,2
89,3085.73,2416.06,10.18,2405.88,679.85,mortgage,67,2
90,679.85,2416.06,2.24,2413.82,-1733.97,mortgage,67,2
0,4000.0,70.0,16.0,54.0,3946.0,testing,67,3
1,3946.0,70.0,15.78,54.22,3891.78,testing,67,3
2,3891.78,70.0,15.57,54.43,3837.35,testing,67,3
3,3837.35,70.0,15.35,54.65,3782.7,testing,67,3
4,3782.7,70.0,15.13,54.87,3727.83,testing,67,3
5,3727.83,70.0,14.91,55.09,3672.74,testing,67,3
6,3672.74,70.0,14.69,55.31,3617.43,testing,67,3
7,3617.43,70.0,14.47,55.53,3561.9,testing,67,3
8,3561.9,70.0,14.25,55.75,3506.15,testing,67,3
9,3506.15,70.0,14.02,55.98,3450.17,testing,67,3
10,3450.17,70.0,13.8,56.2,3393.97,testing,67,3
11,3393.97,70.0,13.58,56.42,3337.55,testing,67,3
12,3337.55,70.0,13.35,56.65,3280.9,testing,67,3
13,3280.9,70.0,13.12,56.88,3224.02,testing,67,3
14,3224.02,70.0,12.9,57.1,3166.92,testing,67,3
15,3166.92,70.0,12.67,57.33,3109.59,testing,67,3
16,3109.59,70.0,12.44,57.56,3052.03,testing,67,3
17,3052.03,70.0,12.21,57.79,2994.24,testing,67,3
18,2994.24,70.0,11.98,58.02,2936.22,testing,67,3
19,2936.22,70.0,11.74,58.26,2877.96,testing,67,3
20,2877.96,70.0,11.51,58.49,2819.47,testing,67,3
21,2819.47,70.0,11.28,58.72,2760.75,testing,67,3
22,2760.75,70.0,11.04,58.96,2701.79,testing,67,3
23,2701.79,70.0,10.81,59.19,2642.6,testing,67,3
24,2642.6,70.0,10.57,59.43,2583.17,testing,67,3
25,2583.17,70.0,10.33,59.67,2523.5,testing,67,3
26,2523.5,70.0,10.09,59.91,2463.59,testing,67,3
27,2463.59,70.0,9.85,60.15,2403.44,testing,67,3
28,2403.44,70.0,9.61,60.39,2343.05,testing,67,3
29,2343.05,70.0,9.37,60.63,2282.42,testing,67,3
30,2282.42,70.0,9.13,60.87,2221.55,testing,67,3
31,2221.55,70.0,8.89,61.11,2160.44,testing,67,3
32,2160.44,70.0,8.64,61.36,2099.08,testing,67,3
33,2099.08,70.0,8.4,61.6,2037.48,testing,67,3
34,2037.48,70.0,8.15,61.85,1975.63,testing,67,3
35,1975.63,70.0,7.9,62.1,1913.53,testing,67,3
36,1913.53,70.0,7.65,62.35,1851.18,testing,67,3
37,1851.18,70.0,7.4,62.6,1788.58,testing,67,3
38,1788.58,70.0,7.15,62.85,1725.73,testing,67,3
39,1725.73,70.0,6.9,63.1,1662.63,testing,67,3
40,1662.63,70.0,6.65,63.35,1599.28,testing,67,3
41,1599.28,70.0,6.4,63.6,1535.68,testing,67,3
42,1535.68,70.0,6.14,63.86,1471.82,testing,67,3
43,1471.82,70.0,5.89,64.11,1407.71,testing,67,3
44,1407.71,70.0,5.63,64.37,1343.34,testing,67,3
45,1343.34,70.0,5.37,64.63,1278.71,testing,67,3
46,1278.71,70.0,5.11,64.89,1213.82,testing,67,3
47,1213.82,70.0,4.86,65.14,1148.68,testing,67,3
48,1148.68,70.0,4.59,65.41,1083.27,testing,67,3
49,1083.27,70.0,4.33,65.67,1017.6,testing,67,3
50,1017.6,70.0,4.07,65.93,951.67,testing,67,3
51,951.67,70.0,3.81,66.19,885.48,testing,67,3
52,885.48,70.0,3.54,66.46,819.02,testing,67,3
53,819.02,70.0,3.28,66.72,752.3,testing,67,3
54,752.3,70.0,3.01,66.99,685.31,testing,67,3
55,685.31,70.0,2.74,67.26,618.05,testing,67,3
56,618.05,70.0,2.47,67.53,550.52,testing,67,3
57,550.52,70.0,2.2,67.8,482.72,testing,67,3
58,482.72,70.0,1.93,68.07,414.65,testing,67,3
59,414.65,70.0,1.66,68.34,346.31,testing,67,3
60,346.31,70.0,1.39,68.61,277.7,testing,67,3
61,277.7,70.0,1.11,68.89,208.81,testing,67,3
62,208.81,70.0,0.84,69.16,139.65,testing,67,3
63,139.65,70.0,0.56,69.44,70.21,testing,67,3
64,70.21,70.0,0.28,69.72,0.49,testing,67,3
65,0.49,70.0,0.0,70.0,-69.51,testing,67,3
0,5000.0,333.0,36.0,297.0,4703.0,Car,67,4
1,4703.0,333.0,33.86,299.14,4403.86,Car,67,4
2,4403.86,333.0,31.71,301.29,4102.57,Car,67,4
3,4102.57,333.0,29.54,303.46,3799.11,Car,67,4
4,3799.11,333.0,27.35,305.65,3493.46,Car,67,4
5,3493.46,333.0,25.15,307.85,3185.61,Car,67,4
6,3185.61,333.0,22.94,310.06,2875.55,Car,67,4
7,2875.55,333.0,20.7,312.3,2563.25,Car,67,4
8,2563.25,333.0,18.46,314.54,2248.71,Car,67,4
9,2248.71,333.0,16.19,316.81,1931.9,Car,67,4
10,1931.9,333.0,13.91,319.09,1612.81,Car,67,4
11,1612.81,333.0,11.61,321.39,1291.42,Car,67,4
12,1291.42,333.0,9.3,323.7,967.72,Car,67,4
13,967.72,333.0,6.97,326.03,641.69,Car,67,4
14,641.69,333.0,4.62,328.38,313.31,Car,67,4
15,313.31,333.0,2.26,330.74,-17.43,Car,67,4
0,20000.0,191.04,108.0,83.04,19916.96,WellsFargo2,67,5
1,19916.96,191.04,107.55,83.49,19833.47,WellsFargo2,67,5
2,19833.47,191.04,107.1,83.94,19749.53,WellsFargo2,67,5
3,19749.53,191.04,106.65,84.39,19665.14,WellsFargo2,67,5
4,19665.14,191.04,106.19,84.85,19580.29,WellsFargo2,67,5
5,19580.29,191.04,105.73,85.31,19494.98,WellsFargo2,67,5
6,19494.98,191.04,105.27,85.77,19409.21,WellsFargo2,67,5
7,19409.21,191.04,104.81,86.23,19322.98,WellsFargo2,67,5
8,19322.98,191.04,104.34,86.7,19236.28,WellsFargo2,67,5
9,19236.28,191.04,103.88,87.16,19149.12,WellsFargo2,67,5
10,19149.12,191.04,103.41,87.63,19061.49,WellsFargo2,67,5
11,19061.49,191.04,102.93,88.11,18973.38,WellsFargo2,67,5
12,18973.38,191.04,102.46,88.58,18884.8,WellsFargo2,67,5
13,18884.8,191.04,101.98,89.06,18795.74,WellsFargo2,67,5
14,18795.74,191.04,101.5,89.54,18706.2,WellsFargo2,67,5
15,18706.2,208.47,101.01,107.46,18598.74,WellsFargo2,67,5
16,18598.74,3010.1,100.43,2909.67,15689.07,WellsFargo2,67,5
17,15689.07,3010.1,84.72,2925.38,12763.69,WellsFargo2,67,5
18,12763.69,3010.1,68.92,2941.18,9822.51,WellsFargo2,67,5
19,9822.51,3010.1,53.04,2957.06,6865.45,WellsFargo2,67,5
20,6865.45,3010.1,37.07,2973.03,3892.42,WellsFargo2,67,5
21,3892.42,3010.1,21.02,2989.08,903.34,WellsFargo2,67,5
22,903.34,3010.1,4.88,3005.22,-2101.88,WellsFargo2,67,5
0,8250.57,1084.62,53.63,1030.99,7219.58,WellsFargo1,68,1
1,7219.58,1084.62,46.93,1037.69,6181.89,WellsFargo1,68,1
2,6181.89,1084.62,40.18,1044.44,5137.45,WellsFargo1,68,1
3,5137.45,1084.62,33.39,1051.23,4086.22,WellsFargo1,68,1
4,4086.22,1084.62,26.56,1058.06,3028.16,WellsFargo1,68,1
5,3028.16,1084.62,19.68,1064.94,1963.22,WellsFargo1,68,1
6,1963.22,1084.62,12.76,1071.86,891.36,WellsFargo1,68,1
7,891.36,1084.62,5.79,1078.83,-187.47,WellsFargo1,68,1
0,180000.0,1331.44,594.0,737.44,179262.56,mortgage,68,2
1,179262.56,1331.44,591.57,739.87,178522.69,mortgage,68,2
2,178522.69,1331.44,589.12,742.32,177780.37,mortgage,68,2
3,177780.37,1331.44,586.68,744.76,177035.61,mortgage,68,2
4,177035.61,1331.44,584.22,747.22,176288.39,mortgage,68,2
5,176288.39,1331.44,581.75,749.69,175538.7,mortgage,68,2
6,175538.7,1331.44,579.28,752.16,174786.54,mortgage,68,2
7,174786.54,1518.91,576.8,942.11,173844.43,mortgage,68,2
8,173844.43,2416.06,573.69,1842.37,172002.06,mortgage,68,2
9,172002.06,2416.06,567.61,1848.45,170153.61,mortgage,68,2
10,170153.61,2416.06,561.51,1854.55,168299.06,mortgage,68,2
11,168299.06,2416.06,555.39,1860.67,166438.39,mortgage,68,2
12,166438.39,2416.06,549.25,1866.81,164571.58,mortgage,68,2
13,164571.58,2416.06,543.09,1872.97,162698.61,mortgage,68,2
14,162698.61,2416.06,536.91,1879.15,160819.46,mortgage,68,2
15,160819.46,2416.06,530.7,1885.36,158934.1,mortgage,68,2
16,158934.1,2416.06,524.48,1891.58,157042.52,mortgage,68,2
17,157042.52,2416.06,518.24,1897.82,155144.7,mortgage,68,2
18,155144.7,2416.06,511.98,1904.08,153240.62,mortgage,68,2
19,153240.62,2416.06,505.69,1910.37,151330.25,mortgage,68,2
20,151330.25,2416.06,499.39,1916.67,149413.58,mortgage,68,2
21,149413.58,2416.06,493.06,1923.0,147490.58,mortgage,68,2
22,147490.58,2416.06,486.72,1929.34,145561.24,mortgage,68,2
23,145561.24,2416.06,480.35,1935.71,143625.53,mortgage,68,2
24,143625.53,2416.06,473.96,1942.1,141683.43,mortgage,68,2
25,141683.43,2416.06,467.56,1948.5,139734.93,mortgage,68,2
26,139734.93,2416.06,461.13,1954.93,137780.0,mortgage,68,2
27,137780.0,2416.06,454.67,1961.39,135818.61,mortgage,68,2
28,135818.61,2416.06,448.2,1967.86,133850.75,mortgage,68,2
29,133850.75,2416.06,441.71,1974.35,131876.4,mortgage,68,2
30,131876.4,2416.06,435.19,1980.87,129895.53,mortgage,68,2
31,129895.53,2416.06,428.66,1987.4,127908.13,mortgage,68,2
32,127908.13,2416.06,422.1,1993.96,125914.17,mortgage,68,2
33,125914.17,2416.06,415.52,2000.54,123913.63,mortgage,68,2
34,123913.63,2416.06,408.91,2007.15,121906.48,mortgage,68,2
35,121906.48,2416.06,402.29,2013.77,119892.71,mortgage,68,2
36,119892.71,2416.06,395.65,2020.41,117872.3,mortgage,68,2
37,117872.3,2416.06,388.98,2027.08,115845.22,mortgage,68,2
38,115845.22,2416.06,382.29,2033.77,113811.45,mortgage,68,2
39,113811.45,2416.06,375.58,2040.48,111770.97,mortgage,68,2
40,111770.97,2416.06,368.84,2047.22,109723.75,mortgage,68,2
41,109723.75,2416.06,362.09,2053.97,107669.78,mortgage,68,2
42,107669.78,2416.06,355.31,2060.75,105609.03,mortgage,68,2
43,105609.03,2416.06,348.51,2067.55,103541.48,mortgage,68,2
44,103541.48,2416.06,341.69,2074.37,101467.11,mortgage,68,2
45,101467.11,2416.06,334.84,2081.22,99385.89,mortgage,68,2
46,99385.89,2416.06,327.97,2088.09,97297.8,mortgage,68,2
47,97297.8,2416.06,321.08,2094.98,95202.82,mortgage,68,2
48,95202.82,2416.06,314.17,2101.89,93100.93,mortgage,68,2
49,93100.93,2416.06,307.23,2108.83,90992.1,mortgage,68,2
50,90992.1,2416.06,300.27,2115.79,88876.31,mortgage,68,2
51,88876.31,2416.06,293.29,2122.77,86753.54,mortgage,68,2
52,86753.54,2416.06,286.29,2129.77,84623.77,mortgage,68,2
53,84623.77,2416.06,279.26,2136.8,82486.97,mortgage,68,2
54,82486.97,2416.06,272.21,2143.85,80343.12,mortgage,68,2
55,80343.12,2416.06,265.13,2150.93,78192.19,mortgage,68,2
56,78192.19,2416.06,258.03,2158.03,76034.16,mortgage,68,2
57,76034.16,2416.06,250.91,2165.15,73869.01,mortgage,68,2
58,73869.01,2416.06,243.77,2172.29,71696.72,mortgage,68,2
59,71696.72,2416.06,236.6,2179.46,69517.26,mortgage,68,2
60,69517.26,2416.06,229.41,2186.65,67330.61,mortgage,68,2
61,67330.61,2416.06,222.19,2193.87,65136.74,mortgage,68,2
62,65136.74,2416.06,214.95,2201.11,62935.63,mortgage,68,2
63,62935.63,2416.06,207.69,2208.37,60727.26,mortgage,68,2
64,60727.26,2416.06,200.4,2215.66,58511.6,mortgage,68,2
65,58511.6,2416.06,193.09,2222.97,56288.63,mortgage,68,2
66,56288.63,2416.06,185.75,2230.31,54058.32,mortgage,68,2
67,54058.32,2416.06,178.39,2237.67,51820.65,mortgage,68,2
68,51820.65,2416.06,171.01,2245.05,49575.6,mortgage,68,2
69,49575.6,2416.06,163.6,2252.46,47323.14,mortgage,68,2
70,47323.14,2416.06,156.17,2259.89,45063.25,mortgage,68,2
71,45063.25,2416.06,148.71,2267.35,42795.9,mortgage,68,2
72,42795.9,2416.06,141.23,2274.83,40521.07,mortgage,68,2
73,40521.07,2416.06,133.72,2282.34,38238.73,mortgage,68,2
74,38238.73,2416.06,126.19,2289.87,35948.86,mortgage,68,2
75,35948.86,2416.06,118.63,2297.43,33651.43,mortgage,68,2
76,33651.43,2416.06,111.05,2305.01,31346.42,mortgage,68,2
77,31346.42,2416.06,103.44,2312.62,29033.8,mortgage,68,2
78,29033.8,2416.06,95.81,2320.25,26713.55,mortgage,68,2
79,26713.55,2416.06,88.15,2327.91,24385.64,mortgage,68,2
80,24385.64,2416.06,80.47,2335.59,22050.05,mortgage,68,2
81,22050.05,2416.06,72.77,2343.29,19706.76,mortgage,68,2
82,19706.76,2416.06,65.03,2351.03,17355.73,mortgage,68,2
83,17355.73,2416.06,57.27,2358.79,14996.94,mortgage,68,2
84,14996.94,2416.06,49.49,2366.57,12630.37,mortgage,68,2
85,12630.37,2416.06,41.68,2374.38,10255.99,mortgage,68,2
86,10255.99,2416.06,33.84,2382.22,7873.77,mortgage,68,2
87,7873.77,2416.06,25.98,2390.08,5483.69,mortgage,68,2
88,5483.69,2416.06,18.1,2397.96,3085.73,mortgage,68,2
89,3085.73,2416.06,10.18,2405.88,679.85,mortgage,68,2
90,679.85,2416.06,2.24,2413.82,-1733.97,mortgage,68,2
0,4000.0,70.0,16.0,54.0,3946.0,testing,68,3
1,3946.0,70.0,15.78,54.22,3891.78,testing,68,3
2,3891.78,70.0,15.57,54.43,3837.35,testing,68,3
3,3837.35,70.0,15.35,54.65,3782.7,testing,68,3
4,3782.7,70.0,15.13,54.87,3727.83,testing,68,3
5,3727.83,70.0,14.91,55.09,3672.74,testing,68,3
6,3672.74,70.0,14.69,55.31,3617.43,testing,68,3
7,3617.43,70.0,14.47,55.53,3561.9,testing,68,3
8,3561.9,70.0,14.25,55.75,3506.15,testing,68,3
9,3506.15,70.0,14.02,55.98,3450.17,testing,68,3
10,3450.17,70.0,13.8,56.2,3393.97,testing,68,3
11,3393.97,70.0,13.58,56.42,3337.55,testing,68,3
12,3337.55,70.0,13.35,56.65,3280.9,testing,68,3
13,3280.9,70.0,13.12,56.88,3224.02,testing,68,3
14,3224.02,70.0,12.9,57.1,3166.92,testing,68,3
15,3166.92,70.0,12.67,57.33,3109.59,testing,68,3
16,3109.59,70.0,12.44,57.56,3052.03,testing,68,3
17,3052.03,70.0,12.21,57.79,2994.24,testing,68,3
18,2994.24,70.0,11.98,58.02,2936.22,testing,68,3
19,2936.22,70.0,11.74,58.26,2877.96,testing,68,3
20,2877.96,70.0,11.51,58.49,2819.47,testing,68,3
21,2819.47,70.0,11.28,58.72,2760.75,testing,68,3
22,2760.75,70.0,11.04,58.96,2701.79,testing,68,3
23,2701.79,70.0,10.81,59.19,2642.6,testing,68,3
24,2642.6,70.0,10.57,59.43,2583.17,testing,68,3
25,2583.17,70.0,10.33,59.67,2523.5,testing,68,3
26,2523.5,70.0,10.09,59.91,2463.59,testing,68,3
27,2463.59,70.0,9.85,60.15,2403.44,testing,68,3
28,2403.44,70.0,9.61,60.39,2343.05,testing,68,3
29,2343.05,70.0,9.37,60.63,2282.42,testing,68,3
30,2282.42,70.0,9.13,60.87,2221.55,testing,68,3
31,2221.55,70.0,8.89,61.11,2160.44,testing,68,3
32,2160.44,70.0,8.64,61.36,2099.08,testing,68,3
33,2099.08,70.0,8.4,61.6,2037.48,testing,68,3
34,2037.48,70.0,8.15,61.85,1975.63,testing,68,3
35,1975.63,70.0,7.9,62.1,1913.53,testing,68,3
36,1913.53,70.0,7.65,62.35,1851.18,testing,68,3
37,1851.18,70.0,7.4,62.6,1788.58,testing,68,3
38,1788.58,70.0,7.15,62.85,1725.73,testing,68,3
39,1725.73,70.0,6.9,63.1,1662.63,testing,68,3
40,1662.63,70.0,6.65,63.35,1599.28,testing,68,3
41,1599.28,70.0,6.4,63.6,1535.68,testing,68,3
42,1535.68,70.0,6.14,63.86,1471.82,testing,68,3
43,1471.82,70.0,5.89,64.11,1407.71,testing,68,3
44,1407.71,70.0,5.63,64.37,1343.34,testing,68,3
45,1343.34,70.0,5.37,64.63,1278.71,testing,68,3
46,1278.71,70.0,5.11,64.89,1213.82,testing,68,3
47,1213.82,70.0,4.86,65.14,1148.68,testing,68,3
48,1148.68,70.0,4.59,65.41,1083.27,testing,68,3
49,1083.27,70.0,4.33,65.67,1017.6,testing,68,3
50,1017.6,70.0,4.07,65.93,951.67,testing,68,3
51,951.67,70.0,3.81,66.19,885.48,testing,68,3
52,885.48,70.0,3.54,66.46,819.02,testing,68,3
53,819.02,70.0,3.28,66.72,752.3,testing,68,3
54,752.3,70.0,3.01,66.99,685.31,testing,68,3
55,685.31,70.0,2.74,67.26,618.05,testing,68,3
56,618.05,70.0,2.47,67.53,550.52,testing,68,3
57,550.52,70.0,2.2,67.8,482.72,testing,68,3
58,482.72,70.0,1.93,68.07,414.65,testing,68,3
59,414.65,70.0,1.66,68.34,346.31,testing,68,3
60,346.31,70.0,1.39,68.61,277.7,testing,68,3
61,277.7,70.0,1.11,68.89,208.81,testing,68,3
62,208.81,70.0,0.84,69.16,139.65,testing,68,3
63,139.65,70.0,0.56,69.44,70.21,testing,68,3
64,70.21,70.0,0.28,69.72,0.49,testing,68,3
65,0.49,70.0,0.0,70.0,-69.51,testing,68,3
0,20000.0,191.04,108.0,83.04,19916.96,WellsFargo2,68,4
1,19916.96,191.04,107.55,83.49,19833.47,WellsFargo2,68,4
2,19833.47,191.04,107.1,83.94,19749.53,WellsFargo2,68,4
3,19749.53,191.04,106.65,84.39,19665.14,WellsFargo2,68,4
4,19665.14,191.04,106.19,84.85,19580.29,WellsFargo2,68,4
5,19580.29,191.04,105.73,85.31,19494.98,WellsFargo2,68,4
6,19494.98,191.04,105.27,85.77,19409.21,WellsFargo2,68,4
7,19409.21,191.04,104.81,86.23,19322.98,WellsFargo2,68,4
8,19322.98,191.04,104.34,86.7,19236.28,WellsFargo2,68,4
9,19236.28,191.04,103.88,87.16,19149.12,WellsFargo2,68,4
10,19149.12,191.04,103.41,87.63,19061.49,WellsFargo2,68,4
11,19061.49,191.04,102.93,88.11,18973.38,WellsFargo2,68,4
12,18973.38,191.04,102.46,88.58,18884.8,WellsFargo2,68,4
13,18884.8,191.04,101.98,89.06,18795.74,WellsFargo2,68,4
14,18795.74,191.04,101.5,89.54,18706.2,WellsFargo2,68,4
15,18706.2,191.04,101.01,90.03,18616.17,WellsFargo2,68,4
16,18616.17,191.04,100.53,90.51,18525.66,WellsFargo2,68,4
17,18525.66,191.04,100.04,91.0,18434.66,WellsFargo2,68,4
18,18434.66,191.04,99.55,91.49,18343.17,WellsFargo2,68,4
19,18343.17,191.04,99.05,91.99,18251.18,WellsFargo2,68,4
20,18251.18,191.04,98.56,92.48,18158.7,WellsFargo2,68,4
21,18158.7,191.04,98.06,92.98,18065.72,WellsFargo2,68,4
22,18065.72,191.04,97.55,93.49,17972.23,WellsFargo2,68,4
23,17972.23,191.04,97.05,93.99,17878.24,WellsFargo2,68,4
24,17878.24,191.04,96.54,94.5,17783.74,WellsFargo2,68,4
25,17783.74,191.04,96.03,95.01,17688.73,WellsFargo2,68,4
26,17688.73,191.04,95.52,95.52,17593.21,WellsFargo2,68,4
27,17593.21,191.04,95.0,96.04,17497.17,WellsFargo2,68,4
28,17497.17,191.04,94.48,96.56,17400.61,WellsFargo2,68,4
29,17400.61,191.04,93.96,97.08,17303.53,WellsFargo2,68,4
30,17303.53,191.04,93.44,97.6,17205.93,WellsFargo2,68,4
31,17205.93,191.04,92.91,98.13,17107.8,WellsFargo2,68,4
32,17107.8,191.04,92.38,98.66,17009.14,WellsFargo2,68,4
33,17009.14,191.04,91.85,99.19,16909.95,WellsFargo2,68,4
34,16909.95,191.04,91.31,99.73,16810.22,WellsFargo2,68,4
35,16810.22,191.04,90.78,100.26,16709.96,WellsFargo2,68,4
36,16709.96,191.04,90.23,100.81,16609.15,WellsFargo2,68,4
37,16609.15,191.04,89.69,101.35,16507.8,WellsFargo2,68,4
38,16507.8,191.04,89.14,101.9,16405.9,WellsFargo2,68,4
39,16405.9,191.04,88.59,102.45,16303.45,WellsFargo2,68,4
40,16303.45,191.04,88.04,103.0,16200.45,WellsFargo2,68,4
41,16200.45,191.04,87.48,103.56,16096.89,WellsFargo2,68,4
42,16096.89,191.04,86.92,104.12,15992.77,WellsFargo2,68,4
43,15992.77,191.04,86.36,104.68,15888.09,WellsFargo2,68,4
44,15888.09,191.04,85.8,105.24,15782.85,WellsFargo2,68,4
45,15782.85,191.04,85.23,105.81,15677.04,WellsFargo2,68,4
46,15677.04,191.04,84.66,106.38,15570.66,WellsFargo2,68,4
47,15570.66,191.04,84.08,106.96,15463.7,WellsFargo2,68,4
48,15463.7,191.04,83.5,107.54,15356.16,WellsFargo2,68,4
49,15356.16,191.04,82.92,108.12,15248.04,WellsFargo2,68,4
50,15248.04,191.04,82.34,108.7,15139.34,WellsFargo2,68,4
51,15139.34,191.04,81.75,109.29,15030.05,WellsFargo2,68,4
52,15030.05,191.04,81.16,109.88,14920.17,WellsFargo2,68,4
53,14920.17,191.04,80.57,110.47,14809.7,WellsFargo2,68,4
54,14809.7,191.04,79.97,111.07,14698.63,WellsFargo2,68,4
55,14698.63,191.04,79.37,111.67,14586.96,WellsFargo2,68,4
56,14586.96,191.04,78.77,112.27,14474.69,WellsFargo2,68,4
57,14474.69,191.04,78.16,112.88,14361.81,WellsFargo2,68,4
58,14361.81,191.04,77.55,113.49,14248.32,WellsFargo2,68,4
59,14248.32,191.04,76.94,114.1,14134.22,WellsFargo2,68,4
60,14134.22,191.04,76.32,114.72,14019.5,WellsFargo2,68,4
61,14019.5,191.04,75.71,115.33,13904.17,WellsFargo2,68,4
62,13904.17,191.04,75.08,115.96,13788.21,WellsFargo2,68,4
63,13788.21,191.04,74.46,116.58,13671.63,WellsFargo2,68,4
64,13671.63,191.04,73.83,117.21,13554.42,WellsFargo2,68,4
65,13554.42,260.55,73.19,187.36,13367.06,WellsFargo2,68,4
66,13367.06,2677.1,72.18,2604.92,10762.14,WellsFargo2,68,4
67,10762.14,2677.1,58.12,2618.98,8143.16,WellsFargo2,68,4
68,8143.16,2677.1,43.97,2633.13,5510.03,WellsFargo2,68,4
69,5510.03,2677.1,29.75,2647.35,2862.68,WellsFargo2,68,4
70,2862.68,2677.1,15.46,2661.64,201.04,WellsFargo2,68,4
71,201.04,2677.1,1.09,2676.01,-2474.97,WellsFargo2,68,4
0,5000.0,333.0,36.0,297.0,4703.0,Car,68,5
1,4703.0,333.0,33.86,299.14,4403.86,Car,68,5
2,4403.86,333.0,31.71,301.29,4102.57,Car,68,5
3,4102.57,333.0,29.54,303.46,3799.11,Car,68,5
4,3799.11,333.0,27.35,305.65,3493.46,Car,68,5
5,3493.46,333.0,25.15,307.85,3185.61,Car,68,5
6,3185.61,333.0,22.94,310.06,2875.55,Car,68,5
7,2875.55,333.0,20.7,312.3,2563.25,Car,68,5
8,2563.25,333.0,18.46,314.54,2248.71,Car,68,5
9,2248.71,333.0,16.19,316.81,1931.9,Car,68,5
10,1931.9,333.0,13.91,319.09,1612.81,Car,68,5
11,1612.81,333.0,11.61,321.39,1291.42,Car,68,5
12,1291.42,333.0,9.3,323.7,967.72,Car,68,5
13,967.72,333.0,6.97,326.03,641.69,Car,68,5
14,641.69,333.0,4.62,328.38,313.31,Car,68,5
15,313.31,333.0,2.26,330.74,-17.43,Car,68,5
0,8250.57,1084.62,53.63,1030.99,7219.58,WellsFargo1,69,1
1,7219.58,1084.62,46.93,1037.69,6181.89,WellsFargo1,69,1
2,6181.89,1084.62,40.18,1044.44,5137.45,WellsFargo1,69,1
3,5137.45,1084.62,33.39,1051.23,4086.22,WellsFargo1,69,1
4,4086.22,1084.62,26.56,1058.06,3028.16,WellsFargo1,69,1
5,3028.16,1084.62,19.68,1064.94,1963.22,WellsFargo1,69,1
6,1963.22,1084.62,12.76,1071.86,891.36,WellsFargo1,69,1
7,891.36,1084.62,5.79,1078.83,-187.47,WellsFargo1,69,1
0,180000.0,1331.44,594.0,737.44,179262.56,mortgage,69,2
1,179262.56,1331.44,591.57,739.87,178522.69,mortgage,69,2
2,178522.69,1331.44,589.12,742.32,177780.37,mortgage,69,2
3,177780.37,1331.44,586.68,744.76,177035.61,mortgage,69,2
4,177035.61,1331.44,584.22,747.22,176288.39,mortgage,69,2
5,176288.39,1331.44,581.75,749.69,175538.7,mortgage,69,2
6,175538.7,1331.44,579.28,752.16,174786.54,mortgage,69,2
7,174786.54,1518.91,576.8,942.11,173844.43,mortgage,69,2
8,173844.43,2416.06,573.69,1842.37,172002.06,mortgage,69,2
9,172002.06,2416.06,567.61,1848.45,170153.61,mortgage,69,2
10,170153.61,2416.06,561.51,1854.55,168299.06,mortgage,69,2
11,168299.06,2416.06,555.39,1860.67,166438.39,mortgage,69,2
12,166438.39,2416.06,549.25,1866.81,164571.58,mortgage,69,2
13,164571.58,2416.06,543.09,1872.97,162698.61,mortgage,69,2
14,162698.61,2416.06,536.91,1879.15,160819.46,mortgage,69,2
15,160819.46,2416.06,530.7,1885.36,158934.1,mortgage,69,2
16,158934.1,2416.06,524.48,1891.58,157042.52,mortgage,69,2
17,157042.52,2416.06,518.24,1897.82,155144.7,mortgage,69,2
18,155144.7,2416.06,511.98,1904.08,153240.62,mortgage,69,2
19,153240.62,2416.06,505.69,1910.37,151330.25,mortgage,69,2
20,151330.25,2416.06,499.39,1916.67,149413.58,mortgage,69,2
21,149413.58,2416.06,493.06,1923.0,147490.58,mortgage,69,2
22,147490.58,2416.06,486.72,1929.34,145561.24,mortgage,69,2
23,145561.24,2416.06,480.35,1935.71,143625.53,mortgage,69,2
24,143625.53,2416.06,473.96,1942.1,141683.43,mortgage,69,2
25,141683.43,2416.06,467.56,1948.5,139734.93,mortgage,69,2
26,139734.93,2416.06,461.13,1954.93,137780.0,mortgage,69,2
27,137780.0,2416.06,454.67,1961.39,135818.61,mortgage,69,2
28,135818.61,2416.06,448.2,1967.86,133850.75,mortgage,69,2
29,133850.75,2416.06,441.71,1974.35,131876.4,mortgage,69,2
30,131876.4,2416.06,435.19,1980.87,129895.53,mortgage,69,2
31,129895.53,2416.06,428.66,1987.4,127908.13,mortgage,69,2
32,127908.13,2416.06,422.1,1993.96,125914.17,mortgage,69,2
33,125914.17,2416.06,415.52,2000.54,123913.63,mortgage,69,2
34,123913.63,2416.06,408.91,2007.15,121906.48,mortgage,69,2
35,121906.48,2416.06,402.29,2013.77,119892.71,mortgage,69,2
36,119892.71,2416.06,395.65,2020.41,117872.3,mortgage,69,2
37,117872.3,2416.06,388.98,2027.08,115845.22,mortgage,69,2
38,115845.22,2416.06,382.29,2033.77,113811.45,mortgage,69,2
39,113811.45,2416.06,375.58,2040.48,111770.97,mortgage,69,2
40,111770.97,2416.06,368.84,2047.22,109723.75,mortgage,69,2
41,109723.75,2416.06,362.09,2053.97,107669.78,mortgage,69,2
42,107669.78,2416.06,355.31,2060.75,105609.03,mortgage,69,2
43,105609.03,2416.06,348.51,2067.55,103541.48,mortgage,69,2
44,103541.48,2416.06,341.69,2074.37,101467.11,mortgage,69,2
45,101467.11,2416.06,334.84,2081.22,99385.89,mortgage,69,2
46,99385.89,2416.06,327.97,2088.09,97297.8,mortgage,69,2
47,97297.8,2416.06,321.08,2094.98,95202.82,mortgage,69,2
48,95202.82,2416.06,314.17,2101.89,93100.93,mortgage,69,2
49,93100.93,2416.06,307.23,2108.83,90992.1,mortgage,69,2
50,90992.1,2416.06,300.27,2115.79,88876.31,mortgage,69,2
51,88876.31,2416.06,293.29,2122.77,86753.54,mortgage,69,2
52,86753.54,2416.06,286.29,2129.77,84623.77,mortgage,69,2
53,84623.77,2416.06,279.26,2136.8,82486.97,mortgage,69,2
54,82486.97,2416.06,272.21,2143.85,80343.12,mortgage,69,2
55,80343.12,2416.06,265.13,2150.93,78192.19,mortgage,69,2
56,78192.19,2416.06,258.03,2158.03,76034.16,mortgage,69,2
57,76034.16,2416.06,250.91,2165.15,73869.01,mortgage,69,2
58,73869.01,2416.06,243.77,2172.29,71696.72,mortgage,69,2
59,71696.72,2416.06,236.6,2179.46,69517.26,mortgage,69,2
60,69517.26,2416.06,229.41,2186.65,67330.61,mortgage,69,2
61,67330.61,2416.06,222.19,2193.87,65136.74,mortgage,69,2
62,65136.74,2416.06,214.95,2201.11,62935.63,mortgage,69,2
63,62935.63,2416.06,207.69,2208.37,60727.26,mortgage,69,2
64,60727.26,2416.06,200.4,2215.66,58511.6,mortgage,69,2
65,58511.6,2416.06,193.09,2222.97,56288.63,mortgage,69,2
66,56288.63,2416.06,185.75,2230.31,54058.32,mortgage,69,2
67,54058.32,2416.06,178.39,2237.67,51820.65,mortgage,69,2
68,51820.65,2416.06,171.01,2245.05,49575.6,mortgage,69,2
69,49575.6,2416.06,163.6,2252.46,47323.14,mortgage,69,2
70,47323.14,2416.06,156.17,2259.89,45063.25,mortgage,69,2
71,45063.25,2416.06,148.71,2267.35,42795.9,mortgage,69,2
72,42795.9,2416.06,141.23,2274.83,40521.07,mortgage,69,2
73,40521.07,2416.06,133.72,2282.34,38238.73,mortgage,69,2
74,38238.73,2416.06,126.19,2289.87,35948.86,mortgage,69,2
75,35948.86,2416.06,118.63,2297.43,33651.43,mortgage,69,2
76,33651.43,2416.06,111.05,2305.01,31346.42,mortgage,69,2
77,31346.42,2416.06,103.44,2312.62,29033.8,mortgage,69,2
78,29033.8,2416.06,95.81,2320.25,26713.55,mortgage,69,2
79,26713.55,2416.06,88.15,2327.91,24385.64,mortgage,69,2
80,24385.64,2416.06,80.47,2335.59,22050.05,mortgage,69,2
81,22050.05,2416.06,72.77,2343.29,19706.76,mortgage,69,2
82,19706.76,2416.06,65.03,2351.03,17355.73,mortgage,69,2
83,17355.73,2416.06,57.27,2358.79,14996.94,mortgage,69,2
84,14996.94,2416.06,49.49,2366.57,12630.37,mortgage,69,2
85,12630.37,2416.06,41.68,2374.38,10255.99,mortgage,69,2
86,10255.99,2416.06,33.84,2382.22,7873.77,mortgage,69,2
87,7873.77,2416.06,25.98,2390.08,5483.69,mortgage,69,2
88,5483.69,2416.06,18.1,2397.96,3085.73,mortgage,69,2
89,3085.73,2416.06,10.18,2405.88,679.85,mortgage,69,2
90,679.85,2416.06,2.24,2413.82,-1733.97,mortgage,69,2
0,5000.0,333.0,36.0,297.0,4703.0,Car,69,3
1,4703.0,333.0,33.86,299.14,4403.86,Car,69,3
2,4403.86,333.0,31.71,301.29,4102.57,Car,69,3
3,4102.57,333.0,29.54,303.46,3799.11,Car,69,3
4,3799.11,333.0,27.35,305.65,3493.46,Car,69,3
5,3493.46,333.0,25.15,307.85,3185.61,Car,69,3
6,3185.61,333.0,22.94,310.06,2875.55,Car,69,3
7,2875.55,333.0,20.7,312.3,2563.25,Car,69,3
8,2563.25,333.0,18.46,314.54,2248.71,Car,69,3
9,2248.71,333.0,16.19,316.81,1931.9,Car,69,3
10,1931.9,333.0,13.91,319.09,1612.81,Car,69,3
11,1612.81,333.0,11.61,321.39,1291.42,Car,69,3
12,1291.42,333.0,9.3,323.7,967.72,Car,69,3
13,967.72,333.0,6.97,326.03,641.69,Car,69,3
14,641.69,333.0,4.62,328.38,313.31,Car,69,3
15,313.31,333.0,2.26,330.74,-17.43,Car,69,3
0,4000.0,70.0,16.0,54.0,3946.0,testing,69,4
1,3946.0,70.0,15.78,54.22,3891.78,testing,69,4
2,3891.78,70.0,15.57,54.43,3837.35,testing,69,4
3,3837.35,70.0,15.35,54.65,3782.7,testing,69,4
4,3782.7,70.0,15.13,54.87,3727.83,testing,69,4
5,3727.83,70.0,14.91,55.09,3672.74,testing,69,4
6,3672.74,70.0,14.69,55.31,3617.43,testing,69,4
7,3617.43,70.0,14.47,55.53,3561.9,testing,69,4
8,3561.9,70.0,14.25,55.75,3506.15,testing,69,4
9,3506.15,70.0,14.02,55.98,3450.17,testing,69,4
10,3450.17,70.0,13.8,56.2,3393.97,testing,69,4
11,3393.97,70.0,13.58,56.42,3337.55,testing,69,4
12,3337.55,70.0,13.35,56.65,3280.9,testing,69,4
13,3280.9,70.0,13.12,56.88,3224.02,testing,69,4
14,3224.02,70.0,12.9,57.1,3166.92,testing,69,4
15,3166.92,87.43,12.67,74.76,3092.16,testing,69,4
16,3092.16,2819.06,12.37,2806.69,285.47,testing,69,4
17,285.47,2819.06,1.14,2817.92,-2532.45,testing,69,4
0,20000.0,191.04,108.0,83.04,19916.96,WellsFargo2,69,5
1,19916.96,191.04,107.55,83.49,19833.47,WellsFargo2,69,5
2,19833.47,191.04,107.1,83.94,19749.53,WellsFargo2,69,5
3,19749.53,191.04,106.65,84.39,19665.14,WellsFargo2,69,5
4,19665.14,191.04,106.19,84.85,19580.29,WellsFargo2,69,5
5,19580.29,191.04,105.73,85.31,19494.98,WellsFargo2,69,5
6,19494.98,191.04,105.27,85.77,19409.21,WellsFargo2,69,5
7,19409.21,191.04,104.81,86.23,19322.98,WellsFargo2,69,5
8,19322.98,191.04,104.34,86.7,19236.28,WellsFargo2,69,5
9,19236.28,191.04,103.88,87.16,19149.12,WellsFargo2,69,5
10,19149.12,191.04,103.41,87.63,19061.49,WellsFargo2,69,5
11,19061.49,191.04,102.93,88.11,18973.38,WellsFargo2,69,5
12,18973.38,191.04,102.46,88.58,18884.8,WellsFargo2,69,5
13,18884.8,191.04,101.98,89.06,18795.74,WellsFargo2,69,5
14,18795.74,191.04,101.5,89.54,18706.2,WellsFargo2,69,5
15,18706.2,191.04,101.01,90.03,18616.17,WellsFargo2,69,5
16,18616.17,191.04,100.53,90.51,18525.66,WellsFargo2,69,5
17,18525.66,2723.49,100.04,2623.45,15902.21,WellsFargo2,69,5
18,15902.21,3010.1,85.87,2924.23,12977.98,WellsFargo2,69,5
19,12977.98,3010.1,70.08,2940.02,10037.96,WellsFargo2,69,5
20,10037.96,3010.1,54.2,2955.9,7082.06,WellsFargo2,69,5
21,7082.06,3010.1,38.24,2971.86,4110.2,WellsFargo2,69,5
22,4110.2,3010.1,22.2,2987.9,1122.3,WellsFargo2,69,5
23,1122.3,3010.1,6.06,3004.04,-1881.74,WellsFargo2,69,5
0,8250.57,1084.62,53.63,1030.99,7219.58,WellsFargo1,70,1
1,7219.58,1084.62,46.93,1037.69,6181.89,WellsFargo1,70,1
2,6181.89,1084.62,40.18,1044.44,5137.45,WellsFargo1,70,1
3,5137.45,1084.62,33.39,1051.23,4086.22,WellsFargo1,70,1
4,4086.22,1084.62,26.56,1058.06,3028.16,WellsFargo1,70,1
5,3028.16,1084.62,19.68,1064.94,1963.22,WellsFargo1,70,1
6,1963.22,1084.62,12.76,1071.86,891.36,WellsFargo1,70,1
7,891.36,1084.62,5.79,1078.83,-187.47,WellsFargo1,70,1
0,180000.0,1331.44,594.0,737.44,179262.56,mortgage,70,2
1,179262.56,1331.44,591.57,739.87,178522.69,mortgage,70,2
2,178522.69,1331.44,589.12,742.32,177780.37,mortgage,70,2
3,177780.37,1331.44,586.68,744.76,177035.61,mortgage,70,2
4,177035.61,1331.44,584.22,747.22,176288.39,mortgage,70,2
5,176288.39,1331.44,581.75,749.69,175538.7,mortgage,70,2
6,175538.7,1331.44,579.28,752.16,174786.54,mortgage,70,2
7,174786.54,1518.91,576.8,942.11,173844.43,mortgage,70,2
8,173844.43,2416.06,573.69,1842.37,172002.06,mortgage,70,2
9,172002.06,2416.06,567.61,1848.45,170153.61,mortgage,70,2
10,170153.61,2416.06,561.51,1854.55,168299.06,mortgage,70,2
11,168299.06,2416.06,555.39,1860.67,166438.39,mortgage,70,2
12,166438.39,2416.06,549.25,1866.81,164571.58,mortgage,70,2
13,164571.58,2416.06,543.09,1872.97,162698.61,mortgage,70,2
14,162698.61,2416.06,536.91,1879.15,160819.46,mortgage,70,2
15,160819.46,2416.06,530.7,1885.36,158934.1,mortgage,70,2
16,158934.1,2416.06,524.48,1891.58,157042.52,mortgage,70,2
17,157042.52,2416.06,518.24,1897.82,155144.7,mortgage,70,2
18,155144.7,2416.06,511.98,1904.08,153240.62,mortgage,70,2
19,153240.62,2416.06,505.69,1910.37,151330.25,mortgage,70,2
20,151330.25,2416.06,499.39,1916.67,149413.58,mortgage,70,2
21,149413.58,2416.06,493.06,1923.0,147490.58,mortgage,70,2
22,147490.58,2416.06,486.72,1929.34,145561.24,mortgage,70,2
23,145561.24,2416.06,480.35,1935.71,143625.53,mortgage,70,2
24,143625.53,2416.06,473.96,1942.1,141683.43,mortgage,70,2
25,141683.43,2416.06,467.56,1948.5,139734.93,mortgage,70,2
26,139734.93,2416.06,461.13,1954.93,137780.0,mortgage,70,2
27,137780.0,2416.06,454.67,1961.39,135818.61,mortgage,70,2
28,135818.61,2416.06,448.2,1967.86,133850.75,mortgage,70,2
29,133850.75,2416.06,441.71,1974.35,131876.4,mortgage,70,2
30,131876.4,2416.06,435.19,1980.87,129895.53,mortgage,70,2
31,129895.53,2416.06,428.66,1987.4,127908.13,mortgage,70,2
32,127908.13,2416.06,422.1,1993.96,125914.17,mortgage,70,2
33,125914.17,2416.06,415.52,2000.54,123913.63,mortgage,70,2
34,123913.63,2416.06,408.91,2007.15,121906.48,mortgage,70,2
35,121906.48,2416.06,402.29,2013.77,119892.71,mortgage,70,2
36,119892.71,2416.06,395.65,2020.41,117872.3,mortgage,70,2
37,117872.3,2416.06,388.98,2027.08,115845.22,mortgage,70,2
38,115845.22,2416.06,382.29,2033.77,113811.45,mortgage,70,2
39,113811.45,2416.06,375.58,2040.48,111770.97,mortgage,70,2
40,111770.97,2416.06,368.84,2047.22,109723.75,mortgage,70,2
41,109723.75,2416.06,362.09,2053.97,107669.78,mortgage,70,2
42,107669.78,2416.06,355.31,2060.75,105609.03,mortgage,70,2
43,105609.03,2416.06,348.51,2067.55,103541.48,mortgage,70,2
44,103541.48,2416.06,341.69,2074.37,101467.11,mortgage,70,2
45,101467.11,2416.06,334.84,2081.22,99385.89,mortgage,70,2
46,99385.89,2416.06,327.97,2088.09,97297.8,mortgage,70,2
47,97297.8,2416.06,321.08,2094.98,95202.82,mortgage,70,2
48,95202.82,2416.06,314.17,2101.89,93100.93,mortgage,70,2
49,93100.93,2416.06,307.23,2108.83,90992.1,mortgage,70,2
50,90992.1,2416.06,300.27,2115.79,88876.31,mortgage,70,2
51,88876.31,2416.06,293.29,2122.77,86753.54,mortgage,70,2
52,86753.54,2416.06,286.29,2129.77,84623.77,mortgage,70,2
53,84623.77,2416.06,279.26,2136.8,82486.97,mortgage,70,2
54,82486.97,2416.06,272.21,2143.85,80343.12,mortgage,70,2
55,80343.12,2416.06,265.13,2150.93,78192.19,mortgage,70,2
56,78192.19,2416.06,258.03,2158.03,76034.16,mortgage,70,2
57,76034.16,2416.06,250.91,2165.15,73869.01,mortgage,70,2
58,73869.01,2416.06,243.77,2172.29,71696.72,mortgage,70,2
59,71696.72,2416.06,236.6,2179.46,69517.26,mortgage,70,2
60,69517.26,2416.06,229.41,2186.65,67330.61,mortgage,70,2
61,67330.61,2416.06,222.19,2193.87,65136.74,mortgage,70,2
62,65136.74,2416.06,214.95,2201.11,62935.63,mortgage,70,2
63,62935.63,2416.06,207.69,2208.37,60727.26,mortgage,70,2
64,60727.26,2416.06,200.4,2215.66,58511.6,mortgage,70,2
65,58511.6,2416.06,193.09,2222.97,56288.63,mortgage,70,2
66,56288.63,2416.06,185.75,2230.31,54058.32,mortgage,70,2
67,54058.32,2416.06,178.39,2237.67,51820.65,mortgage,70,2
68,51820.65,2416.06,171.01,2245.05,49575.6,mortgage,70,2
69,49575.6,2416.06,163.6,2252.46,47323.14,mortgage,70,2
70,47323.14,2416.06,156.17,2259.89,45063.25,mortgage,70,2
71,45063.25,2416.06,148.71,2267.35,42795.9,mortgage,70,2
72,42795.9,2416.06,141.23,2274.83,40521.07,mortgage,70,2
73,40521.07,2416.06,133.72,2282.34,38238.73,mortgage,70,2
74,38238.73,2416.06,126.19,2289.87,35948.86,mortgage,70,2
75,35948.86,2416.06,118.63,2297.43,33651.43,mortgage,70,2
76,33651.43,2416.06,111.05,2305.01,31346.42,mortgage,70,2
77,31346.42,2416.06,103.44,2312.62,29033.8,mortgage,70,2
78,29033.8,2416.06,95.81,2320.25,26713.55,mortgage,70,2
79,26713.55,2416.06,88.15,2327.91,24385.64,mortgage,70,2
80,24385.64,2416.06,80.47,2335.59,22050.05,mortgage,70,2
81,22050.05,2416.06,72.77,2343.29,19706.76,mortgage,70,2
82,19706.76,2416.06,65.03,2351.03,17355.73,mortgage,70,2
83,17355.73,2416.06,57.27,2358.79,14996.94,mortgage,70,2
84,14996.94,2416.06,49.49,2366.57,12630.37,mortgage,70,2
85,12630.37,2416.06,41.68,2374.38,10255.99,mortgage,70,2
86,10255.99,2416.06,33.84,2382.22,7873.77,mortgage,70,2
87,7873.77,2416.06,25.98,2390.08,5483.69,mortgage,70,2
88,5483.69,2416.06,18.1,2397.96,3085.73,mortgage,70,2
89,3085.73,2416.06,10.18,2405.88,679.85,mortgage,70,2
90,679.85,2416.06,2.24,2413.82,-1733.97,mortgage,70,2
0,5000.0,333.0,36.0,297.0,4703.0,Car,70,3
1,4703.0,333.0,33.86,299.14,4403.86,Car,70,3
2,4403.86,333.0,31.71,301.29,4102.57,Car,70,3
3,4102.57,333.0,29.54,303.46,3799.11,Car,70,3
4,3799.11,333.0,27.35,305.65,3493.46,Car,70,3
5,3493.46,333.0,25.15,307.85,3185.61,Car,70,3
6,3185.61,333.0,22.94,310.06,2875.55,Car,70,3
7,2875.55,333.0,20.7,312.3,2563.25,Car,70,3
8,2563.25,333.0,18.46,314.54,2248.71,Car,70,3
9,2248.71,333.0,16.19,316.81,1931.9,Car,70,3
10,1931.9,333.0,13.91,319.09,1612.81,Car,70,3
11,1612.81,333.0,11.61,321.39,1291.42,Car,70,3
12,1291.42,333.0,9.3,323.7,967.72,Car,70,3
13,967.72,333.0,6.97,326.03,641.69,Car,70,3
14,641.69,333.0,4.62,328.38,313.31,Car,70,3
15,313.31,333.0,2.26,330.74,-17.43,Car,70,3
0,20000.0,191.04,108.0,83.04,19916.96,WellsFargo2,70,4
1,19916.96,191.04,107.55,83.49,19833.47,WellsFargo2,70,4
2,19833.47,191.04,107.1,83.94,19749.53,WellsFargo2,70,4
3,19749.53,191.04,106.65,84.39,19665.14,WellsFargo2,70,4
4,19665.14,191.04,106.19,84.85,19580.29,WellsFargo2,70,4
5,19580.29,191.04,105.73,85.31,19494.98,WellsFargo2,70,4
6,19494.98,191.04,105.27,85.77,19409.21,WellsFargo2,70,4
7,19409.21,191.04,104.81,86.23,19322.98,WellsFargo2,70,4
8,19322.98,191.04,104.34,86.7,19236.28,WellsFargo2,70,4
9,19236.28,191.04,103.88,87.16,19149.12,WellsFargo2,70,4
10,19149.12,191.04,103.41,87.63,19061.49,WellsFargo2,70,4
11,19061.49,191.04,102.93,88.11,18973.38,WellsFargo2,70,4
12,18973.38,191.04,102.46,88.58,18884.8,WellsFargo2,70,4
13,18884.8,191.04,101.98,89.06,18795.74,WellsFargo2,70,4
14,18795.74,191.04,101.5,89.54,18706.2,WellsFargo2,70,4
15,18706.2,208.47,101.01,107.46,18598.74,WellsFargo2,70,4
16,18598.74,2940.1,100.43,2839.67,15759.07,WellsFargo2,70,4
17,15759.07,2940.1,85.1,2855.0,12904.07,WellsFargo2,70,4
18,12904.07,2940.1,69.68,2870.42,10033.65,WellsFargo2,70,4
19,10033.65,2940.1,54.18,2885.92,7147.73,WellsFargo2,70,4
20,7147.73,2940.1,38.6,2901.5,4246.23,WellsFargo2,70,4
21,4246.23,2940.1,22.93,2917.17,1329.06,WellsFargo2,70,4
22,1329.06,2940.1,7.18,2932.92,-1603.86,WellsFargo2,70,4
0,4000.0,70.0,16.0,54.0,3946.0,testing,70,5
1,3946.0,70.0,15.78,54.22,3891.78,testing,70,5
2,3891.78,70.0,15.57,54.43,3837.35,testing,70,5
3,3837.35,70.0,15.35,54.65,3782.7,testing,70,5
4,3782.7,70.0,15.13,54.87,3727.83,testing,70,5
5,3727.83,70.0,14.91,55.09,3672.74,testing,70,5
6,3672.74,70.0,14.69,55.31,3617.43,testing,70,5
7,3617.43,70.0,14.47,55.53,3561.9,testing,70,5
8,3561.9,70.0,14.25,55.75,3506.15,testing,70,5
9,3506.15,70.0,14.02,55.98,3450.17,testing,70,5
10,3450.17,70.0,13.8,56.2,3393.97,testing,70,5
11,3393.97,70.0,13.58,56.42,3337.55,testing,70,5
12,3337.55,70.0,13.35,56.65,3280.9,testing,70,5
13,3280.9,70.0,13.12,56.88,3224.02,testing,70,5
14,3224.02,70.0,12.9,57.1,3166.92,testing,70,5
15,3166.92,70.0,12.67,57.33,3109.59,testing,70,5
16,3109.59,70.0,12.44,57.56,3052.03,testing,70,5
17,3052.03,70.0,12.21,57.79,2994.24,testing,70,5
18,2994.24,70.0,11.98,58.02,2936.22,testing,70,5
19,2936.22,70.0,11.74,58.26,2877.96,testing,70,5
20,2877.96,70.0,11.51,58.49,2819.47,testing,70,5
21,2819.47,70.0,11.28,58.72,2760.75,testing,70,5
22,2760.75,1673.86,11.04,1662.82,1097.93,testing,70,5
23,1097.93,3010.1,4.39,3005.71,-1907.78,testing,70,5
0,8250.57,1084.62,53.63,1030.99,7219.58,WellsFargo1,71,1
1,7219.58,1084.62,46.93,1037.69,6181.89,WellsFargo1,71,1
2,6181.89,1084.62,40.18,1044.44,5137.45,WellsFargo1,71,1
3,5137.45,1084.62,33.39,1051.23,4086.22,WellsFargo1,71,1
4,4086.22,1084.62,26.56,1058.06,3028.16,WellsFargo1,71,1
5,3028.16,1084.62,19.68,1064.94,1963.22,WellsFargo1,71,1
6,1963.22,1084.62,12.76,1071.86,891.36,WellsFargo1,71,1
7,891.36,1084.62,5.79,1078.83,-187.47,WellsFargo1,71,1
0,180000.0,1331.44,594.0,737.44,179262.56,mortgage,71,2
1,179262.56,1331.44,591.57,739.87,178522.69,mortgage,71,2
2,178522.69,1331.44,589.12,742.32,177780.37,mortgage,71,2
3,177780.37,1331.44,586.68,744.76,177035.61,mortgage,71,2
4,177035.61,1331.44,584.22,747.22,176288.39,mortgage,71,2
5,176288.39,1331.44,581.75,749.69,175538.7,mortgage,71,2
6,175538.7,1331.44,579.28,752.16,174786.54,mortgage,71,2
7,174786.54,1518.91,576.8,942.11,173844.43,mortgage,71,2
8,173844.43,2416.06,573.69,1842.37,172002.06,mortgage,71,2
9,172002.06,2416.06,567.61,1848.45,170153.61,mortgage,71,2
10,170153.61,2416.06,561.51,1854.55,168299.06,mortgage,71,2
11,168299.06,2416.06,555.39,1860.67,166438.39,mortgage,71,2
12,166438.39,2416.06,549.25,1866.81,164571.58,mortgage,71,2
13,164571.58,2416.06,543.09,1872.97,162698.61,mortgage,71,2
14,162698.61,2416.06,536.91,1879.15,160819.46,mortgage,71,2
15,160819.46,2416.06,530.7,1885.36,158934.1,mortgage,71,2
16,158934.1,2416.06,524.48,1891.58,157042.52,mortgage,71,2
17,157042.52,2416.06,518.24,1897.82,155144.7,mortgage,71,2
18,155144.7,2416.06,511.98,1904.08,153240.62,mortgage,71,2
19,153240.62,2416.06,505.69,1910.37,151330.25,mortgage,71,2
20,151330.25,2416.06,499.39,1916.67,149413.58,mortgage,71,2
21,149413.58,2416.06,493.06,1923.0,147490.58,mortgage,71,2
22,147490.58,2416.06,486.72,1929.34,145561.24,mortgage,71,2
23,145561.24,2416.06,480.35,1935.71,143625.53,mortgage,71,2
24,143625.53,2416.06,473.96,1942.1,141683.43,mortgage,71,2
25,141683.43,2416.06,467.56,1948.5,139734.93,mortgage,71,2
26,139734.93,2416.06,461.13,1954.93,137780.0,mortgage,71,2
27,137780.0,2416.06,454.67,1961.39,135818.61,mortgage,71,2
28,135818.61,2416.06,448.2,1967.86,133850.75,mortgage,71,2
29,133850.75,2416.06,441.71,1974.35,131876.4,mortgage,71,2
30,131876.4,2416.06,435.19,1980.87,129895.53,mortgage,71,2
31,129895.53,2416.06,428.66,1987.4,127908.13,mortgage,71,2
32,127908.13,2416.06,422.1,1993.96,125914.17,mortgage,71,2
33,125914.17,2416.06,415.52,2000.54,123913.63,mortgage,71,2
34,123913.63,2416.06,408.91,2007.15,121906.48,mortgage,71,2
35,121906.48,2416.06,402.29,2013.77,119892.71,mortgage,71,2
36,119892.71,2416.06,395.65,2020.41,117872.3,mortgage,71,2
37,117872.3,2416.06,388.98,2027.08,115845.22,mortgage,71,2
38,115845.22,2416.06,382.29,2033.77,113811.45,mortgage,71,2
39,113811.45,2416.06,375.58,2040.48,111770.97,mortgage,71,2
40,111770.97,2416.06,368.84,2047.22,109723.75,mortgage,71,2
41,109723.75,2416.06,362.09,2053.97,107669.78,mortgage,71,2
42,107669.78,2416.06,355.31,2060.75,105609.03,mortgage,71,2
43,105609.03,2416.06,348.51,2067.55,103541.48,mortgage,71,2
44,103541.48,2416.06,341.69,2074.37,101467.11,mortgage,71,2
45,101467.11,2416.06,334.84,2081.22,99385.89,mortgage,71,2
46,99385.89,2416.06,327.97,2088.09,97297.8,mortgage,71,2
47,97297.8,2416.06,321.08,2094.98,95202.82,mortgage,71,2
48,95202.82,2416.06,314.17,2101.89,93100.93,mortgage,71,2
49,93100.93,2416.06,307.23,2108.83,90992.1,mortgage,71,2
50,90992.1,2416.06,300.27,2115.79,88876.31,mortgage,71,2
51,88876.31,2416.06,293.29,2122.77,86753.54,mortgage,71,2
52,86753.54,2416.06,286.29,2129.77,84623.77,mortgage,71,2
53,84623.77,2416.06,279.26,2136.8,82486.97,mortgage,71,2
54,82486.97,2416.06,272.21,2143.85,80343.12,mortgage,71,2
55,80343.12,2416.06,265.13,2150.93,78192.19,mortgage,71,2
56,78192.19,2416.06,258.03,2158.03,76034.16,mortgage,71,2
57,76034.16,2416.06,250.91,2165.15,73869.01,mortgage,71,2
58,73869.01,2416.06,243.77,2172.29,71696.72,mortgage,71,2
59,71696.72,2416.06,236.6,2179.46,69517.26,mortgage,71,2
60,69517.26,2416.06,229.41,2186.65,67330.61,mortgage,71,2
61,67330.61,2416.06,222.19,2193.87,65136.74,mortgage,71,2
62,65136.74,2416.06,214.95,2201.11,62935.63,mortgage,71,2
63,62935.63,2416.06,207.69,2208.37,60727.26,mortgage,71,2
64,60727.26,2416.06,200.4,2215.66,58511.6,mortgage,71,2
65,58511.6,2416.06,193.09,2222.97,56288.63,mortgage,71,2
66,56288.63,2416.06,185.75,2230.31,54058.32,mortgage,71,2
67,54058.32,2416.06,178.39,2237.67,51820.65,mortgage,71,2
68,51820.65,2416.06,171.01,2245.05,49575.6,mortgage,71,2
69,49575.6,2416.06,163.6,2252.46,47323.14,mortgage,71,2
70,47323.14,2416.06,156.17,2259.89,45063.25,mortgage,71,2
71,45063.25,2416.06,148.71,2267.35,42795.9,mortgage,71,2
72,42795.9,2416.06,141.23,2274.83,40521.07,mortgage,71,2
73,40521.07,2416.06,133.72,2282.34,38238.73,mortgage,71,2
74,38238.73,2416.06,126.19,2289.87,35948.86,mortgage,71,2
75,35948.86,2416.06,118.63,2297.43,33651.43,mortgage,71,2
76,33651.43,2416.06,111.05,2305.01,31346.42,mortgage,71,2
77,31346.42,2416.06,103.44,2312.62,29033.8,mortgage,71,2
78,29033.8,2416.06,95.81,2320.25,26713.55,mortgage,71,2
79,26713.55,2416.06,88.15,2327.91,24385.64,mortgage,71,2
80,24385.64,2416.06,80.47,2335.59,22050.05,mortgage,71,2
81,22050.05,2416.06,72.77,2343.29,19706.76,mortgage,71,2
82,19706.76,2416.06,65.03,2351.03,17355.73,mortgage,71,2
83,17355.73,2416.06,57.27,2358.79,14996.94,mortgage,71,2
84,14996.94,2416.06,49.49,2366.57,12630.37,mortgage,71,2
85,12630.37,2416.06,41.68,2374.38,10255.99,mortgage,71,2
86,10255.99,2416.06,33.84,2382.22,7873.77,mortgage,71,2
87,7873.77,2416.06,25.98,2390.08,5483.69,mortgage,71,2
88,5483.69,2416.06,18.1,2397.96,3085.73,mortgage,71,2
89,3085.73,2416.06,10.18,2405.88,679.85,mortgage,71,2
90,679.85,2416.06,2.24,2413.82,-1733.97,mortgage,71,2
0,20000.0,191.04,108.0,83.04,19916.96,WellsFargo2,71,3
1,19916.96,191.04,107.55,83.49,19833.47,WellsFargo2,71,3
2,19833.47,191.04,107.1,83.94,19749.53,WellsFargo2,71,3
3,19749.53,191.04,106.65,84.39,19665.14,WellsFargo2,71,3
4,19665.14,191.04,106.19,84.85,19580.29,WellsFargo2,71,3
5,19580.29,191.04,105.73,85.31,19494.98,WellsFargo2,71,3
6,19494.98,191.04,105.27,85.77,19409.21,WellsFargo2,71,3
7,19409.21,191.04,104.81,86.23,19322.98,WellsFargo2,71,3
8,19322.98,191.04,104.34,86.7,19236.28,WellsFargo2,71,3
9,19236.28,191.04,103.88,87.16,19149.12,WellsFargo2,71,3
10,19149.12,191.04,103.41,87.63,19061.49,WellsFargo2,71,3
11,19061.49,191.04,102.93,88.11,18973.38,WellsFargo2,71,3
12,18973.38,191.04,102.46,88.58,18884.8,WellsFargo2,71,3
13,18884.8,191.04,101.98,89.06,18795.74,WellsFargo2,71,3
14,18795.74,191.04,101.5,89.54,18706.2,WellsFargo2,71,3
15,18706.2,191.04,101.01,90.03,18616.17,WellsFargo2,71,3
16,18616.17,191.04,100.53,90.51,18525.66,WellsFargo2,71,3
17,18525.66,191.04,100.04,91.0,18434.66,WellsFargo2,71,3
18,18434.66,191.04,99.55,91.49,18343.17,WellsFargo2,71,3
19,18343.17,191.04,99.05,91.99,18251.18,WellsFargo2,71,3
20,18251.18,191.04,98.56,92.48,18158.7,WellsFargo2,71,3
21,18158.7,191.04,98.06,92.98,18065.72,WellsFargo2,71,3
22,18065.72,191.04,97.55,93.49,17972.23,WellsFargo2,71,3
23,17972.23,191.04,97.05,93.99,17878.24,WellsFargo2,71,3
24,17878.24,191.04,96.54,94.5,17783.74,WellsFargo2,71,3
25,17783.74,191.04,96.03,95.01,17688.73,WellsFargo2,71,3
26,17688.73,191.04,95.52,95.52,17593.21,WellsFargo2,71,3
27,17593.21,191.04,95.0,96.04,17497.17,WellsFargo2,71,3
28,17497.17,191.04,94.48,96.56,17400.61,WellsFargo2,71,3
29,17400.61,191.04,93.96,97.08,17303.53,WellsFargo2,71,3
30,17303.53,191.04,93.44,97.6,17205.93,WellsFargo2,71,3
31,17205.93,191.04,92.91,98.13,17107.8,WellsFargo2,71,3
32,17107.8,191.04,92.38,98.66,17009.14,WellsFargo2,71,3
33,17009.14,191.04,91.85,99.19,16909.95,WellsFargo2,71,3
34,16909.95,191.04,91.31,99.73,16810.22,WellsFargo2,71,3
35,16810.22,191.04,90.78,100.26,16709.96,WellsFargo2,71,3
36,16709.96,191.04,90.23,100.81,16609.15,WellsFargo2,71,3
37,16609.15,191.04,89.69,101.35,16507.8,WellsFargo2,71,3
38,16507.8,191.04,89.14,101.9,16405.9,WellsFargo2,71,3
39,16405.9,191.04,88.59,102.45,16303.45,WellsFargo2,71,3
40,16303.45,191.04,88.04,103.0,16200.45,WellsFargo2,71,3
41,16200.45,191.04,87.48,103.56,16096.89,WellsFargo2,71,3
42,16096.89,191.04,86.92,104.12,15992.77,WellsFargo2,71,3
43,15992.77,191.04,86.36,104.68,15888.09,WellsFargo2,71,3
44,15888.09,191.04,85.8,105.24,15782.85,WellsFargo2,71,3
45,15782.85,191.04,85.23,105.81,15677.04,WellsFargo2,71,3
46,15677.04,191.04,84.66,106.38,15570.66,WellsFargo2,71,3
47,15570.66,191.04,84.08,106.96,15463.7,WellsFargo2,71,3
48,15463.7,191.04,83.5,107.54,15356.16,WellsFargo2,71,3
49,15356.16,191.04,82.92,108.12,15248.04,WellsFargo2,71,3
50,15248.04,191.04,82.34,108.7,15139.34,WellsFargo2,71,3
51,15139.34,191.04,81.75,109.29,15030.05,WellsFargo2,71,3
52,15030.05,191.04,81.16,109.88,14920.17,WellsFargo2,71,3
53,14920.17,191.04,80.57,110.47,14809.7,WellsFargo2,71,3
54,14809.7,191.04,79.97,111.07,14698.63,WellsFargo2,71,3
55,14698.63,191.04,79.37,111.67,14586.96,WellsFargo2,71,3
56,14586.96,191.04,78.77,112.27,14474.69,WellsFargo2,71,3
57,14474.69,191.04,78.16,112.88,14361.81,WellsFargo2,71,3
58,14361.81,191.04,77.55,113.49,14248.32,WellsFargo2,71,3
59,14248.32,191.04,76.94,114.1,14134.22,WellsFargo2,71,3
60,14134.22,191.04,76.32,114.72,14019.5,WellsFargo2,71,3
61,14019.5,191.04,75.71,115.33,13904.17,WellsFargo2,71,3
62,13904.17,191.04,75.08,115.96,13788.21,WellsFargo2,71,3
63,13788.21,191.04,74.46,116.58,13671.63,WellsFargo2,71,3
64,13671.63,191.04,73.83,117.21,13554.42,WellsFargo2,71,3
65,13554.42,191.04,73.19,117.85,13436.57,WellsFargo2,71,3
66,13436.57,191.04,72.56,118.48,13318.09,WellsFargo2,71,3
67,13318.09,191.04,71.92,119.12,13198.97,WellsFargo2,71,3
68,13198.97,191.04,71.27,119.77,13079.2,WellsFargo2,71,3
69,13079.2,191.04,70.63,120.41,12958.79,WellsFargo2,71,3
70,12958.79,191.04,69.98,121.06,12837.73,WellsFargo2,71,3
71,12837.73,191.04,69.32,121.72,12716.01,WellsFargo2,71,3
72,12716.01,191.04,68.67,122.37,12593.64,WellsFargo2,71,3
73,12593.64,191.04,68.01,123.03,12470.61,WellsFargo2,71,3
74,12470.61,191.04,67.34,123.7,12346.91,WellsFargo2,71,3
75,12346.91,191.04,66.67,124.37,12222.54,WellsFargo2,71,3
76,12222.54,191.04,66.0,125.04,12097.5,WellsFargo2,71,3
77,12097.5,191.04,65.33,125.71,11971.79,WellsFargo2,71,3
78,11971.79,191.04,64.65,126.39,11845.4,WellsFargo2,71,3
79,11845.4,191.04,63.97,127.07,11718.33,WellsFargo2,71,3
80,11718.33,191.04,63.28,127.76,11590.57,WellsFargo2,71,3
81,11590.57,191.04,62.59,128.45,11462.12,WellsFargo2,71,3
82,11462.12,191.04,61.9,129.14,11332.98,WellsFargo2,71,3
83,11332.98,191.04,61.2,129.84,11203.14,WellsFargo2,71,3
84,11203.14,191.04,60.5,130.54,11072.6,WellsFargo2,71,3
85,11072.6,191.04,59.79,131.25,10941.35,WellsFargo2,71,3
86,10941.35,191.04,59.08,131.96,10809.39,WellsFargo2,71,3
87,10809.39,191.04,58.37,132.67,10676.72,WellsFargo2,71,3
88,10676.72,191.04,57.65,133.39,10543.33,WellsFargo2,71,3
89,10543.33,191.04,56.93,134.11,10409.22,WellsFargo2,71,3
90,10409.22,1925.01,56.21,1868.8,8540.42,WellsFargo2,71,3
91,8540.42,2607.1,46.12,2560.98,5979.44,WellsFargo2,71,3
92,5979.44,2607.1,32.29,2574.81,3404.63,WellsFargo2,71,3
93,3404.63,2607.1,18.39,2588.71,815.92,WellsFargo2,71,3
94,815.92,2607.1,4.41,2602.69,-1786.77,WellsFargo2,71,3
0,4000.0,70.0,16.0,54.0,3946.0,testing,71,4
1,3946.0,70.0,15.78,54.22,3891.78,testing,71,4
2,3891.78,70.0,15.57,54.43,3837.35,testing,71,4
3,3837.35,70.0,15.35,54.65,3782.7,testing,71,4
4,3782.7,70.0,15.13,54.87,3727.83,testing,71,4
5,3727.83,70.0,14.91,55.09,3672.74,testing,71,4
6,3672.74,70.0,14.69,55.31,3617.43,testing,71,4
7,3617.43,70.0,14.47,55.53,3561.9,testing,71,4
8,3561.9,70.0,14.25,55.75,3506.15,testing,71,4
9,3506.15,70.0,14.02,55.98,3450.17,testing,71,4
10,3450.17,70.0,13.8,56.2,3393.97,testing,71,4
11,3393.97,70.0,13.58,56.42,3337.55,testing,71,4
12,3337.55,70.0,13.35,56.65,3280.9,testing,71,4
13,3280.9,70.0,13.12,56.88,3224.02,testing,71,4
14,3224.02,70.0,12.9,57.1,3166.92,testing,71,4
15,3166.92,70.0,12.67,57.33,3109.59,testing,71,4
16,3109.59,70.0,12.44,57.56,3052.03,testing,71,4
17,3052.03,70.0,12.21,57.79,2994.24,testing,71,4
18,2994.24,70.0,11.98,58.02,2936.22,testing,71,4
19,2936.22,70.0,11.74,58.26,2877.96,testing,71,4
20,2877.96,70.0,11.51,58.49,2819.47,testing,71,4
21,2819.47,70.0,11.28,58.72,2760.75,testing,71,4
22,2760.75,70.0,11.04,58.96,2701.79,testing,71,4
23,2701.79,70.0,10.81,59.19,2642.6,testing,71,4
24,2642.6,70.0,10.57,59.43,2583.17,testing,71,4
25,2583.17,70.0,10.33,59.67,2523.5,testing,71,4
26,2523.5,70.0,10.09,59.91,2463.59,testing,71,4
27,2463.59,70.0,9.85,60.15,2403.44,testing,71,4
28,2403.44,70.0,9.61,60.39,2343.05,testing,71,4
29,2343.05,70.0,9.37,60.63,2282.42,testing,71,4
30,2282.42,70.0,9.13,60.87,2221.55,testing,71,4
31,2221.55,70.0,8.89,61.11,2160.44,testing,71,4
32,2160.44,70.0,8.64,61.36,2099.08,testing,71,4
33,2099.08,70.0,8.4,61.6,2037.48,testing,71,4
34,2037.48,70.0,8.15,61.85,1975.63,testing,71,4
35,1975.63,70.0,7.9,62.1,1913.53,testing,71,4
36,1913.53,70.0,7.65,62.35,1851.18,testing,71,4
37,1851.18,70.0,7.4,62.6,1788.58,testing,71,4
38,1788.58,70.0,7.15,62.85,1725.73,testing,71,4
39,1725.73,70.0,6.9,63.1,1662.63,testing,71,4
40,1662.63,70.0,6.65,63.35,1599.28,testing,71,4
41,1599.28,70.0,6.4,63.6,1535.68,testing,71,4
42,1535.68,70.0,6.14,63.86,1471.82,testing,71,4
43,1471.82,70.0,5.89,64.11,1407.71,testing,71,4
44,1407.71,70.0,5.63,64.37,1343.34,testing,71,4
45,1343.34,70.0,5.37,64.63,1278.71,testing,71,4
46,1278.71,70.0,5.11,64.89,1213.82,testing,71,4
47,1213.82,70.0,4.86,65.14,1148.68,testing,71,4
48,1148.68,70.0,4.59,65.41,1083.27,testing,71,4
49,1083.27,70.0,4.33,65.67,1017.6,testing,71,4
50,1017.6,70.0,4.07,65.93,951.67,testing,71,4
51,951.67,70.0,3.81,66.19,885.48,testing,71,4
52,885.48,70.0,3.54,66.46,819.02,testing,71,4
53,819.02,70.0,3.28,66.72,752.3,testing,71,4
54,752.3,70.0,3.01,66.99,685.31,testing,71,4
55,685.31,70.0,2.74,67.26,618.05,testing,71,4
56,618.05,70.0,2.47,67.53,550.52,testing,71,4
57,550.52,70.0,2.2,67.8,482.72,testing,71,4
58,482.72,70.0,1.93,68.07,414.65,testing,71,4
59,414.65,70.0,1.66,68.34,346.31,testing,71,4
60,346.31,70.0,1.39,68.61,277.7,testing,71,4
61,277.7,70.0,1.11,68.89,208.81,testing,71,4
62,208.81,70.0,0.84,69.16,139.65,testing,71,4
63,139.65,70.0,0.56,69.44,70.21,testing,71,4
64,70.21,70.0,0.28,69.72,0.49,testing,71,4
65,0.49,70.0,0.0,70.0,-69.51,testing,71,4
0,5000.0,333.0,36.0,297.0,4703.0,Car,71,5
1,4703.0,333.0,33.86,299.14,4403.86,Car,71,5
2,4403.86,333.0,31.71,301.29,4102.57,Car,71,5
3,4102.57,333.0,29.54,303.46,3799.11,Car,71,5
4,3799.11,333.0,27.35,305.65,3493.46,Car,71,5
5,3493.46,333.0,25.15,307.85,3185.61,Car,71,5
6,3185.61,333.0,22.94,310.06,2875.55,Car,71,5
7,2875.55,333.0,20.7,312.3,2563.25,Car,71,5
8,2563.25,333.0,18.46,314.54,2248.71,Car,71,5
9,2248.71,333.0,16.19,316.81,1931.9,Car,71,5
10,1931.9,333.0,13.91,319.09,1612.81,Car,71,5
11,1612.81,333.0,11.61,321.39,1291.42,Car,71,5
12,1291.42,333.0,9.3,323.7,967.72,Car,71,5
13,967.72,333.0,6.97,326.03,641.69,Car,71,5
14,641.69,333.0,4.62,328.38,313.31,Car,71,5
15,313.31,333.0,2.26,330.74,-17.43,Car,71,5
0,8250.57,1084.62,53.63,1030.99,7219.58,WellsFargo1,72,1
1,7219.58,1084.62,46.93,1037.69,6181.89,WellsFargo1,72,1
2,6181.89,1084.62,40.18,1044.44,5137.45,WellsFargo1,72,1
3,5137.45,1084.62,33.39,1051.23,4086.22,WellsFargo1,72,1
4,4086.22,1084.62,26.56,1058.06,3028.16,WellsFargo1,72,1
5,3028.16,1084.62,19.68,1064.94,1963.22,WellsFargo1,72,1
6,1963.22,1084.62,12.76,1071.86,891.36,WellsFargo1,72,1
7,891.36,1084.62,5.79,1078.83,-187.47,WellsFargo1,72,1
0,180000.0,1331.44,594.0,737.44,179262.56,mortgage,72,2
1,179262.56,1331.44,591.57,739.87,178522.69,mortgage,72,2
2,178522.69,1331.44,589.12,742.32,177780.37,mortgage,72,2
3,177780.37,1331.44,586.68,744.76,177035.61,mortgage,72,2
4,177035.61,1331.44,584.22,747.22,176288.39,mortgage,72,2
5,176288.39,1331.44,581.75,749.69,175538.7,mortgage,72,2
6,175538.7,1331.44,579.28,752.16,174786.54,mortgage,72,2
7,174786.54,1518.91,576.8,942.11,173844.43,mortgage,72,2
8,173844.43,2416.06,573.69,1842.37,172002.06,mortgage,72,2
9,172002.06,2416.06,567.61,1848.45,170153.61,mortgage,72,2
10,170153.61,2416.06,561.51,1854.55,168299.06,mortgage,72,2
11,168299.06,2416.06,555.39,1860.67,166438.39,mortgage,72,2
12,166438.39,2416.06,549.25,1866.81,164571.58,mortgage,72,2
13,164571.58,2416.06,543.09,1872.97,162698.61,mortgage,72,2
14,162698.61,2416.06,536.91,1879.15,160819.46,mortgage,72,2
15,160819.46,2416.06,530.7,1885.36,158934.1,mortgage,72,2
16,158934.1,2416.06,524.48,1891.58,157042.52,mortgage,72,2
17,157042.52,2416.06,518.24,1897.82,155144.7,mortgage,72,2
18,155144.7,2416.06,511.98,1904.08,153240.62,mortgage,72,2
19,153240.62,2416.06,505.69,1910.37,151330.25,mortgage,72,2
20,151330.25,2416.06,499.39,1916.67,149413.58,mortgage,72,2
21,149413.58,2416.06,493.06,1923.0,147490.58,mortgage,72,2
22,147490.58,2416.06,486.72,1929.34,145561.24,mortgage,72,2
23,145561.24,2416.06,480.35,1935.71,143625.53,mortgage,72,2
24,143625.53,2416.06,473.96,1942.1,141683.43,mortgage,72,2
25,141683.43,2416.06,467.56,1948.5,139734.93,mortgage,72,2
26,139734.93,2416.06,461.13,1954.93,137780.0,mortgage,72,2
27,137780.0,2416.06,454.67,1961.39,135818.61,mortgage,72,2
28,135818.61,2416.06,448.2,1967.86,133850.75,mortgage,72,2
29,133850.75,2416.06,441.71,1974.35,131876.4,mortgage,72,2
30,131876.4,2416.06,435.19,1980.87,129895.53,mortgage,72,2
31,129895.53,2416.06,428.66,1987.4,127908.13,mortgage,72,2
32,127908.13,2416.06,422.1,1993.96,125914.17,mortgage,72,2
33,125914.17,2416.06,415.52,2000.54,123913.63,mortgage,72,2
34,123913.63,2416.06,408.91,2007.15,121906.48,mortgage,72,2
35,121906.48,2416.06,402.29,2013.77,119892.71,mortgage,72,2
36,119892.71,2416.06,395.65,2020.41,117872.3,mortgage,72,2
37,117872.3,2416.06,388.98,2027.08,115845.22,mortgage,72,2
38,115845.22,2416.06,382.29,2033.77,113811.45,mortgage,72,2
39,113811.45,2416.06,375.58,2040.48,111770.97,mortgage,72,2
40,111770.97,2416.06,368.84,2047.22,109723.75,mortgage,72,2
41,109723.75,2416.06,362.09,2053.97,107669.78,mortgage,72,2
42,107669.78,2416.06,355.31,2060.75,105609.03,mortgage,72,2
43,105609.03,2416.06,348.51,2067.55,103541.48,mortgage,72,2
44,103541.48,2416.06,341.69,2074.37,101467.11,mortgage,72,2
45,101467.11,2416.06,334.84,2081.22,99385.89,mortgage,72,2
46,99385.89,2416.06,327.97,2088.09,97297.8,mortgage,72,2
47,97297.8,2416.06,321.08,2094.98,95202.82,mortgage,72,2
48,95202.82,2416.06,314.17,2101.89,93100.93,mortgage,72,2
49,93100.93,2416.06,307.23,2108.83,90992.1,mortgage,72,2
50,90992.1,2416.06,300.27,2115.79,88876.31,mortgage,72,2
51,88876.31,2416.06,293.29,2122.77,86753.54,mortgage,72,2
52,86753.54,2416.06,286.29,2129.77,84623.77,mortgage,72,2
53,84623.77,2416.06,279.26,2136.8,82486.97,mortgage,72,2
54,82486.97,2416.06,272.21,2143.85,80343.12,mortgage,72,2
55,80343.12,2416.06,265.13,2150.93,78192.19,mortgage,72,2
56,78192.19,2416.06,258.03,2158.03,76034.16,mortgage,72,2
57,76034.16,2416.06,250.91,2165.15,73869.01,mortgage,72,2
58,73869.01,2416.06,243.77,2172.29,71696.72,mortgage,72,2
59,71696.72,2416.06,236.6,2179.46,69517.26,mortgage,72,2
60,69517.26,2416.06,229.41,2186.65,67330.61,mortgage,72,2
61,67330.61,2416.06,222.19,2193.87,65136.74,mortgage,72,2
62,65136.74,2416.06,214.95,2201.11,62935.63,mortgage,72,2
63,62935.63,2416.06,207.69,2208.37,60727.26,mortgage,72,2
64,60727.26,2416.06,200.4,2215.66,58511.6,mortgage,72,2
65,58511.6,2416.06,193.09,2222.97,56288.63,mortgage,72,2
66,56288.63,2416.06,185.75,2230.31,54058.32,mortgage,72,2
67,54058.32,2416.06,178.39,2237.67,51820.65,mortgage,72,2
68,51820.65,2416.06,171.01,2245.05,49575.6,mortgage,72,2
69,49575.6,2416.06,163.6,2252.46,47323.14,mortgage,72,2
70,47323.14,2416.06,156.17,2259.89,45063.25,mortgage,72,2
71,45063.25,2416.06,148.71,2267.35,42795.9,mortgage,72,2
72,42795.9,2416.06,141.23,2274.83,40521.07,mortgage,72,2
73,40521.07,2416.06,133.72,2282.34,38238.73,mortgage,72,2
74,38238.73,2416.06,126.19,2289.87,35948.86,mortgage,72,2
75,35948.86,2416.06,118.63,2297.43,33651.43,mortgage,72,2
76,33651.43,2416.06,111.05,2305.01,31346.42,mortgage,72,2
77,31346.42,2416.06,103.44,2312.62,29033.8,mortgage,72,2
78,29033.8,2416.06,95.81,2320.25,26713.55,mortgage,72,2
79,26713.55,2416.06,88.15,2327.91,24385.64,mortgage,72,2
80,24385.64,2416.06,80.47,2335.59,22050.05,mortgage,72,2
81,22050.05,2416.06,72.77,2343.29,19706.76,mortgage,72,2
82,19706.76,2416.06,65.03,2351.03,17355.73,mortgage,72,2
83,17355.73,2416.06,57.27,2358.79,14996.94,mortgage,72,2
84,14996.94,2416.06,49.49,2366.57,12630.37,mortgage,72,2
85,12630.37,2416.06,41.68,2374.38,10255.99,mortgage,72,2
86,10255.99,2416.06,33.84,2382.22,7873.77,mortgage,72,2
87,7873.77,2416.06,25.98,2390.08,5483.69,mortgage,72,2
88,5483.69,2416.06,18.1,2397.96,3085.73,mortgage,72,2
89,3085.73,2416.06,10.18,2405.88,679.85,mortgage,72,2
90,679.85,2416.06,2.24,2413.82,-1733.97,mortgage,72,2
0,20000.0,191.04,108.0,83.04,19916.96,WellsFargo2,72,3
1,19916.96,191.04,107.55,83.49,19833.47,WellsFargo2,72,3
2,19833.47,191.04,107.1,83.94,19749.53,WellsFargo2,72,3
3,19749.53,191.04,106.65,84.39,19665.14,WellsFargo2,72,3
4,19665.14,191.04,106.19,84.85,19580.29,WellsFargo2,72,3
5,19580.29,191.04,105.73,85.31,19494.98,WellsFargo2,72,3
6,19494.98,191.04,105.27,85.77,19409.21,WellsFargo2,72,3
7,19409.21,191.04,104.81,86.23,19322.98,WellsFargo2,72,3
8,19322.98,191.04,104.34,86.7,19236.28,WellsFargo2,72,3
9,19236.28,191.04,103.88,87.16,19149.12,WellsFargo2,72,3
10,19149.12,191.04,103.41,87.63,19061.49,WellsFargo2,72,3
11,19061.49,191.04,102.93,88.11,18973.38,WellsFargo2,72,3
12,18973.38,191.04,102.46,88.58,18884.8,WellsFargo2,72,3
13,18884.8,191.04,101.98,89.06,18795.74,WellsFargo2,72,3
14,18795.74,191.04,101.5,89.54,18706.2,WellsFargo2,72,3
15,18706.2,191.04,101.01,90.03,18616.17,WellsFargo2,72,3
16,18616.17,191.04,100.53,90.51,18525.66,WellsFargo2,72,3
17,18525.66,191.04,100.04,91.0,18434.66,WellsFargo2,72,3
18,18434.66,191.04,99.55,91.49,18343.17,WellsFargo2,72,3
19,18343.17,191.04,99.05,91.99,18251.18,WellsFargo2,72,3
20,18251.18,191.04,98.56,92.48,18158.7,WellsFargo2,72,3
21,18158.7,191.04,98.06,92.98,18065.72,WellsFargo2,72,3
22,18065.72,191.04,97.55,93.49,17972.23,WellsFargo2,72,3
23,17972.23,191.04,97.05,93.99,17878.24,WellsFargo2,72,3
24,17878.24,191.04,96.54,94.5,17783.74,WellsFargo2,72,3
25,17783.74,191.04,96.03,95.01,17688.73,WellsFargo2,72,3
26,17688.73,191.04,95.52,95.52,17593.21,WellsFargo2,72,3
27,17593.21,191.04,95.0,96.04,17497.17,WellsFargo2,72,3
28,17497.17,191.04,94.48,96.56,17400.61,WellsFargo2,72,3
29,17400.61,191.04,93.96,97.08,17303.53,WellsFargo2,72,3
30,17303.53,191.04,93.44,97.6,17205.93,WellsFargo2,72,3
31,17205.93,191.04,92.91,98.13,17107.8,WellsFargo2,72,3
32,17107.8,191.04,92.38,98.66,17009.14,WellsFargo2,72,3
33,17009.14,191.04,91.85,99.19,16909.95,WellsFargo2,72,3
34,16909.95,191.04,91.31,99.73,16810.22,WellsFargo2,72,3
35,16810.22,191.04,90.78,100.26,16709.96,WellsFargo2,72,3
36,16709.96,191.04,90.23,100.81,16609.15,WellsFargo2,72,3
37,16609.15,191.04,89.69,101.35,16507.8,WellsFargo2,72,3
38,16507.8,191.04,89.14,101.9,16405.9,WellsFargo2,72,3
39,16405.9,191.04,88.59,102.45,16303.45,WellsFargo2,72,3
40,16303.45,191.04,88.04,103.0,16200.45,WellsFargo2,72,3
41,16200.45,191.04,87.48,103.56,16096.89,WellsFargo2,72,3
42,16096.89,191.04,86.92,104.12,15992.77,WellsFargo2,72,3
43,15992.77,191.04,86.36,104.68,15888.09,WellsFargo2,72,3
44,15888.09,191.04,85.8,105.24,15782.85,WellsFargo2,72,3
45,15782.85,191.04,85.23,105.81,15677.04,WellsFargo2,72,3
46,15677.04,191.04,84.66,106.38,15570.66,WellsFargo2,72,3
47,15570.66,191.04,84.08,106.96,15463.7,WellsFargo2,72,3
48,15463.7,191.04,83.5,107.54,15356.16,WellsFargo2,72,3
49,15356.16,191.04,82.92,108.12,15248.04,WellsFargo2,72,3
50,15248.04,191.04,82.34,108.7,15139.34,WellsFargo2,72,3
51,15139.34,191.04,81.75,109.29,15030.05,WellsFargo2,72,3
52,15030.05,191.04,81.16,109.88,14920.17,WellsFargo2,72,3
53,14920.17,191.04,80.57,110.47,14809.7,WellsFargo2,72,3
54,14809.7,191.04,79.97,111.07,14698.63,WellsFargo2,72,3
55,14698.63,191.04,79.37,111.67,14586.96,WellsFargo2,72,3
56,14586.96,191.04,78.77,112.27,14474.69,WellsFargo2,72,3
57,14474.69,191.04,78.16,112.88,14361.81,WellsFargo2,72,3
58,14361.81,191.04,77.55,113.49,14248.32,WellsFargo2,72,3
59,14248.32,191.04,76.94,114.1,14134.22,WellsFargo2,72,3
60,14134.22,191.04,76.32,114.72,14019.5,WellsFargo2,72,3
61,14019.5,191.04,75.71,115.33,13904.17,WellsFargo2,72,3
62,13904.17,191.04,75.08,115.96,13788.21,WellsFargo2,72,3
63,13788.21,191.04,74.46,116.58,13671.63,WellsFargo2,72,3
64,13671.63,191.04,73.83,117.21,13554.42,WellsFargo2,72,3
65,13554.42,191.04,73.19,117.85,13436.57,WellsFargo2,72,3
66,13436.57,191.04,72.56,118.48,13318.09,WellsFargo2,72,3
67,13318.09,191.04,71.92,119.12,13198.97,WellsFargo2,72,3
68,13198.97,191.04,71.27,119.77,13079.2,WellsFargo2,72,3
69,13079.2,191.04,70.63,120.41,12958.79,WellsFargo2,72,3
70,12958.79,191.04,69.98,121.06,12837.73,WellsFargo2,72,3
71,12837.73,191.04,69.32,121.72,12716.01,WellsFargo2,72,3
72,12716.01,191.04,68.67,122.37,12593.64,WellsFargo2,72,3
73,12593.64,191.04,68.01,123.03,12470.61,WellsFargo2,72,3
74,12470.61,191.04,67.34,123.7,12346.91,WellsFargo2,72,3
75,12346.91,191.04,66.67,124.37,12222.54,WellsFargo2,72,3
76,12222.54,191.04,66.0,125.04,12097.5,WellsFargo2,72,3
77,12097.5,191.04,65.33,125.71,11971.79,WellsFargo2,72,3
78,11971.79,191.04,64.65,126.39,11845.4,WellsFargo2,72,3
79,11845.4,191.04,63.97,127.07,11718.33,WellsFargo2,72,3
80,11718.33,191.04,63.28,127.76,11590.57,WellsFargo2,72,3
81,11590.57,191.04,62.59,128.45,11462.12,WellsFargo2,72,3
82,11462.12,191.04,61.9,129.14,11332.98,WellsFargo2,72,3
83,11332.98,191.04,61.2,129.84,11203.14,WellsFargo2,72,3
84,11203.14,191.04,60.5,130.54,11072.6,WellsFargo2,72,3
85,11072.6,191.04,59.79,131.25,10941.35,WellsFargo2,72,3
86,10941.35,191.04,59.08,131.96,10809.39,WellsFargo2,72,3
87,10809.39,191.04,58.37,132.67,10676.72,WellsFargo2,72,3
88,10676.72,191.04,57.65,133.39,10543.33,WellsFargo2,72,3
89,10543.33,191.04,56.93,134.11,10409.22,WellsFargo2,72,3
90,10409.22,1925.01,56.21,1868.8,8540.42,WellsFargo2,72,3
91,8540.42,2607.1,46.12,2560.98,5979.44,WellsFargo2,72,3
92,5979.44,2607.1,32.29,2574.81,3404.63,WellsFargo2,72,3
93,3404.63,2607.1,18.39,2588.71,815.92,WellsFargo2,72,3
94,815.92,2607.1,4.41,2602.69,-1786.77,WellsFargo2,72,3
0,5000.0,333.0,36.0,297.0,4703.0,Car,72,4
1,4703.0,333.0,33.86,299.14,4403.86,Car,72,4
2,4403.86,333.0,31.71,301.29,4102.57,Car,72,4
3,4102.57,333.0,29.54,303.46,3799.11,Car,72,4
4,3799.11,333.0,27.35,305.65,3493.46,Car,72,4
5,3493.46,333.0,25.15,307.85,3185.61,Car,72,4
6,3185.61,333.0,22.94,310.06,2875.55,Car,72,4
7,2875.55,333.0,20.7,312.3,2563.25,Car,72,4
8,2563.25,333.0,18.46,314.54,2248.71,Car,72,4
9,2248.71,333.0,16.19,316.81,1931.9,Car,72,4
10,1931.9,333.0,13.91,319.09,1612.81,Car,72,4
11,1612.81,333.0,11.61,321.39,1291.42,Car,72,4
12,1291.42,333.0,9.3,323.7,967.72,Car,72,4
13,967.72,333.0,6.97,326.03,641.69,Car,72,4
14,641.69,333.0,4.62,328.38,313.31,Car,72,4
15,313.31,333.0,2.26,330.74,-17.43,Car,72,4
0,4000.0,70.0,16.0,54.0,3946.0,testing,72,5
1,3946.0,70.0,15.78,54.22,3891.78,testing,72,5
2,3891.78,70.0,15.57,54.43,3837.35,testing,72,5
3,3837.35,70.0,15.35,54.65,3782.7,testing,72,5
4,3782.7,70.0,15.13,54.87,3727.83,testing,72,5
5,3727.83,70.0,14.91,55.09,3672.74,testing,72,5
6,3672.74,70.0,14.69,55.31,3617.43,testing,72,5
7,3617.43,70.0,14.47,55.53,3561.9,testing,72,5
8,3561.9,70.0,14.25,55.75,3506.15,testing,72,5
9,3506.15,70.0,14.02,55.98,3450.17,testing,72,5
10,3450.17,70.0,13.8,56.2,3393.97,testing,72,5
11,3393.97,70.0,13.58,56.42,3337.55,testing,72,5
12,3337.55,70.0,13.35,56.65,3280.9,testing,72,5
13,3280.9,70.0,13.12,56.88,3224.02,testing,72,5
14,3224.02,70.0,12.9,57.1,3166.92,testing,72,5
15,3166.92,87.43,12.67,74.76,3092.16,testing,72,5
16,3092.16,3010.1,12.37,2997.73,94.43,testing,72,5
17,94.43,3010.1,0.38,3009.72,-2915.29,testing,72,5
0,20000.0,1191.04,108.0,1083.04,18916.96,WellsFargo2,73,1
1,18916.96,1191.04,102.15,1088.89,17828.07,WellsFargo2,73,1
2,17828.07,1191.04,96.27,1094.77,16733.3,WellsFargo2,73,1
3,16733.3,1191.04,90.36,1100.68,15632.62,WellsFargo2,73,1
4,15632.62,1191.04,84.42,1106.62,14526.0,WellsFargo2,73,1
5,14526.0,1191.04,78.44,1112.6,13413.4,WellsFargo2,73,1
6,13413.4,1191.04,72.43,1118.61,12294.79,WellsFargo2,73,1
7,12294.79,1191.04,66.39,1124.65,11170.14,WellsFargo2,73,1
8,11170.14,1191.04,60.32,1130.72,10039.42,WellsFargo2,73,1
9,10039.42,1191.04,54.21,1136.83,8902.59,WellsFargo2,73,1
10,8902.59,1191.04,48.07,1142.97,7759.62,WellsFargo2,73,1
11,7759.62,1191.04,41.9,1149.14,6610.48,WellsFargo2,73,1
12,6610.48,1191.04,35.7,1155.34,5455.14,WellsFargo2,73,1
13,5455.14,1191.04,29.46,1161.58,4293.56,WellsFargo2,73,1
14,4293.56,1191.04,23.19,1167.85,3125.71,WellsFargo2,73,1
15,3125.71,1191.04,16.88,1174.16,1951.55,WellsFargo2,73,1
16,1951.55,1191.04,10.54,1180.5,771.05,WellsFargo2,73,1
17,771.05,1191.04,4.16,1186.88,-415.83,WellsFargo2,73,1
0,4000.0,70.0,16.0,54.0,3946.0,testing,73,2
1,3946.0,70.0,15.78,54.22,3891.78,testing,73,2
2,3891.78,70.0,15.57,54.43,3837.35,testing,73,2
3,3837.35,70.0,15.35,54.65,3782.7,testing,73,2
4,3782.7,70.0,15.13,54.87,3727.83,testing,73,2
5,3727.83,70.0,14.91,55.09,3672.74,testing,73,2
6,3672.74,70.0,14.69,55.31,3617.43,testing,73,2
7,3617.43,70.0,14.47,55.53,3561.9,testing,73,2
8,3561.9,70.0,14.25,55.75,3506.15,testing,73,2
9,3506.15,70.0,14.02,55.98,3450.17,testing,73,2
10,3450.17,70.0,13.8,56.2,3393.97,testing,73,2
11,3393.97,70.0,13.58,56.42,3337.55,testing,73,2
12,3337.55,70.0,13.35,56.65,3280.9,testing,73,2
13,3280.9,70.0,13.12,56.88,3224.02,testing,73,2
14,3224.02,70.0,12.9,57.1,3166.92,testing,73,2
15,3166.92,70.0,12.67,57.33,3109.59,testing,73,2
16,3109.59,70.0,12.44,57.56,3052.03,testing,73,2
17,3052.03,485.83,12.21,473.62,2578.41,testing,73,2
18,2578.41,1261.04,10.31,1250.73,1327.68,testing,73,2
19,1327.68,1261.04,5.31,1255.73,71.95,testing,73,2
20,71.95,1261.04,0.29,1260.75,-1188.8,testing,73,2
0,5000.0,333.0,36.0,297.0,4703.0,Car,73,3
1,4703.0,333.0,33.86,299.14,4403.86,Car,73,3
2,4403.86,333.0,31.71,301.29,4102.57,Car,73,3
3,4102.57,333.0,29.54,303.46,3799.11,Car,73,3
4,3799.11,333.0,27.35,305.65,3493.46,Car,73,3
5,3493.46,333.0,25.15,307.85,3185.61,Car,73,3
6,3185.61,333.0,22.94,310.06,2875.55,Car,73,3
7,2875.55,333.0,20.7,312.3,2563.25,Car,73,3
8,2563.25,333.0,18.46,314.54,2248.71,Car,73,3
9,2248.71,333.0,16.19,316.81,1931.9,Car,73,3
10,1931.9,333.0,13.91,319.09,1612.81,Car,73,3
11,1612.81,333.0,11.61,321.39,1291.42,Car,73,3
12,1291.42,333.0,9.3,323.7,967.72,Car,73,3
13,967.72,333.0,6.97,326.03,641.69,Car,73,3
14,641.69,333.0,4.62,328.38,313.31,Car,73,3
15,313.31,333.0,2.26,330.74,-17.43,Car,73,3
0,8250.57,84.62,53.63,30.99,8219.58,WellsFargo1,73,4
1,8219.58,84.62,53.43,31.19,8188.39,WellsFargo1,73,4
2,8188.39,84.62,53.22,31.4,8156.99,WellsFargo1,73,4
3,8156.99,84.62,53.02,31.6,8125.39,WellsFargo1,73,4
4,8125.39,84.62,52.82,31.8,8093.59,WellsFargo1,73,4
5,8093.59,84.62,52.61,32.01,8061.58,WellsFargo1,73,4
6,8061.58,84.62,52.4,32.22,8029.36,WellsFargo1,73,4
7,8029.36,84.62,52.19,32.43,7996.93,WellsFargo1,73,4
8,7996.93,84.62,51.98,32.64,7964.29,WellsFargo1,73,4
9,7964.29,84.62,51.77,32.85,7931.44,WellsFargo1,73,4
10,7931.44,84.62,51.55,33.07,7898.37,WellsFargo1,73,4
11,7898.37,84.62,51.34,33.28,7865.09,WellsFargo1,73,4
12,7865.09,84.62,51.12,33.5,7831.59,WellsFargo1,73,4
13,7831.59,84.62,50.91,33.71,7797.88,WellsFargo1,73,4
14,7797.88,84.62,50.69,33.93,7763.95,WellsFargo1,73,4
15,7763.95,102.05,50.47,51.58,7712.37,WellsFargo1,73,4
16,7712.37,1678.66,50.13,1628.53,6083.84,WellsFargo1,73,4
17,6083.84,1678.66,39.54,1639.12,4444.72,WellsFargo1,73,4
18,4444.72,1678.66,28.89,1649.77,2794.95,WellsFargo1,73,4
19,2794.95,1678.66,18.17,1660.49,1134.46,WellsFargo1,73,4
20,1134.46,1678.66,7.37,1671.29,-536.83,WellsFargo1,73,4
0,180000.0,1331.44,594.0,737.44,179262.56,mortgage,73,5
1,179262.56,1331.44,591.57,739.87,178522.69,mortgage,73,5
2,178522.69,1331.44,589.12,742.32,177780.37,mortgage,73,5
3,177780.37,1331.44,586.68,744.76,177035.61,mortgage,73,5
4,177035.61,1331.44,584.22,747.22,176288.39,mortgage,73,5
5,176288.39,1331.44,581.75,749.69,175538.7,mortgage,73,5
6,175538.7,1331.44,579.28,752.16,174786.54,mortgage,73,5
7,174786.54,1331.44,576.8,754.64,174031.9,mortgage,73,5
8,174031.9,1331.44,574.31,757.13,173274.77,mortgage,73,5
9,173274.77,1331.44,571.81,759.63,172515.14,mortgage,73,5
10,172515.14,1331.44,569.3,762.14,171753.0,mortgage,73,5
11,171753.0,1331.44,566.78,764.66,170988.34,mortgage,73,5
12,170988.34,1331.44,564.26,767.18,170221.16,mortgage,73,5
13,170221.16,1331.44,561.73,769.71,169451.45,mortgage,73,5
14,169451.45,1331.44,559.19,772.25,168679.2,mortgage,73,5
15,168679.2,1331.44,556.64,774.8,167904.4,mortgage,73,5
16,167904.4,1331.44,554.08,777.36,167127.04,mortgage,73,5
17,167127.04,1331.44,551.52,779.92,166347.12,mortgage,73,5
18,166347.12,1331.44,548.95,782.49,165564.63,mortgage,73,5
19,165564.63,1331.44,546.36,785.08,164779.55,mortgage,73,5
20,164779.55,1868.27,543.77,1324.5,163455.05,mortgage,73,5
21,163455.05,3010.1,539.4,2470.7,160984.35,mortgage,73,5
22,160984.35,3010.1,531.25,2478.85,158505.5,mortgage,73,5
23,158505.5,3010.1,523.07,2487.03,156018.47,mortgage,73,5
24,156018.47,3010.1,514.86,2495.24,153523.23,mortgage,73,5
25,153523.23,3010.1,506.63,2503.47,151019.76,mortgage,73,5
26,151019.76,3010.1,498.37,2511.73,148508.03,mortgage,73,5
27,148508.03,3010.1,490.08,2520.02,145988.01,mortgage,73,5
28,145988.01,3010.1,481.76,2528.34,143459.67,mortgage,73,5
29,143459.67,3010.1,473.42,2536.68,140922.99,mortgage,73,5
30,140922.99,3010.1,465.05,2545.05,138377.94,mortgage,73,5
31,138377.94,3010.1,456.65,2553.45,135824.49,mortgage,73,5
32,135824.49,3010.1,448.22,2561.88,133262.61,mortgage,73,5
33,133262.61,3010.1,439.77,2570.33,130692.28,mortgage,73,5
34,130692.28,3010.1,431.28,2578.82,128113.46,mortgage,73,5
35,128113.46,3010.1,422.77,2587.33,125526.13,mortgage,73,5
36,125526.13,3010.1,414.24,2595.86,122930.27,mortgage,73,5
37,122930.27,3010.1,405.67,2604.43,120325.84,mortgage,73,5
38,120325.84,3010.1,397.08,2613.02,117712.82,mortgage,73,5
39,117712.82,3010.1,388.45,2621.65,115091.17,mortgage,73,5
40,115091.17,3010.1,379.8,2630.3,112460.87,mortgage,73,5
41,112460.87,3010.1,371.12,2638.98,109821.89,mortgage,73,5
42,109821.89,3010.1,362.41,2647.69,107174.2,mortgage,73,5
43,107174.2,3010.1,353.67,2656.43,104517.77,mortgage,73,5
44,104517.77,3010.1,344.91,2665.19,101852.58,mortgage,73,5
45,101852.58,3010.1,336.11,2673.99,99178.59,mortgage,73,5
46,99178.59,3010.1,327.29,2682.81,96495.78,mortgage,73,5
47,96495.78,3010.1,318.44,2691.66,93804.12,mortgage,73,5
48,93804.12,3010.1,309.55,2700.55,91103.57,mortgage,73,5
49,91103.57,3010.1,300.64,2709.46,88394.11,mortgage,73,5
50,88394.11,3010.1,291.7,2718.4,85675.71,mortgage,73,5
51,85675.71,3010.1,282.73,2727.37,82948.34,mortgage,73,5
52,82948.34,3010.1,273.73,2736.37,80211.97,mortgage,73,5
53,80211.97,3010.1,264.7,2745.4,77466.57,mortgage,73,5
54,77466.57,3010.1,255.64,2754.46,74712.11,mortgage,73,5
55,74712.11,3010.1,246.55,2763.55,71948.56,mortgage,73,5
56,71948.56,3010.1,237.43,2772.67,69175.89,mortgage,73,5
57,69175.89,3010.1,228.28,2781.82,66394.07,mortgage,73,5
58,66394.07,3010.1,219.1,2791.0,63603.07,mortgage,73,5
59,63603.07,3010.1,209.89,2800.21,60802.86,mortgage,73,5
60,60802.86,3010.1,200.65,2809.45,57993.41,mortgage,73,5
61,57993.41,3010.1,191.38,2818.72,55174.69,mortgage,73,5
62,55174.69,3010.1,182.08,2828.02,52346.67,mortgage,73,5
63,52346.67,3010.1,172.74,2837.36,49509.31,mortgage,73,5
64,49509.31,3010.1,163.38,2846.72,46662.59,mortgage,73,5
65,46662.59,3010.1,153.99,2856.11,43806.48,mortgage,73,5
66,43806.48,3010.1,144.56,2865.54,40940.94,mortgage,73,5
67,40940.94,3010.1,135.11,2874.99,38065.95,mortgage,73,5
68,38065.95,3010.1,125.62,2884.48,35181.47,mortgage,73,5
69,35181.47,3010.1,116.1,2894.0,32287.47,mortgage,73,5
70,32287.47,3010.1,106.55,2903.55,29383.92,mortgage,73,5
71,29383.92,3010.1,96.97,2913.13,26470.79,mortgage,73,5
72,26470.79,3010.1,87.35,2922.75,23548.04,mortgage,73,5
73,23548.04,3010.1,77.71,2932.39,20615.65,mortgage,73,5
74,20615.65,3010.1,68.03,2942.07,17673.58,mortgage,73,5
75,17673.58,3010.1,58.32,2951.78,14721.8,mortgage,73,5
76,14721.8,3010.1,48.58,2961.52,11760.28,mortgage,73,5
77,11760.28,3010.1,38.81,2971.29,8788.99,mortgage,73,5
78,8788.99,3010.1,29.0,2981.1,5807.89,mortgage,73,5
79,5807.89,3010.1,19.17,2990.93,2816.96,mortgage,73,5
80,2816.96,3010.1,9.3,3000.8,-183.84,mortgage,73,5
0,20000.0,1191.04,108.0,1083.04,18916.96,WellsFargo2,74,1
1,18916.96,1191.04,102.15,1088.89,17828.07,WellsFargo2,74,1
2,17828.07,1191.04,96.27,1094.77,16733.3,WellsFargo2,74,1
3,16733.3,1191.04,90.36,1100.68,15632.62,WellsFargo2,74,1
4,15632.62,1191.04,84.42,1106.62,14526.0,WellsFargo2,74,1
5,14526.0,1191.04,78.44,1112.6,13413.4,WellsFargo2,74,1
6,13413.4,1191.04,72.43,1118.61,12294.79,WellsFargo2,74,1
7,12294.79,1191.04,66.39,1124.65,11170.14,WellsFargo2,74,1
8,11170.14,1191.04,60.32,1130.72,10039.42,WellsFargo2,74,1
9,10039.42,1191.04,54.21,1136.83,8902.59,WellsFargo2,74,1
10,8902.59,1191.04,48.07,1142.97,7759.62,WellsFargo2,74,1
11,7759.62,1191.04,41.9,1149.14,6610.48,WellsFargo2,74,1
12,6610.48,1191.04,35.7,1155.34,5455.14,WellsFargo2,74,1
13,5455.14,1191.04,29.46,1161.58,4293.56,WellsFargo2,74,1
14,4293.56,1191.04,23.19,1167.85,3125.71,WellsFargo2,74,1
15,3125.71,1191.04,16.88,1174.16,1951.55,WellsFargo2,74,1
16,1951.55,1191.04,10.54,1180.5,771.05,WellsFargo2,74,1
17,771.05,1191.04,4.16,1186.88,-415.83,WellsFargo2,74,1
0,4000.0,70.0,16.0,54.0,3946.0,testing,74,2
1,3946.0,70.0,15.78,54.22,3891.78,testing,74,2
2,3891.78,70.0,15.57,54.43,3837.35,testing,74,2
3,3837.35,70.0,15.35,54.65,3782.7,testing,74,2
4,3782.7,70.0,15.13,54.87,3727.83,testing,74,2
5,3727.83,70.0,14.91,55.09,3672.74,testing,74,2
6,3672.74,70.0,14.69,55.31,3617.43,testing,74,2
7,3617.43,70.0,14.47,55.53,3561.9,testing,74,2
8,3561.9,70.0,14.25,55.75,3506.15,testing,74,2
9,3506.15,70.0,14.02,55.98,3450.17,testing,74,2
10,3450.17,70.0,13.8,56.2,3393.97,testing,74,2
11,3393.97,70.0,13.58,56.42,3337.55,testing,74,2
12,3337.55,70.0,13.35,56.65,3280.9,testing,74,2
13,3280.9,70.0,13.12,56.88,3224.02,testing,74,2
14,3224.02,70.0,12.9,57.1,3166.92,testing,74,2
15,3166.92,70.0,12.67,57.33,3109.59,testing,74,2
16,3109.59,70.0,12.44,57.56,3052.03,testing,74,2
17,3052.03,485.83,12.21,473.62,2578.41,testing,74,2
18,2578.41,1261.04,10.31,1250.73,1327.68,testing,74,2
19,1327.68,1261.04,5.31,1255.73,71.95,testing,74,2
20,71.95,1261.04,0.29,1260.75,-1188.8,testing,74,2
0,5000.0,333.0,36.0,297.0,4703.0,Car,74,3
1,4703.0,333.0,33.86,299.14,4403.86,Car,74,3
2,4403.86,333.0,31.71,301.29,4102.57,Car,74,3
3,4102.57,333.0,29.54,303.46,3799.11,Car,74,3
4,3799.11,333.0,27.35,305.65,3493.46,Car,74,3
5,3493.46,333.0,25.15,307.85,3185.61,Car,74,3
6,3185.61,333.0,22.94,310.06,2875.55,Car,74,3
7,2875.55,333.0,20.7,312.3,2563.25,Car,74,3
8,2563.25,333.0,18.46,314.54,2248.71,Car,74,3
9,2248.71,333.0,16.19,316.81,1931.9,Car,74,3
10,1931.9,333.0,13.91,319.09,1612.81,Car,74,3
11,1612.81,333.0,11.61,321.39,1291.42,Car,74,3
12,1291.42,333.0,9.3,323.7,967.72,Car,74,3
13,967.72,333.0,6.97,326.03,641.69,Car,74,3
14,641.69,333.0,4.62,328.38,313.31,Car,74,3
15,313.31,333.0,2.26,330.74,-17.43,Car,74,3
0,180000.0,1331.44,594.0,737.44,179262.56,mortgage,74,4
1,179262.56,1331.44,591.57,739.87,178522.69,mortgage,74,4
2,178522.69,1331.44,589.12,742.32,177780.37,mortgage,74,4
3,177780.37,1331.44,586.68,744.76,177035.61,mortgage,74,4
4,177035.61,1331.44,584.22,747.22,176288.39,mortgage,74,4
5,176288.39,1331.44,581.75,749.69,175538.7,mortgage,74,4
6,175538.7,1331.44,579.28,752.16,174786.54,mortgage,74,4
7,174786.54,1331.44,576.8,754.64,174031.9,mortgage,74,4
8,174031.9,1331.44,574.31,757.13,173274.77,mortgage,74,4
9,173274.77,1331.44,571.81,759.63,172515.14,mortgage,74,4
10,172515.14,1331.44,569.3,762.14,171753.0,mortgage,74,4
11,171753.0,1331.44,566.78,764.66,170988.34,mortgage,74,4
12,170988.34,1331.44,564.26,767.18,170221.16,mortgage,74,4
13,170221.16,1331.44,561.73,769.71,169451.45,mortgage,74,4
14,169451.45,1331.44,559.19,772.25,168679.2,mortgage,74,4
15,168679.2,1348.87,556.64,792.23,167886.97,mortgage,74,4
16,167886.97,2925.48,554.03,2371.45,165515.52,mortgage,74,4
17,165515.52,2925.48,546.2,2379.28,163136.24,mortgage,74,4
18,163136.24,2925.48,538.35,2387.13,160749.11,mortgage,74,4
19,160749.11,2925.48,530.47,2395.01,158354.1,mortgage,74,4
20,158354.1,2925.48,522.57,2402.91,155951.19,mortgage,74,4
21,155951.19,2925.48,514.64,2410.84,153540.35,mortgage,74,4
22,153540.35,2925.48,506.68,2418.8,151121.55,mortgage,74,4
23,151121.55,2925.48,498.7,2426.78,148694.77,mortgage,74,4
24,148694.77,2925.48,490.69,2434.79,146259.98,mortgage,74,4
25,146259.98,2925.48,482.66,2442.82,143817.16,mortgage,74,4
26,143817.16,2925.48,474.6,2450.88,141366.28,mortgage,74,4
27,141366.28,2925.48,466.51,2458.97,138907.31,mortgage,74,4
28,138907.31,2925.48,458.39,2467.09,136440.22,mortgage,74,4
29,136440.22,2925.48,450.25,2475.23,133964.99,mortgage,74,4
30,133964.99,2925.48,442.08,2483.4,131481.59,mortgage,74,4
31,131481.59,2925.48,433.89,2491.59,128990.0,mortgage,74,4
32,128990.0,2925.48,425.67,2499.81,126490.19,mortgage,74,4
33,126490.19,2925.48,417.42,2508.06,123982.13,mortgage,74,4
34,123982.13,2925.48,409.14,2516.34,121465.79,mortgage,74,4
35,121465.79,2925.48,400.84,2524.64,118941.15,mortgage,74,4
36,118941.15,2925.48,392.51,2532.97,116408.18,mortgage,74,4
37,116408.18,2925.48,384.15,2541.33,113866.85,mortgage,74,4
38,113866.85,2925.48,375.76,2549.72,111317.13,mortgage,74,4
39,111317.13,2925.48,367.35,2558.13,108759.0,mortgage,74,4
40,108759.0,2925.48,358.9,2566.58,106192.42,mortgage,74,4
41,106192.42,2925.48,350.43,2575.05,103617.37,mortgage,74,4
42,103617.37,2925.48,341.94,2583.54,101033.83,mortgage,74,4
43,101033.83,2925.48,333.41,2592.07,98441.76,mortgage,74,4
44,98441.76,2925.48,324.86,2600.62,95841.14,mortgage,74,4
45,95841.14,2925.48,316.28,2609.2,93231.94,mortgage,74,4
46,93231.94,2925.48,307.67,2617.81,90614.13,mortgage,74,4
47,90614.13,2925.48,299.03,2626.45,87987.68,mortgage,74,4
48,87987.68,2925.48,290.36,2635.12,85352.56,mortgage,74,4
49,85352.56,2925.48,281.66,2643.82,82708.74,mortgage,74,4
50,82708.74,2925.48,272.94,2652.54,80056.2,mortgage,74,4
51,80056.2,2925.48,264.19,2661.29,77394.91,mortgage,74,4
52,77394.91,2925.48,255.4,2670.08,74724.83,mortgage,74,4
53,74724.83,2925.48,246.59,2678.89,72045.94,mortgage,74,4
54,72045.94,2925.48,237.75,2687.73,69358.21,mortgage,74,4
55,69358.21,2925.48,228.88,2696.6,66661.61,mortgage,74,4
56,66661.61,2925.48,219.98,2705.5,63956.11,mortgage,74,4
57,63956.11,2925.48,211.06,2714.42,61241.69,mortgage,74,4
58,61241.69,2925.48,202.1,2723.38,58518.31,mortgage,74,4
59,58518.31,2925.48,193.11,2732.37,55785.94,mortgage,74,4
60,55785.94,2925.48,184.09,2741.39,53044.55,mortgage,74,4
61,53044.55,2925.48,175.05,2750.43,50294.12,mortgage,74,4
62,50294.12,2925.48,165.97,2759.51,47534.61,mortgage,74,4
63,47534.61,2925.48,156.86,2768.62,44765.99,mortgage,74,4
64,44765.99,2925.48,147.73,2777.75,41988.24,mortgage,74,4
65,41988.24,2925.48,138.56,2786.92,39201.32,mortgage,74,4
66,39201.32,2925.48,129.36,2796.12,36405.2,mortgage,74,4
67,36405.2,2925.48,120.14,2805.34,33599.86,mortgage,74,4
68,33599.86,2925.48,110.88,2814.6,30785.26,mortgage,74,4
69,30785.26,2925.48,101.59,2823.89,27961.37,mortgage,74,4
70,27961.37,2925.48,92.27,2833.21,25128.16,mortgage,74,4
71,25128.16,2925.48,82.92,2842.56,22285.6,mortgage,74,4
72,22285.6,2925.48,73.54,2851.94,19433.66,mortgage,74,4
73,19433.66,2925.48,64.13,2861.35,16572.31,mortgage,74,4
74,16572.31,2925.48,54.69,2870.79,13701.52,mortgage,74,4
75,13701.52,2925.48,45.22,2880.26,10821.26,mortgage,74,4
76,10821.26,2925.48,35.71,2889.77,7931.49,mortgage,74,4
77,7931.49,2925.48,26.17,2899.31,5032.18,mortgage,74,4
78,5032.18,2925.48,16.61,2908.87,2123.31,mortgage,74,4
79,2123.31,2925.48,7.01,2918.47,-795.16,mortgage,74,4
0,8250.57,84.62,53.63,30.99,8219.58,WellsFargo1,74,5
1,8219.58,84.62,53.43,31.19,8188.39,WellsFargo1,74,5
2,8188.39,84.62,53.22,31.4,8156.99,WellsFargo1,74,5
3,8156.99,84.62,53.02,31.6,8125.39,WellsFargo1,74,5
4,8125.39,84.62,52.82,31.8,8093.59,WellsFargo1,74,5
5,8093.59,84.62,52.61,32.01,8061.58,WellsFargo1,74,5
6,8061.58,84.62,52.4,32.22,8029.36,WellsFargo1,74,5
7,8029.36,84.62,52.19,32.43,7996.93,WellsFargo1,74,5
8,7996.93,84.62,51.98,32.64,7964.29,WellsFargo1,74,5
9,7964.29,84.62,51.77,32.85,7931.44,WellsFargo1,74,5
10,7931.44,84.62,51.55,33.07,7898.37,WellsFargo1,74,5
11,7898.37,84.62,51.34,33.28,7865.09,WellsFargo1,74,5
12,7865.09,84.62,51.12,33.5,7831.59,WellsFargo1,74,5
13,7831.59,84.62,50.91,33.71,7797.88,WellsFargo1,74,5
14,7797.88,84.62,50.69,33.93,7763.95,WellsFargo1,74,5
15,7763.95,84.62,50.47,34.15,7729.8,WellsFargo1,74,5
16,7729.8,84.62,50.24,34.38,7695.42,WellsFargo1,74,5
17,7695.42,84.62,50.02,34.6,7660.82,WellsFargo1,74,5
18,7660.82,84.62,49.8,34.82,7626.0,WellsFargo1,74,5
19,7626.0,84.62,49.57,35.05,7590.95,WellsFargo1,74,5
20,7590.95,84.62,49.34,35.28,7555.67,WellsFargo1,74,5
21,7555.67,84.62,49.11,35.51,7520.16,WellsFargo1,74,5
22,7520.16,84.62,48.88,35.74,7484.42,WellsFargo1,74,5
23,7484.42,84.62,48.65,35.97,7448.45,WellsFargo1,74,5
24,7448.45,84.62,48.41,36.21,7412.24,WellsFargo1,74,5
25,7412.24,84.62,48.18,36.44,7375.8,WellsFargo1,74,5
26,7375.8,84.62,47.94,36.68,7339.12,WellsFargo1,74,5
27,7339.12,84.62,47.7,36.92,7302.2,WellsFargo1,74,5
28,7302.2,84.62,47.46,37.16,7265.04,WellsFargo1,74,5
29,7265.04,84.62,47.22,37.4,7227.64,WellsFargo1,74,5
30,7227.64,84.62,46.98,37.64,7190.0,WellsFargo1,74,5
31,7190.0,84.62,46.73,37.89,7152.11,WellsFargo1,74,5
32,7152.11,84.62,46.49,38.13,7113.98,WellsFargo1,74,5
33,7113.98,84.62,46.24,38.38,7075.6,WellsFargo1,74,5
34,7075.6,84.62,45.99,38.63,7036.97,WellsFargo1,74,5
35,7036.97,84.62,45.74,38.88,6998.09,WellsFargo1,74,5
36,6998.09,84.62,45.49,39.13,6958.96,WellsFargo1,74,5
37,6958.96,84.62,45.23,39.39,6919.57,WellsFargo1,74,5
38,6919.57,84.62,44.98,39.64,6879.93,WellsFargo1,74,5
39,6879.93,84.62,44.72,39.9,6840.03,WellsFargo1,74,5
40,6840.03,84.62,44.46,40.16,6799.87,WellsFargo1,74,5
41,6799.87,84.62,44.2,40.42,6759.45,WellsFargo1,74,5
42,6759.45,84.62,43.94,40.68,6718.77,WellsFargo1,74,5
43,6718.77,84.62,43.67,40.95,6677.82,WellsFargo1,74,5
44,6677.82,84.62,43.41,41.21,6636.61,WellsFargo1,74,5
45,6636.61,84.62,43.14,41.48,6595.13,WellsFargo1,74,5
46,6595.13,84.62,42.87,41.75,6553.38,WellsFargo1,74,5
47,6553.38,84.62,42.6,42.02,6511.36,WellsFargo1,74,5
48,6511.36,84.62,42.32,42.3,6469.06,WellsFargo1,74,5
49,6469.06,84.62,42.05,42.57,6426.49,WellsFargo1,74,5
50,6426.49,84.62,41.77,42.85,6383.64,WellsFargo1,74,5
51,6383.64,84.62,41.49,43.13,6340.51,WellsFargo1,74,5
52,6340.51,84.62,41.21,43.41,6297.1,WellsFargo1,74,5
53,6297.1,84.62,40.93,43.69,6253.41,WellsFargo1,74,5
54,6253.41,84.62,40.65,43.97,6209.44,WellsFargo1,74,5
55,6209.44,84.62,40.36,44.26,6165.18,WellsFargo1,74,5
56,6165.18,84.62,40.07,44.55,6120.63,WellsFargo1,74,5
57,6120.63,84.62,39.78,44.84,6075.79,WellsFargo1,74,5
58,6075.79,84.62,39.49,45.13,6030.66,WellsFargo1,74,5
59,6030.66,84.62,39.2,45.42,5985.24,WellsFargo1,74,5
60,5985.24,84.62,38.9,45.72,5939.52,WellsFargo1,74,5
61,5939.52,84.62,38.61,46.01,5893.51,WellsFargo1,74,5
62,5893.51,84.62,38.31,46.31,5847.2,WellsFargo1,74,5
63,5847.2,84.62,38.01,46.61,5800.59,WellsFargo1,74,5
64,5800.59,84.62,37.7,46.92,5753.67,WellsFargo1,74,5
65,5753.67,84.62,37.4,47.22,5706.45,WellsFargo1,74,5
66,5706.45,84.62,37.09,47.53,5658.92,WellsFargo1,74,5
67,5658.92,84.62,36.78,47.84,5611.08,WellsFargo1,74,5
68,5611.08,84.62,36.47,48.15,5562.93,WellsFargo1,74,5
69,5562.93,84.62,36.16,48.46,5514.47,WellsFargo1,74,5
70,5514.47,84.62,35.84,48.78,5465.69,WellsFargo1,74,5
71,5465.69,84.62,35.53,49.09,5416.6,WellsFargo1,74,5
72,5416.6,84.62,35.21,49.41,5367.19,WellsFargo1,74,5
73,5367.19,84.62,34.89,49.73,5317.46,WellsFargo1,74,5
74,5317.46,84.62,34.56,50.06,5267.4,WellsFargo1,74,5
75,5267.4,84.62,34.24,50.38,5217.02,WellsFargo1,74,5
76,5217.02,84.62,33.91,50.71,5166.31,WellsFargo1,74,5
77,5166.31,84.62,33.58,51.04,5115.27,WellsFargo1,74,5
78,5115.27,84.62,33.25,51.37,5063.9,WellsFargo1,74,5
79,5063.9,879.78,32.92,846.86,4217.04,WellsFargo1,74,5
80,4217.04,3010.1,27.41,2982.69,1234.35,WellsFargo1,74,5
81,1234.35,3010.1,8.02,3002.08,-1767.73,WellsFargo1,74,5
0,20000.0,1191.04,108.0,1083.04,18916.96,WellsFargo2,75,1
1,18916.96,1191.04,102.15,1088.89,17828.07,WellsFargo2,75,1
2,17828.07,1191.04,96.27,1094.77,16733.3,WellsFargo2,75,1
3,16733.3,1191.04,90.36,1100.68,15632.62,WellsFargo2,75,1
4,15632.62,1191.04,84.42,1106.62,14526.0,WellsFargo2,75,1
5,14526.0,1191.04,78.44,1112.6,13413.4,WellsFargo2,75,1
6,13413.4,1191.04,72.43,1118.61,12294.79,WellsFargo2,75,1
7,12294.79,1191.04,66.39,1124.65,11170.14,WellsFargo2,75,1
8,11170.14,1191.04,60.32,1130.72,10039.42,WellsFargo2,75,1
9,10039.42,1191.04,54.21,1136.83,8902.59,WellsFargo2,75,1
10,8902.59,1191.04,48.07,1142.97,7759.62,WellsFargo2,75,1
11,7759.62,1191.04,41.9,1149.14,6610.48,WellsFargo2,75,1
12,6610.48,1191.04,35.7,1155.34,5455.14,WellsFargo2,75,1
13,5455.14,1191.04,29.46,1161.58,4293.56,WellsFargo2,75,1
14,4293.56,1191.04,23.19,1167.85,3125.71,WellsFargo2,75,1
15,3125.71,1191.04,16.88,1174.16,1951.55,WellsFargo2,75,1
16,1951.55,1191.04,10.54,1180.5,771.05,WellsFargo2,75,1
17,771.05,1191.04,4.16,1186.88,-415.83,WellsFargo2,75,1
0,4000.0,70.0,16.0,54.0,3946.0,testing,75,2
1,3946.0,70.0,15.78,54.22,3891.78,testing,75,2
2,3891.78,70.0,15.57,54.43,3837.35,testing,75,2
3,3837.35,70.0,15.35,54.65,3782.7,testing,75,2
4,3782.7,70.0,15.13,54.87,3727.83,testing,75,2
5,3727.83,70.0,14.91,55.09,3672.74,testing,75,2
6,3672.74,70.0,14.69,55.31,3617.43,testing,75,2
7,3617.43,70.0,14.47,55.53,3561.9,testing,75,2
8,3561.9,70.0,14.25,55.75,3506.15,testing,75,2
9,3506.15,70.0,14.02,55.98,3450.17,testing,75,2
10,3450.17,70.0,13.8,56.2,3393.97,testing,75,2
11,3393.97,70.0,13.58,56.42,3337.55,testing,75,2
12,3337.55,70.0,13.35,56.65,3280.9,testing,75,2
13,3280.9,70.0,13.12,56.88,3224.02,testing,75,2
14,3224.02,70.0,12.9,57.1,3166.92,testing,75,2
15,3166.92,70.0,12.67,57.33,3109.59,testing,75,2
16,3109.59,70.0,12.44,57.56,3052.03,testing,75,2
17,3052.03,485.83,12.21,473.62,2578.41,testing,75,2
18,2578.41,1261.04,10.31,1250.73,1327.68,testing,75,2
19,1327.68,1261.04,5.31,1255.73,71.95,testing,75,2
20,71.95,1261.04,0.29,1260.75,-1188.8,testing,75,2
0,8250.57,84.62,53.63,30.99,8219.58,WellsFargo1,75,3
1,8219.58,84.62,53.43,31.19,8188.39,WellsFargo1,75,3
2,8188.39,84.62,53.22,31.4,8156.99,WellsFargo1,75,3
3,8156.99,84.62,53.02,31.6,8125.39,WellsFargo1,75,3
4,8125.39,84.62,52.82,31.8,8093.59,WellsFargo1,75,3
5,8093.59,84.62,52.61,32.01,8061.58,WellsFargo1,75,3
6,8061.58,84.62,52.4,32.22,8029.36,WellsFargo1,75,3
7,8029.36,84.62,52.19,32.43,7996.93,WellsFargo1,75,3
8,7996.93,84.62,51.98,32.64,7964.29,WellsFargo1,75,3
9,7964.29,84.62,51.77,32.85,7931.44,WellsFargo1,75,3
10,7931.44,84.62,51.55,33.07,7898.37,WellsFargo1,75,3
11,7898.37,84.62,51.34,33.28,7865.09,WellsFargo1,75,3
12,7865.09,84.62,51.12,33.5,7831.59,WellsFargo1,75,3
13,7831.59,84.62,50.91,33.71,7797.88,WellsFargo1,75,3
14,7797.88,84.62,50.69,33.93,7763.95,WellsFargo1,75,3
15,7763.95,84.62,50.47,34.15,7729.8,WellsFargo1,75,3
16,7729.8,84.62,50.24,34.38,7695.42,WellsFargo1,75,3
17,7695.42,84.62,50.02,34.6,7660.82,WellsFargo1,75,3
18,7660.82,84.62,49.8,34.82,7626.0,WellsFargo1,75,3
19,7626.0,84.62,49.57,35.05,7590.95,WellsFargo1,75,3
20,7590.95,1273.42,49.34,1224.08,6366.87,WellsFargo1,75,3
21,6366.87,1345.66,41.38,1304.28,5062.59,WellsFargo1,75,3
22,5062.59,1345.66,32.91,1312.75,3749.84,WellsFargo1,75,3
23,3749.84,1345.66,24.37,1321.29,2428.55,WellsFargo1,75,3
24,2428.55,1345.66,15.79,1329.87,1098.68,WellsFargo1,75,3
25,1098.68,1345.66,7.14,1338.52,-239.84,WellsFargo1,75,3
0,5000.0,333.0,36.0,297.0,4703.0,Car,75,4
1,4703.0,333.0,33.86,299.14,4403.86,Car,75,4
2,4403.86,333.0,31.71,301.29,4102.57,Car,75,4
3,4102.57,333.0,29.54,303.46,3799.11,Car,75,4
4,3799.11,333.0,27.35,305.65,3493.46,Car,75,4
5,3493.46,333.0,25.15,307.85,3185.61,Car,75,4
6,3185.61,333.0,22.94,310.06,2875.55,Car,75,4
7,2875.55,333.0,20.7,312.3,2563.25,Car,75,4
8,2563.25,333.0,18.46,314.54,2248.71,Car,75,4
9,2248.71,333.0,16.19,316.81,1931.9,Car,75,4
10,1931.9,333.0,13.91,319.09,1612.81,Car,75,4
11,1612.81,333.0,11.61,321.39,1291.42,Car,75,4
12,1291.42,333.0,9.3,323.7,967.72,Car,75,4
13,967.72,333.0,6.97,326.03,641.69,Car,75,4
14,641.69,333.0,4.62,328.38,313.31,Car,75,4
15,313.31,333.0,2.26,330.74,-17.43,Car,75,4
0,180000.0,1331.44,594.0,737.44,179262.56,mortgage,75,5
1,179262.56,1331.44,591.57,739.87,178522.69,mortgage,75,5
2,178522.69,1331.44,589.12,742.32,177780.37,mortgage,75,5
3,177780.37,1331.44,586.68,744.76,177035.61,mortgage,75,5
4,177035.61,1331.44,584.22,747.22,176288.39,mortgage,75,5
5,176288.39,1331.44,581.75,749.69,175538.7,mortgage,75,5
6,175538.7,1331.44,579.28,752.16,174786.54,mortgage,75,5
7,174786.54,1331.44,576.8,754.64,174031.9,mortgage,75,5
8,174031.9,1331.44,574.31,757.13,173274.77,mortgage,75,5
9,173274.77,1331.44,571.81,759.63,172515.14,mortgage,75,5
10,172515.14,1331.44,569.3,762.14,171753.0,mortgage,75,5
11,171753.0,1331.44,566.78,764.66,170988.34,mortgage,75,5
12,170988.34,1331.44,564.26,767.18,170221.16,mortgage,75,5
13,170221.16,1331.44,561.73,769.71,169451.45,mortgage,75,5
14,169451.45,1331.44,559.19,772.25,168679.2,mortgage,75,5
15,168679.2,1348.87,556.64,792.23,167886.97,mortgage,75,5
16,167886.97,3010.1,554.03,2456.07,165430.9,mortgage,75,5
17,165430.9,3010.1,545.92,2464.18,162966.72,mortgage,75,5
18,162966.72,3010.1,537.79,2472.31,160494.41,mortgage,75,5
19,160494.41,3010.1,529.63,2480.47,158013.94,mortgage,75,5
20,158013.94,3010.1,521.45,2488.65,155525.29,mortgage,75,5
21,155525.29,3010.1,513.23,2496.87,153028.42,mortgage,75,5
22,153028.42,3010.1,504.99,2505.11,150523.31,mortgage,75,5
23,150523.31,3010.1,496.73,2513.37,148009.94,mortgage,75,5
24,148009.94,3010.1,488.43,2521.67,145488.27,mortgage,75,5
25,145488.27,3010.1,480.11,2529.99,142958.28,mortgage,75,5
26,142958.28,3010.1,471.76,2538.34,140419.94,mortgage,75,5
27,140419.94,3010.1,463.39,2546.71,137873.23,mortgage,75,5
28,137873.23,3010.1,454.98,2555.12,135318.11,mortgage,75,5
29,135318.11,3010.1,446.55,2563.55,132754.56,mortgage,75,5
30,132754.56,3010.1,438.09,2572.01,130182.55,mortgage,75,5
31,130182.55,3010.1,429.6,2580.5,127602.05,mortgage,75,5
32,127602.05,3010.1,421.09,2589.01,125013.04,mortgage,75,5
33,125013.04,3010.1,412.54,2597.56,122415.48,mortgage,75,5
34,122415.48,3010.1,403.97,2606.13,119809.35,mortgage,75,5
35,119809.35,3010.1,395.37,2614.73,117194.62,mortgage,75,5
36,117194.62,3010.1,386.74,2623.36,114571.26,mortgage,75,5
37,114571.26,3010.1,378.09,2632.01,111939.25,mortgage,75,5
38,111939.25,3010.1,369.4,2640.7,109298.55,mortgage,75,5
39,109298.55,3010.1,360.69,2649.41,106649.14,mortgage,75,5
40,106649.14,3010.1,351.94,2658.16,103990.98,mortgage,75,5
41,103990.98,3010.1,343.17,2666.93,101324.05,mortgage,75,5
42,101324.05,3010.1,334.37,2675.73,98648.32,mortgage,75,5
43,98648.32,3010.1,325.54,2684.56,95963.76,mortgage,75,5
44,95963.76,3010.1,316.68,2693.42,93270.34,mortgage,75,5
45,93270.34,3010.1,307.79,2702.31,90568.03,mortgage,75,5
46,90568.03,3010.1,298.87,2711.23,87856.8,mortgage,75,5
47,87856.8,3010.1,289.93,2720.17,85136.63,mortgage,75,5
48,85136.63,3010.1,280.95,2729.15,82407.48,mortgage,75,5
49,82407.48,3010.1,271.94,2738.16,79669.32,mortgage,75,5
50,79669.32,3010.1,262.91,2747.19,76922.13,mortgage,75,5
51,76922.13,3010.1,253.84,2756.26,74165.87,mortgage,75,5
52,74165.87,3010.1,244.75,2765.35,71400.52,mortgage,75,5
53,71400.52,3010.1,235.62,2774.48,68626.04,mortgage,75,5
54,68626.04,3010.1,226.47,2783.63,65842.41,mortgage,75,5
55,65842.41,3010.1,217.28,2792.82,63049.59,mortgage,75,5
56,63049.59,3010.1,208.06,2802.04,60247.55,mortgage,75,5
57,60247.55,3010.1,198.82,2811.28,57436.27,mortgage,75,5
58,57436.27,3010.1,189.54,2820.56,54615.71,mortgage,75,5
59,54615.71,3010.1,180.23,2829.87,51785.84,mortgage,75,5
60,51785.84,3010.1,170.89,2839.21,48946.63,mortgage,75,5
61,48946.63,3010.1,161.52,2848.58,46098.05,mortgage,75,5
62,46098.05,3010.1,152.12,2857.98,43240.07,mortgage,75,5
63,43240.07,3010.1,142.69,2867.41,40372.66,mortgage,75,5
64,40372.66,3010.1,133.23,2876.87,37495.79,mortgage,75,5
65,37495.79,3010.1,123.74,2886.36,34609.43,mortgage,75,5
66,34609.43,3010.1,114.21,2895.89,31713.54,mortgage,75,5
67,31713.54,3010.1,104.65,2905.45,28808.09,mortgage,75,5
68,28808.09,3010.1,95.07,2915.03,25893.06,mortgage,75,5
69,25893.06,3010.1,85.45,2924.65,22968.41,mortgage,75,5
70,22968.41,3010.1,75.8,2934.3,20034.11,mortgage,75,5
71,20034.11,3010.1,66.11,2943.99,17090.12,mortgage,75,5
72,17090.12,3010.1,56.4,2953.7,14136.42,mortgage,75,5
73,14136.42,3010.1,46.65,2963.45,11172.97,mortgage,75,5
74,11172.97,3010.1,36.87,2973.23,8199.74,mortgage,75,5
75,8199.74,3010.1,27.06,2983.04,5216.7,mortgage,75,5
76,5216.7,3010.1,17.22,2992.88,2223.82,mortgage,75,5
77,2223.82,3010.1,7.34,3002.76,-778.94,mortgage,75,5
0,20000.0,1191.04,108.0,1083.04,18916.96,WellsFargo2,76,1
1,18916.96,1191.04,102.15,1088.89,17828.07,WellsFargo2,76,1
2,17828.07,1191.04,96.27,1094.77,16733.3,WellsFargo2,76,1
3,16733.3,1191.04,90.36,1100.68,15632.62,WellsFargo2,76,1
4,15632.62,1191.04,84.42,1106.62,14526.0,WellsFargo2,76,1
5,14526.0,1191.04,78.44,1112.6,13413.4,WellsFargo2,76,1
6,13413.4,1191.04,72.43,1118.61,12294.79,WellsFargo2,76,1
7,12294.79,1191.04,66.39,1124.65,11170.14,WellsFargo2,76,1
8,11170.14,1191.04,60.32,1130.72,10039.42,WellsFargo2,76,1
9,10039.42,1191.04,54.21,1136.83,8902.59,WellsFargo2,76,1
10,8902.59,1191.04,48.07,1142.97,7759.62,WellsFargo2,76,1
11,7759.62,1191.04,41.9,1149.14,6610.48,WellsFargo2,76,1
12,6610.48,1191.04,35.7,1155.34,5455.14,WellsFargo2,76,1
13,5455.14,1191.04,29.46,1161.58,4293.56,WellsFargo2,76,1
14,4293.56,1191.04,23.19,1167.85,3125.71,WellsFargo2,76,1
15,3125.71,1191.04,16.88,1174.16,1951.55,WellsFargo2,76,1
16,1951.55,1191.04,10.54,1180.5,771.05,WellsFargo2,76,1
17,771.05,1191.04,4.16,1186.88,-415.83,WellsFargo2,76,1
0,4000.0,70.0,16.0,54.0,3946.0,testing,76,2
1,3946.0,70.0,15.78,54.22,3891.78,testing,76,2
2,3891.78,70.0,15.57,54.43,3837.35,testing,76,2
3,3837.35,70.0,15.35,54.65,3782.7,testing,76,2
4,3782.7,70.0,15.13,54.87,3727.83,testing,76,2
5,3727.83,70.0,14.91,55.09,3672.74,testing,76,2
6,3672.74,70.0,14.69,55.31,3617.43,testing,76,2
7,3617.43,70.0,14.47,55.53,3561.9,testing,76,2
8,3561.9,70.0,14.25,55.75,3506.15,testing,76,2
9,3506.15,70.0,14.02,55.98,3450.17,testing,76,2
10,3450.17,70.0,13.8,56.2,3393.97,testing,76,2
11,3393.97,70.0,13.58,56.42,3337.55,testing,76,2
12,3337.55,70.0,13.35,56.65,3280.9,testing,76,2
13,3280.9,70.0,13.12,56.88,3224.02,testing,76,2
14,3224.02,70.0,12.9,57.1,3166.92,testing,76,2
15,3166.92,70.0,12.67,57.33,3109.59,testing,76,2
16,3109.59,70.0,12.44,57.56,3052.03,testing,76,2
17,3052.03,485.83,12.21,473.62,2578.41,testing,76,2
18,2578.41,1261.04,10.31,1250.73,1327.68,testing,76,2
19,1327.68,1261.04,5.31,1255.73,71.95,testing,76,2
20,71.95,1261.04,0.29,1260.75,-1188.8,testing,76,2
0,8250.57,84.62,53.63,30.99,8219.58,WellsFargo1,76,3
1,8219.58,84.62,53.43,31.19,8188.39,WellsFargo1,76,3
2,8188.39,84.62,53.22,31.4,8156.99,WellsFargo1,76,3
3,8156.99,84.62,53.02,31.6,8125.39,WellsFargo1,76,3
4,8125.39,84.62,52.82,31.8,8093.59,WellsFargo1,76,3
5,8093.59,84.62,52.61,32.01,8061.58,WellsFargo1,76,3
6,8061.58,84.62,52.4,32.22,8029.36,WellsFargo1,76,3
7,8029.36,84.62,52.19,32.43,7996.93,WellsFargo1,76,3
8,7996.93,84.62,51.98,32.64,7964.29,WellsFargo1,76,3
9,7964.29,84.62,51.77,32.85,7931.44,WellsFargo1,76,3
10,7931.44,84.62,51.55,33.07,7898.37,WellsFargo1,76,3
11,7898.37,84.62,51.34,33.28,7865.09,WellsFargo1,76,3
12,7865.09,84.62,51.12,33.5,7831.59,WellsFargo1,76,3
13,7831.59,84.62,50.91,33.71,7797.88,WellsFargo1,76,3
14,7797.88,84.62,50.69,33.93,7763.95,WellsFargo1,76,3
15,7763.95,84.62,50.47,34.15,7729.8,WellsFargo1,76,3
16,7729.8,84.62,50.24,34.38,7695.42,WellsFargo1,76,3
17,7695.42,84.62,50.02,34.6,7660.82,WellsFargo1,76,3
18,7660.82,84.62,49.8,34.82,7626.0,WellsFargo1,76,3
19,7626.0,84.62,49.57,35.05,7590.95,WellsFargo1,76,3
20,7590.95,1273.42,49.34,1224.08,6366.87,WellsFargo1,76,3
21,6366.87,1345.66,41.38,1304.28,5062.59,WellsFargo1,76,3
22,5062.59,1345.66,32.91,1312.75,3749.84,WellsFargo1,76,3
23,3749.84,1345.66,24.37,1321.29,2428.55,WellsFargo1,76,3
24,2428.55,1345.66,15.79,1329.87,1098.68,WellsFargo1,76,3
25,1098.68,1345.66,7.14,1338.52,-239.84,WellsFargo1,76,3
0,180000.0,1331.44,594.0,737.44,179262.56,mortgage,76,4
1,179262.56,1331.44,591.57,739.87,178522.69,mortgage,76,4
2,178522.69,1331.44,589.12,742.32,177780.37,mortgage,76,4
3,177780.37,1331.44,586.68,744.76,177035.61,mortgage,76,4
4,177035.61,1331.44,584.22,747.22,176288.39,mortgage,76,4
5,176288.39,1331.44,581.75,749.69,175538.7,mortgage,76,4
6,175538.7,1331.44,579.28,752.16,174786.54,mortgage,76,4
7,174786.54,1331.44,576.8,754.64,174031.9,mortgage,76,4
8,174031.9,1331.44,574.31,757.13,173274.77,mortgage,76,4
9,173274.77,1331.44,571.81,759.63,172515.14,mortgage,76,4
10,172515.14,1331.44,569.3,762.14,171753.0,mortgage,76,4
11,171753.0,1331.44,566.78,764.66,170988.34,mortgage,76,4
12,170988.34,1331.44,564.26,767.18,170221.16,mortgage,76,4
13,170221.16,1331.44,561.73,769.71,169451.45,mortgage,76,4
14,169451.45,1331.44,559.19,772.25,168679.2,mortgage,76,4
15,168679.2,1331.44,556.64,774.8,167904.4,mortgage,76,4
16,167904.4,1331.44,554.08,777.36,167127.04,mortgage,76,4
17,167127.04,1331.44,551.52,779.92,166347.12,mortgage,76,4
18,166347.12,1331.44,548.95,782.49,165564.63,mortgage,76,4
19,165564.63,1331.44,546.36,785.08,164779.55,mortgage,76,4
20,164779.55,1331.44,543.77,787.67,163991.88,mortgage,76,4
21,163991.88,1331.44,541.17,790.27,163201.61,mortgage,76,4
22,163201.61,1331.44,538.57,792.87,162408.74,mortgage,76,4
23,162408.74,1331.44,535.95,795.49,161613.25,mortgage,76,4
24,161613.25,1331.44,533.32,798.12,160815.13,mortgage,76,4
25,160815.13,1571.28,530.69,1040.59,159774.54,mortgage,76,4
26,159774.54,2677.1,527.26,2149.84,157624.7,mortgage,76,4
27,157624.7,2677.1,520.16,2156.94,155467.76,mortgage,76,4
28,155467.76,2677.1,513.04,2164.06,153303.7,mortgage,76,4
29,153303.7,2677.1,505.9,2171.2,151132.5,mortgage,76,4
30,151132.5,2677.1,498.74,2178.36,148954.14,mortgage,76,4
31,148954.14,2677.1,491.55,2185.55,146768.59,mortgage,76,4
32,146768.59,2677.1,484.34,2192.76,144575.83,mortgage,76,4
33,144575.83,2677.1,477.1,2200.0,142375.83,mortgage,76,4
34,142375.83,2677.1,469.84,2207.26,140168.57,mortgage,76,4
35,140168.57,2677.1,462.56,2214.54,137954.03,mortgage,76,4
36,137954.03,2677.1,455.25,2221.85,135732.18,mortgage,76,4
37,135732.18,2677.1,447.92,2229.18,133503.0,mortgage,76,4
38,133503.0,2677.1,440.56,2236.54,131266.46,mortgage,76,4
39,131266.46,2677.1,433.18,2243.92,129022.54,mortgage,76,4
40,129022.54,2677.1,425.77,2251.33,126771.21,mortgage,76,4
41,126771.21,2677.1,418.34,2258.76,124512.45,mortgage,76,4
42,124512.45,2677.1,410.89,2266.21,122246.24,mortgage,76,4
43,122246.24,2677.1,403.41,2273.69,119972.55,mortgage,76,4
44,119972.55,2677.1,395.91,2281.19,117691.36,mortgage,76,4
45,117691.36,2677.1,388.38,2288.72,115402.64,mortgage,76,4
46,115402.64,2677.1,380.83,2296.27,113106.37,mortgage,76,4
47,113106.37,2677.1,373.25,2303.85,110802.52,mortgage,76,4
48,110802.52,2677.1,365.65,2311.45,108491.07,mortgage,76,4
49,108491.07,2677.1,358.02,2319.08,106171.99,mortgage,76,4
50,106171.99,2677.1,350.37,2326.73,103845.26,mortgage,76,4
51,103845.26,2677.1,342.69,2334.41,101510.85,mortgage,76,4
52,101510.85,2677.1,334.99,2342.11,99168.74,mortgage,76,4
53,99168.74,2677.1,327.26,2349.84,96818.9,mortgage,76,4
54,96818.9,2677.1,319.5,2357.6,94461.3,mortgage,76,4
55,94461.3,2677.1,311.72,2365.38,92095.92,mortgage,76,4
56,92095.92,2677.1,303.92,2373.18,89722.74,mortgage,76,4
57,89722.74,2677.1,296.09,2381.01,87341.73,mortgage,76,4
58,87341.73,2677.1,288.23,2388.87,84952.86,mortgage,76,4
59,84952.86,2677.1,280.34,2396.76,82556.1,mortgage,76,4
60,82556.1,2677.1,272.44,2404.66,80151.44,mortgage,76,4
61,80151.44,2677.1,264.5,2412.6,77738.84,mortgage,76,4
62,77738.84,2677.1,256.54,2420.56,75318.28,mortgage,76,4
63,75318.28,2677.1,248.55,2428.55,72889.73,mortgage,76,4
64,72889.73,2677.1,240.54,2436.56,70453.17,mortgage,76,4
65,70453.17,2677.1,232.5,2444.6,68008.57,mortgage,76,4
66,68008.57,2677.1,224.43,2452.67,65555.9,mortgage,76,4
67,65555.9,2677.1,216.33,2460.77,63095.13,mortgage,76,4
68,63095.13,2677.1,208.21,2468.89,60626.24,mortgage,76,4
69,60626.24,2677.1,200.07,2477.03,58149.21,mortgage,76,4
70,58149.21,2677.1,191.89,2485.21,55664.0,mortgage,76,4
71,55664.0,2677.1,183.69,2493.41,53170.59,mortgage,76,4
72,53170.59,2677.1,175.46,2501.64,50668.95,mortgage,76,4
73,50668.95,2677.1,167.21,2509.89,48159.06,mortgage,76,4
74,48159.06,2677.1,158.92,2518.18,45640.88,mortgage,76,4
75,45640.88,2677.1,150.61,2526.49,43114.39,mortgage,76,4
76,43114.39,2677.1,142.28,2534.82,40579.57,mortgage,76,4
77,40579.57,2677.1,133.91,2543.19,38036.38,mortgage,76,4
78,38036.38,2677.1,125.52,2551.58,35484.8,mortgage,76,4
79,35484.8,2677.1,117.1,2560.0,32924.8,mortgage,76,4
80,32924.8,2677.1,108.65,2568.45,30356.35,mortgage,76,4
81,30356.35,2677.1,100.18,2576.92,27779.43,mortgage,76,4
82,27779.43,2677.1,91.67,2585.43,25194.0,mortgage,76,4
83,25194.0,2677.1,83.14,2593.96,22600.04,mortgage,76,4
84,22600.04,2677.1,74.58,2602.52,19997.52,mortgage,76,4
85,19997.52,2677.1,65.99,2611.11,17386.41,mortgage,76,4
86,17386.41,2677.1,57.38,2619.72,14766.69,mortgage,76,4
87,14766.69,2677.1,48.73,2628.37,12138.32,mortgage,76,4
88,12138.32,2677.1,40.06,2637.04,9501.28,mortgage,76,4
89,9501.28,2677.1,31.35,2645.75,6855.53,mortgage,76,4
90,6855.53,2677.1,22.62,2654.48,4201.05,mortgage,76,4
91,4201.05,2677.1,13.86,2663.24,1537.81,mortgage,76,4
92,1537.81,2677.1,5.07,2672.03,-1134.22,mortgage,76,4
0,5000.0,333.0,36.0,297.0,4703.0,Car,76,5
1,4703.0,333.0,33.86,299.14,4403.86,Car,76,5
2,4403.86,333.0,31.71,301.29,4102.57,Car,76,5
3,4102.57,333.0,29.54,303.46,3799.11,Car,76,5
4,3799.11,333.0,27.35,305.65,3493.46,Car,76,5
5,3493.46,333.0,25.15,307.85,3185.61,Car,76,5
6,3185.61,333.0,22.94,310.06,2875.55,Car,76,5
7,2875.55,333.0,20.7,312.3,2563.25,Car,76,5
8,2563.25,333.0,18.46,314.54,2248.71,Car,76,5
9,2248.71,333.0,16.19,316.81,1931.9,Car,76,5
10,1931.9,333.0,13.91,319.09,1612.81,Car,76,5
11,1612.81,333.0,11.61,321.39,1291.42,Car,76,5
12,1291.42,333.0,9.3,323.7,967.72,Car,76,5
13,967.72,333.0,6.97,326.03,641.69,Car,76,5
14,641.69,333.0,4.62,328.38,313.31,Car,76,5
15,313.31,333.0,2.26,330.74,-17.43,Car,76,5
0,20000.0,1191.04,108.0,1083.04,18916.96,WellsFargo2,77,1
1,18916.96,1191.04,102.15,1088.89,17828.07,WellsFargo2,77,1
2,17828.07,1191.04,96.27,1094.77,16733.3,WellsFargo2,77,1
3,16733.3,1191.04,90.36,1100.68,15632.62,WellsFargo2,77,1
4,15632.62,1191.04,84.42,1106.62,14526.0,WellsFargo2,77,1
5,14526.0,1191.04,78.44,1112.6,13413.4,WellsFargo2,77,1
6,13413.4,1191.04,72.43,1118.61,12294.79,WellsFargo2,77,1
7,12294.79,1191.04,66.39,1124.65,11170.14,WellsFargo2,77,1
8,11170.14,1191.04,60.32,1130.72,10039.42,WellsFargo2,77,1
9,10039.42,1191.04,54.21,1136.83,8902.59,WellsFargo2,77,1
10,8902.59,1191.04,48.07,1142.97,7759.62,WellsFargo2,77,1
11,7759.62,1191.04,41.9,1149.14,6610.48,WellsFargo2,77,1
12,6610.48,1191.04,35.7,1155.34,5455.14,WellsFargo2,77,1
13,5455.14,1191.04,29.46,1161.58,4293.56,WellsFargo2,77,1
14,4293.56,1191.04,23.19,1167.85,3125.71,WellsFargo2,77,1
15,3125.71,1191.04,16.88,1174.16,1951.55,WellsFargo2,77,1
16,1951.55,1191.04,10.54,1180.5,771.05,WellsFargo2,77,1
17,771.05,1191.04,4.16,1186.88,-415.83,WellsFargo2,77,1
0,4000.0,70.0,16.0,54.0,3946.0,testing,77,2
1,3946.0,70.0,15.78,54.22,3891.78,testing,77,2
2,3891.78,70.0,15.57,54.43,3837.35,testing,77,2
3,3837.35,70.0,15.35,54.65,3782.7,testing,77,2
4,3782.7,70.0,15.13,54.87,3727.83,testing,77,2
5,3727.83,70.0,14.91,55.09,3672.74,testing,77,2
6,3672.74,70.0,14.69,55.31,3617.43,testing,77,2
7,3617.43,70.0,14.47,55.53,3561.9,testing,77,2
8,3561.9,70.0,14.25,55.75,3506.15,testing,77,2
9,3506.15,70.0,14.02,55.98,3450.17,testing,77,2
10,3450.17,70.0,13.8,56.2,3393.97,testing,77,2
11,3393.97,70.0,13.58,56.42,3337.55,testing,77,2
12,3337.55,70.0,13.35,56.65,3280.9,testing,77,2
13,3280.9,70.0,13.12,56.88,3224.02,testing,77,2
14,3224.02,70.0,12.9,57.1,3166.92,testing,77,2
15,3166.92,70.0,12.67,57.33,3109.59,testing,77,2
16,3109.59,70.0,12.44,57.56,3052.03,testing,77,2
17,3052.03,485.83,12.21,473.62,2578.41,testing,77,2
18,2578.41,1261.04,10.31,1250.73,1327.68,testing,77,2
19,1327.68,1261.04,5.31,1255.73,71.95,testing,77,2
20,71.95,1261.04,0.29,1260.75,-1188.8,testing,77,2
0,180000.0,1331.44,594.0,737.44,179262.56,mortgage,77,3
1,179262.56,1331.44,591.57,739.87,178522.69,mortgage,77,3
2,178522.69,1331.44,589.12,742.32,177780.37,mortgage,77,3
3,177780.37,1331.44,586.68,744.76,177035.61,mortgage,77,3
4,177035.61,1331.44,584.22,747.22,176288.39,mortgage,77,3
5,176288.39,1331.44,581.75,749.69,175538.7,mortgage,77,3
6,175538.7,1331.44,579.28,752.16,174786.54,mortgage,77,3
7,174786.54,1331.44,576.8,754.64,174031.9,mortgage,77,3
8,174031.9,1331.44,574.31,757.13,173274.77,mortgage,77,3
9,173274.77,1331.44,571.81,759.63,172515.14,mortgage,77,3
10,172515.14,1331.44,569.3,762.14,171753.0,mortgage,77,3
11,171753.0,1331.44,566.78,764.66,170988.34,mortgage,77,3
12,170988.34,1331.44,564.26,767.18,170221.16,mortgage,77,3
13,170221.16,1331.44,561.73,769.71,169451.45,mortgage,77,3
14,169451.45,1331.44,559.19,772.25,168679.2,mortgage,77,3
15,168679.2,1331.44,556.64,774.8,167904.4,mortgage,77,3
16,167904.4,1331.44,554.08,777.36,167127.04,mortgage,77,3
17,167127.04,1331.44,551.52,779.92,166347.12,mortgage,77,3
18,166347.12,1331.44,548.95,782.49,165564.63,mortgage,77,3
19,165564.63,1331.44,546.36,785.08,164779.55,mortgage,77,3
20,164779.55,2520.24,543.77,1976.47,162803.08,mortgage,77,3
21,162803.08,2592.48,537.25,2055.23,160747.85,mortgage,77,3
22,160747.85,2592.48,530.47,2062.01,158685.84,mortgage,77,3
23,158685.84,2592.48,523.66,2068.82,156617.02,mortgage,77,3
24,156617.02,2592.48,516.84,2075.64,154541.38,mortgage,77,3
25,154541.38,2592.48,509.99,2082.49,152458.89,mortgage,77,3
26,152458.89,2592.48,503.11,2089.37,150369.52,mortgage,77,3
27,150369.52,2592.48,496.22,2096.26,148273.26,mortgage,77,3
28,148273.26,2592.48,489.3,2103.18,146170.08,mortgage,77,3
29,146170.08,2592.48,482.36,2110.12,144059.96,mortgage,77,3
30,144059.96,2592.48,475.4,2117.08,141942.88,mortgage,77,3
31,141942.88,2592.48,468.41,2124.07,139818.81,mortgage,77,3
32,139818.81,2592.48,461.4,2131.08,137687.73,mortgage,77,3
33,137687.73,2592.48,454.37,2138.11,135549.62,mortgage,77,3
34,135549.62,2592.48,447.31,2145.17,133404.45,mortgage,77,3
35,133404.45,2592.48,440.23,2152.25,131252.2,mortgage,77,3
36,131252.2,2592.48,433.13,2159.35,129092.85,mortgage,77,3
37,129092.85,2592.48,426.01,2166.47,126926.38,mortgage,77,3
38,126926.38,2592.48,418.86,2173.62,124752.76,mortgage,77,3
39,124752.76,2592.48,411.68,2180.8,122571.96,mortgage,77,3
40,122571.96,2592.48,404.49,2187.99,120383.97,mortgage,77,3
41,120383.97,2592.48,397.27,2195.21,118188.76,mortgage,77,3
42,118188.76,2592.48,390.02,2202.46,115986.3,mortgage,77,3
43,115986.3,2592.48,382.75,2209.73,113776.57,mortgage,77,3
44,113776.57,2592.48,375.46,2217.02,111559.55,mortgage,77,3
45,111559.55,2592.48,368.15,2224.33,109335.22,mortgage,77,3
46,109335.22,2592.48,360.81,2231.67,107103.55,mortgage,77,3
47,107103.55,2592.48,353.44,2239.04,104864.51,mortgage,77,3
48,104864.51,2592.48,346.05,2246.43,102618.08,mortgage,77,3
49,102618.08,2592.48,338.64,2253.84,100364.24,mortgage,77,3
50,100364.24,2592.48,331.2,2261.28,98102.96,mortgage,77,3
51,98102.96,2592.48,323.74,2268.74,95834.22,mortgage,77,3
52,95834.22,2592.48,316.25,2276.23,93557.99,mortgage,77,3
53,93557.99,2592.48,308.74,2283.74,91274.25,mortgage,77,3
54,91274.25,2592.48,301.21,2291.27,88982.98,mortgage,77,3
55,88982.98,2592.48,293.64,2298.84,86684.14,mortgage,77,3
56,86684.14,2592.48,286.06,2306.42,84377.72,mortgage,77,3
57,84377.72,2592.48,278.45,2314.03,82063.69,mortgage,77,3
58,82063.69,2592.48,270.81,2321.67,79742.02,mortgage,77,3
59,79742.02,2592.48,263.15,2329.33,77412.69,mortgage,77,3
60,77412.69,2592.48,255.46,2337.02,75075.67,mortgage,77,3
61,75075.67,2592.48,247.75,2344.73,72730.94,mortgage,77,3
62,72730.94,2592.48,240.01,2352.47,70378.47,mortgage,77,3
63,70378.47,2592.48,232.25,2360.23,68018.24,mortgage,77,3
64,68018.24,2592.48,224.46,2368.02,65650.22,mortgage,77,3
65,65650.22,2592.48,216.65,2375.83,63274.39,mortgage,77,3
66,63274.39,2592.48,208.81,2383.67,60890.72,mortgage,77,3
67,60890.72,2592.48,200.94,2391.54,58499.18,mortgage,77,3
68,58499.18,2592.48,193.05,2399.43,56099.75,mortgage,77,3
69,56099.75,2592.48,185.13,2407.35,53692.4,mortgage,77,3
70,53692.4,2592.48,177.18,2415.3,51277.1,mortgage,77,3
71,51277.1,2592.48,169.21,2423.27,48853.83,mortgage,77,3
72,48853.83,2592.48,161.22,2431.26,46422.57,mortgage,77,3
73,46422.57,2592.48,153.19,2439.29,43983.28,mortgage,77,3
74,43983.28,2592.48,145.14,2447.34,41535.94,mortgage,77,3
75,41535.94,2592.48,137.07,2455.41,39080.53,mortgage,77,3
76,39080.53,2592.48,128.97,2463.51,36617.02,mortgage,77,3
77,36617.02,2592.48,120.84,2471.64,34145.38,mortgage,77,3
78,34145.38,2592.48,112.68,2479.8,31665.58,mortgage,77,3
79,31665.58,2592.48,104.5,2487.98,29177.6,mortgage,77,3
80,29177.6,2592.48,96.29,2496.19,26681.41,mortgage,77,3
81,26681.41,2592.48,88.05,2504.43,24176.98,mortgage,77,3
82,24176.98,2592.48,79.78,2512.7,21664.28,mortgage,77,3
83,21664.28,2592.48,71.49,2520.99,19143.29,mortgage,77,3
84,19143.29,2592.48,63.17,2529.31,16613.98,mortgage,77,3
85,16613.98,2592.48,54.83,2537.65,14076.33,mortgage,77,3
86,14076.33,2592.48,46.45,2546.03,11530.3,mortgage,77,3
87,11530.3,2592.48,38.05,2554.43,8975.87,mortgage,77,3
88,8975.87,2592.48,29.62,2562.86,6413.01,mortgage,77,3
89,6413.01,2592.48,21.16,2571.32,3841.69,mortgage,77,3
90,3841.69,2592.48,12.68,2579.8,1261.89,mortgage,77,3
91,1261.89,2592.48,4.16,2588.32,-1326.43,mortgage,77,3
0,5000.0,333.0,36.0,297.0,4703.0,Car,77,4
1,4703.0,333.0,33.86,299.14,4403.86,Car,77,4
2,4403.86,333.0,31.71,301.29,4102.57,Car,77,4
3,4102.57,333.0,29.54,303.46,3799.11,Car,77,4
4,3799.11,333.0,27.35,305.65,3493.46,Car,77,4
5,3493.46,333.0,25.15,307.85,3185.61,Car,77,4
6,3185.61,333.0,22.94,310.06,2875.55,Car,77,4
7,2875.55,333.0,20.7,312.3,2563.25,Car,77,4
8,2563.25,333.0,18.46,314.54,2248.71,Car,77,4
9,2248.71,333.0,16.19,316.81,1931.9,Car,77,4
10,1931.9,333.0,13.91,319.09,1612.81,Car,77,4
11,1612.81,333.0,11.61,321.39,1291.42,Car,77,4
12,1291.42,333.0,9.3,323.7,967.72,Car,77,4
13,967.72,333.0,6.97,326.03,641.69,Car,77,4
14,641.69,333.0,4.62,328.38,313.31,Car,77,4
15,313.31,333.0,2.26,330.74,-17.43,Car,77,4
0,8250.57,84.62,53.63,30.99,8219.58,WellsFargo1,77,5
1,8219.58,84.62,53.43,31.19,8188.39,WellsFargo1,77,5
2,8188.39,84.62,53.22,31.4,8156.99,WellsFargo1,77,5
3,8156.99,84.62,53.02,31.6,8125.39,WellsFargo1,77,5
4,8125.39,84.62,52.82,31.8,8093.59,WellsFargo1,77,5
5,8093.59,84.62,52.61,32.01,8061.58,WellsFargo1,77,5
6,8061.58,84.62,52.4,32.22,8029.36,WellsFargo1,77,5
7,8029.36,84.62,52.19,32.43,7996.93,WellsFargo1,77,5
8,7996.93,84.62,51.98,32.64,7964.29,WellsFargo1,77,5
9,7964.29,84.62,51.77,32.85,7931.44,WellsFargo1,77,5
10,7931.44,84.62,51.55,33.07,7898.37,WellsFargo1,77,5
11,7898.37,84.62,51.34,33.28,7865.09,WellsFargo1,77,5
12,7865.09,84.62,51.12,33.5,7831.59,WellsFargo1,77,5
13,7831.59,84.62,50.91,33.71,7797.88,WellsFargo1,77,5
14,7797.88,84.62,50.69,33.93,7763.95,WellsFargo1,77,5
15,7763.95,102.05,50.47,51.58,7712.37,WellsFargo1,77,5
16,7712.37,3010.1,50.13,2959.97,4752.4,WellsFargo1,77,5
17,4752.4,3010.1,30.89,2979.21,1773.19,WellsFargo1,77,5
18,1773.19,3010.1,11.53,2998.57,-1225.38,WellsFargo1,77,5
0,20000.0,1191.04,108.0,1083.04,18916.96,WellsFargo2,78,1
1,18916.96,1191.04,102.15,1088.89,17828.07,WellsFargo2,78,1
2,17828.07,1191.04,96.27,1094.77,16733.3,WellsFargo2,78,1
3,16733.3,1191.04,90.36,1100.68,15632.62,WellsFargo2,78,1
4,15632.62,1191.04,84.42,1106.62,14526.0,WellsFargo2,78,1
5,14526.0,1191.04,78.44,1112.6,13413.4,WellsFargo2,78,1
6,13413.4,1191.04,72.43,1118.61,12294.79,WellsFargo2,78,1
7,12294.79,1191.04,66.39,1124.65,11170.14,WellsFargo2,78,1
8,11170.14,1191.04,60.32,1130.72,10039.42,WellsFargo2,78,1
9,10039.42,1191.04,54.21,1136.83,8902.59,WellsFargo2,78,1
10,8902.59,1191.04,48.07,1142.97,7759.62,WellsFargo2,78,1
11,7759.62,1191.04,41.9,1149.14,6610.48,WellsFargo2,78,1
12,6610.48,1191.04,35.7,1155.34,5455.14,WellsFargo2,78,1
13,5455.14,1191.04,29.46,1161.58,4293.56,WellsFargo2,78,1
14,4293.56,1191.04,23.19,1167.85,3125.71,WellsFargo2,78,1
15,3125.71,1191.04,16.88,1174.16,1951.55,WellsFargo2,78,1
16,1951.55,1191.04,10.54,1180.5,771.05,WellsFargo2,78,1
17,771.05,1191.04,4.16,1186.88,-415.83,WellsFargo2,78,1
0,4000.0,70.0,16.0,54.0,3946.0,testing,78,2
1,3946.0,70.0,15.78,54.22,3891.78,testing,78,2
2,3891.78,70.0,15.57,54.43,3837.35,testing,78,2
3,3837.35,70.0,15.35,54.65,3782.7,testing,78,2
4,3782.7,70.0,15.13,54.87,3727.83,testing,78,2
5,3727.83,70.0,14.91,55.09,3672.74,testing,78,2
6,3672.74,70.0,14.69,55.31,3617.43,testing,78,2
7,3617.43,70.0,14.47,55.53,3561.9,testing,78,2
8,3561.9,70.0,14.25,55.75,3506.15,testing,78,2
9,3506.15,70.0,14.02,55.98,3450.17,testing,78,2
10,3450.17,70.0,13.8,56.2,3393.97,testing,78,2
11,3393.97,70.0,13.58,56.42,3337.55,testing,78,2
12,3337.55,70.0,13.35,56.65,3280.9,testing,78,2
13,3280.9,70.0,13.12,56.88,3224.02,testing,78,2
14,3224.02,70.0,12.9,57.1,3166.92,testing,78,2
15,3166.92,70.0,12.67,57.33,3109.59,testing,78,2
16,3109.59,70.0,12.44,57.56,3052.03,testing,78,2
17,3052.03,485.83,12.21,473.62,2578.41,testing,78,2
18,2578.41,1261.04,10.31,1250.73,1327.68,testing,78,2
19,1327.68,1261.04,5.31,1255.73,71.95,testing,78,2
20,71.95,1261.04,0.29,1260.75,-1188.8,testing,78,2
0,180000.0,1331.44,594.0,737.44,179262.56,mortgage,78,3
1,179262.56,1331.44,591.57,739.87,178522.69,mortgage,78,3
2,178522.69,1331.44,589.12,742.32,177780.37,mortgage,78,3
3,177780.37,1331.44,586.68,744.76,177035.61,mortgage,78,3
4,177035.61,1331.44,584.22,747.22,176288.39,mortgage,78,3
5,176288.39,1331.44,581.75,749.69,175538.7,mortgage,78,3
6,175538.7,1331.44,579.28,752.16,174786.54,mortgage,78,3
7,174786.54,1331.44,576.8,754.64,174031.9,mortgage,78,3
8,174031.9,1331.44,574.31,757.13,173274.77,mortgage,78,3
9,173274.77,1331.44,571.81,759.63,172515.14,mortgage,78,3
10,172515.14,1331.44,569.3,762.14,171753.0,mortgage,78,3
11,171753.0,1331.44,566.78,764.66,170988.34,mortgage,78,3
12,170988.34,1331.44,564.26,767.18,170221.16,mortgage,78,3
13,170221.16,1331.44,561.73,769.71,169451.45,mortgage,78,3
14,169451.45,1331.44,559.19,772.25,168679.2,mortgage,78,3
15,168679.2,1331.44,556.64,774.8,167904.4,mortgage,78,3
16,167904.4,1331.44,554.08,777.36,167127.04,mortgage,78,3
17,167127.04,1331.44,551.52,779.92,166347.12,mortgage,78,3
18,166347.12,1331.44,548.95,782.49,165564.63,mortgage,78,3
19,165564.63,1331.44,546.36,785.08,164779.55,mortgage,78,3
20,164779.55,2520.24,543.77,1976.47,162803.08,mortgage,78,3
21,162803.08,2592.48,537.25,2055.23,160747.85,mortgage,78,3
22,160747.85,2592.48,530.47,2062.01,158685.84,mortgage,78,3
23,158685.84,2592.48,523.66,2068.82,156617.02,mortgage,78,3
24,156617.02,2592.48,516.84,2075.64,154541.38,mortgage,78,3
25,154541.38,2592.48,509.99,2082.49,152458.89,mortgage,78,3
26,152458.89,2592.48,503.11,2089.37,150369.52,mortgage,78,3
27,150369.52,2592.48,496.22,2096.26,148273.26,mortgage,78,3
28,148273.26,2592.48,489.3,2103.18,146170.08,mortgage,78,3
29,146170.08,2592.48,482.36,2110.12,144059.96,mortgage,78,3
30,144059.96,2592.48,475.4,2117.08,141942.88,mortgage,78,3
31,141942.88,2592.48,468.41,2124.07,139818.81,mortgage,78,3
32,139818.81,2592.48,461.4,2131.08,137687.73,mortgage,78,3
33,137687.73,2592.48,454.37,2138.11,135549.62,mortgage,78,3
34,135549.62,2592.48,447.31,2145.17,133404.45,mortgage,78,3
35,133404.45,2592.48,440.23,2152.25,131252.2,mortgage,78,3
36,131252.2,2592.48,433.13,2159.35,129092.85,mortgage,78,3
37,129092.85,2592.48,426.01,2166.47,126926.38,mortgage,78,3
38,126926.38,2592.48,418.86,2173.62,124752.76,mortgage,78,3
39,124752.76,2592.48,411.68,2180.8,122571.96,mortgage,78,3
40,122571.96,2592.48,404.49,2187.99,120383.97,mortgage,78,3
41,120383.97,2592.48,397.27,2195.21,118188.76,mortgage,78,3
42,118188.76,2592.48,390.02,2202.46,115986.3,mortgage,78,3
43,115986.3,2592.48,382.75,2209.73,113776.57,mortgage,78,3
44,113776.57,2592.48,375.46,2217.02,111559.55,mortgage,78,3
45,111559.55,2592.48,368.15,2224.33,109335.22,mortgage,78,3
46,109335.22,2592.48,360.81,2231.67,107103.55,mortgage,78,3
47,107103.55,2592.48,353.44,2239.04,104864.51,mortgage,78,3
48,104864.51,2592.48,346.05,2246.43,102618.08,mortgage,78,3
49,102618.08,2592.48,338.64,2253.84,100364.24,mortgage,78,3
50,100364.24,2592.48,331.2,2261.28,98102.96,mortgage,78,3
51,98102.96,2592.48,323.74,2268.74,95834.22,mortgage,78,3
52,95834.22,2592.48,316.25,2276.23,93557.99,mortgage,78,3
53,93557.99,2592.48,308.74,2283.74,91274.25,mortgage,78,3
54,91274.25,2592.48,301.21,2291.27,88982.98,mortgage,78,3
55,88982.98,2592.48,293.64,2298.84,86684.14,mortgage,78,3
56,86684.14,2592.48,286.06,2306.42,84377.72,mortgage,78,3
57,84377.72,2592.48,278.45,2314.03,82063.69,mortgage,78,3
58,82063.69,2592.48,270.81,2321.67,79742.02,mortgage,78,3
59,79742.02,2592.48,263.15,2329.33,77412.69,mortgage,78,3
60,77412.69,2592.48,255.46,2337.02,75075.67,mortgage,78,3
61,75075.67,2592.48,247.75,2344.73,72730.94,mortgage,78,3
62,72730.94,2592.48,240.01,2352.47,70378.47,mortgage,78,3
63,70378.47,2592.48,232.25,2360.23,68018.24,mortgage,78,3
64,68018.24,2592.48,224.46,2368.02,65650.22,mortgage,78,3
65,65650.22,2592.48,216.65,2375.83,63274.39,mortgage,78,3
66,63274.39,2592.48,208.81,2383.67,60890.72,mortgage,78,3
67,60890.72,2592.48,200.94,2391.54,58499.18,mortgage,78,3
68,58499.18,2592.48,193.05,2399.43,56099.75,mortgage,78,3
69,56099.75,2592.48,185.13,2407.35,53692.4,mortgage,78,3
70,53692.4,2592.48,177.18,2415.3,51277.1,mortgage,78,3
71,51277.1,2592.48,169.21,2423.27,48853.83,mortgage,78,3
72,48853.83,2592.48,161.22,2431.26,46422.57,mortgage,78,3
73,46422.57,2592.48,153.19,2439.29,43983.28,mortgage,78,3
74,43983.28,2592.48,145.14,2447.34,41535.94,mortgage,78,3
75,41535.94,2592.48,137.07,2455.41,39080.53,mortgage,78,3
76,39080.53,2592.48,128.97,2463.51,36617.02,mortgage,78,3
77,36617.02,2592.48,120.84,2471.64,34145.38,mortgage,78,3
78,34145.38,2592.48,112.68,2479.8,31665.58,mortgage,78,3
79,31665.58,2592.48,104.5,2487.98,29177.6,mortgage,78,3
80,29177.6,2592.48,96.29,2496.19,26681.41,mortgage,78,3
81,26681.41,2592.48,88.05,2504.43,24176.98,mortgage,78,3
82,24176.98,2592.48,79.78,2512.7,21664.28,mortgage,78,3
83,21664.28,2592.48,71.49,2520.99,19143.29,mortgage,78,3
84,19143.29,2592.48,63.17,2529.31,16613.98,mortgage,78,3
85,16613.98,2592.48,54.83,2537.65,14076.33,mortgage,78,3
86,14076.33,2592.48,46.45,2546.03,11530.3,mortgage,78,3
87,11530.3,2592.48,38.05,2554.43,8975.87,mortgage,78,3
88,8975.87,2592.48,29.62,2562.86,6413.01,mortgage,78,3
89,6413.01,2592.48,21.16,2571.32,3841.69,mortgage,78,3
90,3841.69,2592.48,12.68,2579.8,1261.89,mortgage,78,3
91,1261.89,2592.48,4.16,2588.32,-1326.43,mortgage,78,3
0,8250.57,84.62,53.63,30.99,8219.58,WellsFargo1,78,4
1,8219.58,84.62,53.43,31.19,8188.39,WellsFargo1,78,4
2,8188.39,84.62,53.22,31.4,8156.99,WellsFargo1,78,4
3,8156.99,84.62,53.02,31.6,8125.39,WellsFargo1,78,4
4,8125.39,84.62,52.82,31.8,8093.59,WellsFargo1,78,4
5,8093.59,84.62,52.61,32.01,8061.58,WellsFargo1,78,4
6,8061.58,84.62,52.4,32.22,8029.36,WellsFargo1,78,4
7,8029.36,84.62,52.19,32.43,7996.93,WellsFargo1,78,4
8,7996.93,84.62,51.98,32.64,7964.29,WellsFargo1,78,4
9,7964.29,84.62,51.77,32.85,7931.44,WellsFargo1,78,4
10,7931.44,84.62,51.55,33.07,7898.37,WellsFargo1,78,4
11,7898.37,84.62,51.34,33.28,7865.09,WellsFargo1,78,4
12,7865.09,84.62,51.12,33.5,7831.59,WellsFargo1,78,4
13,7831.59,84.62,50.91,33.71,7797.88,WellsFargo1,78,4
14,7797.88,84.62,50.69,33.93,7763.95,WellsFargo1,78,4
15,7763.95,84.62,50.47,34.15,7729.8,WellsFargo1,78,4
16,7729.8,84.62,50.24,34.38,7695.42,WellsFargo1,78,4
17,7695.42,84.62,50.02,34.6,7660.82,WellsFargo1,78,4
18,7660.82,84.62,49.8,34.82,7626.0,WellsFargo1,78,4
19,7626.0,84.62,49.57,35.05,7590.95,WellsFargo1,78,4
20,7590.95,84.62,49.34,35.28,7555.67,WellsFargo1,78,4
21,7555.67,84.62,49.11,35.51,7520.16,WellsFargo1,78,4
22,7520.16,84.62,48.88,35.74,7484.42,WellsFargo1,78,4
23,7484.42,84.62,48.65,35.97,7448.45,WellsFargo1,78,4
24,7448.45,84.62,48.41,36.21,7412.24,WellsFargo1,78,4
25,7412.24,84.62,48.18,36.44,7375.8,WellsFargo1,78,4
26,7375.8,84.62,47.94,36.68,7339.12,WellsFargo1,78,4
27,7339.12,84.62,47.7,36.92,7302.2,WellsFargo1,78,4
28,7302.2,84.62,47.46,37.16,7265.04,WellsFargo1,78,4
29,7265.04,84.62,47.22,37.4,7227.64,WellsFargo1,78,4
30,7227.64,84.62,46.98,37.64,7190.0,WellsFargo1,78,4
31,7190.0,84.62,46.73,37.89,7152.11,WellsFargo1,78,4
32,7152.11,84.62,46.49,38.13,7113.98,WellsFargo1,78,4
33,7113.98,84.62,46.24,38.38,7075.6,WellsFargo1,78,4
34,7075.6,84.62,45.99,38.63,7036.97,WellsFargo1,78,4
35,7036.97,84.62,45.74,38.88,6998.09,WellsFargo1,78,4
36,6998.09,84.62,45.49,39.13,6958.96,WellsFargo1,78,4
37,6958.96,84.62,45.23,39.39,6919.57,WellsFargo1,78,4
38,6919.57,84.62,44.98,39.64,6879.93,WellsFargo1,78,4
39,6879.93,84.62,44.72,39.9,6840.03,WellsFargo1,78,4
40,6840.03,84.62,44.46,40.16,6799.87,WellsFargo1,78,4
41,6799.87,84.62,44.2,40.42,6759.45,WellsFargo1,78,4
42,6759.45,84.62,43.94,40.68,6718.77,WellsFargo1,78,4
43,6718.77,84.62,43.67,40.95,6677.82,WellsFargo1,78,4
44,6677.82,84.62,43.41,41.21,6636.61,WellsFargo1,78,4
45,6636.61,84.62,43.14,41.48,6595.13,WellsFargo1,78,4
46,6595.13,84.62,42.87,41.75,6553.38,WellsFargo1,78,4
47,6553.38,84.62,42.6,42.02,6511.36,WellsFargo1,78,4
48,6511.36,84.62,42.32,42.3,6469.06,WellsFargo1,78,4
49,6469.06,84.62,42.05,42.57,6426.49,WellsFargo1,78,4
50,6426.49,84.62,41.77,42.85,6383.64,WellsFargo1,78,4
51,6383.64,84.62,41.49,43.13,6340.51,WellsFargo1,78,4
52,6340.51,84.62,41.21,43.41,6297.1,WellsFargo1,78,4
53,6297.1,84.62,40.93,43.69,6253.41,WellsFargo1,78,4
54,6253.41,84.62,40.65,43.97,6209.44,WellsFargo1,78,4
55,6209.44,84.62,40.36,44.26,6165.18,WellsFargo1,78,4
56,6165.18,84.62,40.07,44.55,6120.63,WellsFargo1,78,4
57,6120.63,84.62,39.78,44.84,6075.79,WellsFargo1,78,4
58,6075.79,84.62,39.49,45.13,6030.66,WellsFargo1,78,4
59,6030.66,84.62,39.2,45.42,5985.24,WellsFargo1,78,4
60,5985.24,84.62,38.9,45.72,5939.52,WellsFargo1,78,4
61,5939.52,84.62,38.61,46.01,5893.51,WellsFargo1,78,4
62,5893.51,84.62,38.31,46.31,5847.2,WellsFargo1,78,4
63,5847.2,84.62,38.01,46.61,5800.59,WellsFargo1,78,4
64,5800.59,84.62,37.7,46.92,5753.67,WellsFargo1,78,4
65,5753.67,84.62,37.4,47.22,5706.45,WellsFargo1,78,4
66,5706.45,84.62,37.09,47.53,5658.92,WellsFargo1,78,4
67,5658.92,84.62,36.78,47.84,5611.08,WellsFargo1,78,4
68,5611.08,84.62,36.47,48.15,5562.93,WellsFargo1,78,4
69,5562.93,84.62,36.16,48.46,5514.47,WellsFargo1,78,4
70,5514.47,84.62,35.84,48.78,5465.69,WellsFargo1,78,4
71,5465.69,84.62,35.53,49.09,5416.6,WellsFargo1,78,4
72,5416.6,84.62,35.21,49.41,5367.19,WellsFargo1,78,4
73,5367.19,84.62,34.89,49.73,5317.46,WellsFargo1,78,4
74,5317.46,84.62,34.56,50.06,5267.4,WellsFargo1,78,4
75,5267.4,84.62,34.24,50.38,5217.02,WellsFargo1,78,4
76,5217.02,84.62,33.91,50.71,5166.31,WellsFargo1,78,4
77,5166.31,84.62,33.58,51.04,5115.27,WellsFargo1,78,4
78,5115.27,84.62,33.25,51.37,5063.9,WellsFargo1,78,4
79,5063.9,84.62,32.92,51.7,5012.2,WellsFargo1,78,4
80,5012.2,84.62,32.58,52.04,4960.16,WellsFargo1,78,4
81,4960.16,84.62,32.24,52.38,4907.78,WellsFargo1,78,4
82,4907.78,84.62,31.9,52.72,4855.06,WellsFargo1,78,4
83,4855.06,84.62,31.56,53.06,4802.0,WellsFargo1,78,4
84,4802.0,84.62,31.21,53.41,4748.59,WellsFargo1,78,4
85,4748.59,84.62,30.87,53.75,4694.84,WellsFargo1,78,4
86,4694.84,84.62,30.52,54.1,4640.74,WellsFargo1,78,4
87,4640.74,84.62,30.16,54.46,4586.28,WellsFargo1,78,4
88,4586.28,84.62,29.81,54.81,4531.47,WellsFargo1,78,4
89,4531.47,84.62,29.45,55.17,4476.3,WellsFargo1,78,4
90,4476.3,84.62,29.1,55.52,4420.78,WellsFargo1,78,4
91,4420.78,1411.05,28.74,1382.31,3038.47,WellsFargo1,78,4
92,3038.47,2677.1,19.75,2657.35,381.12,WellsFargo1,78,4
93,381.12,2677.1,2.48,2674.62,-2293.5,WellsFargo1,78,4
0,5000.0,333.0,36.0,297.0,4703.0,Car,78,5
1,4703.0,333.0,33.86,299.14,4403.86,Car,78,5
2,4403.86,333.0,31.71,301.29,4102.57,Car,78,5
3,4102.57,333.0,29.54,303.46,3799.11,Car,78,5
4,3799.11,333.0,27.35,305.65,3493.46,Car,78,5
5,3493.46,333.0,25.15,307.85,3185.61,Car,78,5
6,3185.61,333.0,22.94,310.06,2875.55,Car,78,5
7,2875.55,333.0,20.7,312.3,2563.25,Car,78,5
8,2563.25,333.0,18.46,314.54,2248.71,Car,78,5
9,2248.71,333.0,16.19,316.81,1931.9,Car,78,5
10,1931.9,333.0,13.91,319.09,1612.81,Car,78,5
11,1612.81,333.0,11.61,321.39,1291.42,Car,78,5
12,1291.42,333.0,9.3,323.7,967.72,Car,78,5
13,967.72,333.0,6.97,326.03,641.69,Car,78,5
14,641.69,333.0,4.62,328.38,313.31,Car,78,5
15,313.31,333.0,2.26,330.74,-17.43,Car,78,5
0,20000.0,1191.04,108.0,1083.04,18916.96,WellsFargo2,79,1
1,18916.96,1191.04,102.15,1088.89,17828.07,WellsFargo2,79,1
2,17828.07,1191.04,96.27,1094.77,16733.3,WellsFargo2,79,1
3,16733.3,1191.04,90.36,1100.68,15632.62,WellsFargo2,79,1
4,15632.62,1191.04,84.42,1106.62,14526.0,WellsFargo2,79,1
5,14526.0,1191.04,78.44,1112.6,13413.4,WellsFargo2,79,1
6,13413.4,1191.04,72.43,1118.61,12294.79,WellsFargo2,79,1
7,12294.79,1191.04,66.39,1124.65,11170.14,WellsFargo2,79,1
8,11170.14,1191.04,60.32,1130.72,10039.42,WellsFargo2,79,1
9,10039.42,1191.04,54.21,1136.83,8902.59,WellsFargo2,79,1
10,8902.59,1191.04,48.07,1142.97,7759.62,WellsFargo2,79,1
11,7759.62,1191.04,41.9,1149.14,6610.48,WellsFargo2,79,1
12,6610.48,1191.04,35.7,1155.34,5455.14,WellsFargo2,79,1
13,5455.14,1191.04,29.46,1161.58,4293.56,WellsFargo2,79,1
14,4293.56,1191.04,23.19,1167.85,3125.71,WellsFargo2,79,1
15,3125.71,1191.04,16.88,1174.16,1951.55,WellsFargo2,79,1
16,1951.55,1191.04,10.54,1180.5,771.05,WellsFargo2,79,1
17,771.05,1191.04,4.16,1186.88,-415.83,WellsFargo2,79,1
0,5000.0,333.0,36.0,297.0,4703.0,Car,79,2
1,4703.0,333.0,33.86,299.14,4403.86,Car,79,2
2,4403.86,333.0,31.71,301.29,4102.57,Car,79,2
3,4102.57,333.0,29.54,303.46,3799.11,Car,79,2
4,3799.11,333.0,27.35,305.65,3493.46,Car,79,2
5,3493.46,333.0,25.15,307.85,3185.61,Car,79,2
6,3185.61,333.0,22.94,310.06,2875.55,Car,79,2
7,2875.55,333.0,20.7,312.3,2563.25,Car,79,2
8,2563.25,333.0,18.46,314.54,2248.71,Car,79,2
9,2248.71,333.0,16.19,316.81,1931.9,Car,79,2
10,1931.9,333.0,13.91,319.09,1612.81,Car,79,2
11,1612.81,333.0,11.61,321.39,1291.42,Car,79,2
12,1291.42,333.0,9.3,323.7,967.72,Car,79,2
13,967.72,333.0,6.97,326.03,641.69,Car,79,2
14,641.69,333.0,4.62,328.38,313.31,Car,79,2
15,313.31,333.0,2.26,330.74,-17.43,Car,79,2
0,4000.0,70.0,16.0,54.0,3946.0,testing,79,3
1,3946.0,70.0,15.78,54.22,3891.78,testing,79,3
2,3891.78,70.0,15.57,54.43,3837.35,testing,79,3
3,3837.35,70.0,15.35,54.65,3782.7,testing,79,3
4,3782.7,70.0,15.13,54.87,3727.83,testing,79,3
5,3727.83,70.0,14.91,55.09,3672.74,testing,79,3
6,3672.74,70.0,14.69,55.31,3617.43,testing,79,3
7,3617.43,70.0,14.47,55.53,3561.9,testing,79,3
8,3561.9,70.0,14.25,55.75,3506.15,testing,79,3
9,3506.15,70.0,14.02,55.98,3450.17,testing,79,3
10,3450.17,70.0,13.8,56.2,3393.97,testing,79,3
11,3393.97,70.0,13.58,56.42,3337.55,testing,79,3
12,3337.55,70.0,13.35,56.65,3280.9,testing,79,3
13,3280.9,70.0,13.12,56.88,3224.02,testing,79,3
14,3224.02,70.0,12.9,57.1,3166.92,testing,79,3
15,3166.92,87.43,12.67,74.76,3092.16,testing,79,3
16,3092.16,1594.04,12.37,1581.67,1510.49,testing,79,3
17,1510.49,1594.04,6.04,1588.0,-77.51,testing,79,3
0,8250.57,84.62,53.63,30.99,8219.58,WellsFargo1,79,4
1,8219.58,84.62,53.43,31.19,8188.39,WellsFargo1,79,4
2,8188.39,84.62,53.22,31.4,8156.99,WellsFargo1,79,4
3,8156.99,84.62,53.02,31.6,8125.39,WellsFargo1,79,4
4,8125.39,84.62,52.82,31.8,8093.59,WellsFargo1,79,4
5,8093.59,84.62,52.61,32.01,8061.58,WellsFargo1,79,4
6,8061.58,84.62,52.4,32.22,8029.36,WellsFargo1,79,4
7,8029.36,84.62,52.19,32.43,7996.93,WellsFargo1,79,4
8,7996.93,84.62,51.98,32.64,7964.29,WellsFargo1,79,4
9,7964.29,84.62,51.77,32.85,7931.44,WellsFargo1,79,4
10,7931.44,84.62,51.55,33.07,7898.37,WellsFargo1,79,4
11,7898.37,84.62,51.34,33.28,7865.09,WellsFargo1,79,4
12,7865.09,84.62,51.12,33.5,7831.59,WellsFargo1,79,4
13,7831.59,84.62,50.91,33.71,7797.88,WellsFargo1,79,4
14,7797.88,84.62,50.69,33.93,7763.95,WellsFargo1,79,4
15,7763.95,84.62,50.47,34.15,7729.8,WellsFargo1,79,4
16,7729.8,84.62,50.24,34.38,7695.42,WellsFargo1,79,4
17,7695.42,162.13,50.02,112.11,7583.31,WellsFargo1,79,4
18,7583.31,1678.66,49.29,1629.37,5953.94,WellsFargo1,79,4
19,5953.94,1678.66,38.7,1639.96,4313.98,WellsFargo1,79,4
20,4313.98,1678.66,28.04,1650.62,2663.36,WellsFargo1,79,4
21,2663.36,1678.66,17.31,1661.35,1002.01,WellsFargo1,79,4
22,1002.01,1678.66,6.51,1672.15,-670.14,WellsFargo1,79,4
0,180000.0,1331.44,594.0,737.44,179262.56,mortgage,79,5
1,179262.56,1331.44,591.57,739.87,178522.69,mortgage,79,5
2,178522.69,1331.44,589.12,742.32,177780.37,mortgage,79,5
3,177780.37,1331.44,586.68,744.76,177035.61,mortgage,79,5
4,177035.61,1331.44,584.22,747.22,176288.39,mortgage,79,5
5,176288.39,1331.44,581.75,749.69,175538.7,mortgage,79,5
6,175538.7,1331.44,579.28,752.16,174786.54,mortgage,79,5
7,174786.54,1331.44,576.8,754.64,174031.9,mortgage,79,5
8,174031.9,1331.44,574.31,757.13,173274.77,mortgage,79,5
9,173274.77,1331.44,571.81,759.63,172515.14,mortgage,79,5
10,172515.14,1331.44,569.3,762.14,171753.0,mortgage,79,5
11,171753.0,1331.44,566.78,764.66,170988.34,mortgage,79,5
12,170988.34,1331.44,564.26,767.18,170221.16,mortgage,79,5
13,170221.16,1331.44,561.73,769.71,169451.45,mortgage,79,5
14,169451.45,1331.44,559.19,772.25,168679.2,mortgage,79,5
15,168679.2,1331.44,556.64,774.8,167904.4,mortgage,79,5
16,167904.4,1331.44,554.08,777.36,167127.04,mortgage,79,5
17,167127.04,1331.44,551.52,779.92,166347.12,mortgage,79,5
18,166347.12,1331.44,548.95,782.49,165564.63,mortgage,79,5
19,165564.63,1331.44,546.36,785.08,164779.55,mortgage,79,5
20,164779.55,1331.44,543.77,787.67,163991.88,mortgage,79,5
21,163991.88,1331.44,541.17,790.27,163201.61,mortgage,79,5
22,163201.61,2001.58,538.57,1463.01,161738.6,mortgage,79,5
23,161738.6,3010.1,533.74,2476.36,159262.24,mortgage,79,5
24,159262.24,3010.1,525.57,2484.53,156777.71,mortgage,79,5
25,156777.71,3010.1,517.37,2492.73,154284.98,mortgage,79,5
26,154284.98,3010.1,509.14,2500.96,151784.02,mortgage,79,5
27,151784.02,3010.1,500.89,2509.21,149274.81,mortgage,79,5
28,149274.81,3010.1,492.61,2517.49,146757.32,mortgage,79,5
29,146757.32,3010.1,484.3,2525.8,144231.52,mortgage,79,5
30,144231.52,3010.1,475.96,2534.14,141697.38,mortgage,79,5
31,141697.38,3010.1,467.6,2542.5,139154.88,mortgage,79,5
32,139154.88,3010.1,459.21,2550.89,136603.99,mortgage,79,5
33,136603.99,3010.1,450.79,2559.31,134044.68,mortgage,79,5
34,134044.68,3010.1,442.35,2567.75,131476.93,mortgage,79,5
35,131476.93,3010.1,433.87,2576.23,128900.7,mortgage,79,5
36,128900.7,3010.1,425.37,2584.73,126315.97,mortgage,79,5
37,126315.97,3010.1,416.84,2593.26,123722.71,mortgage,79,5
38,123722.71,3010.1,408.28,2601.82,121120.89,mortgage,79,5
39,121120.89,3010.1,399.7,2610.4,118510.49,mortgage,79,5
40,118510.49,3010.1,391.08,2619.02,115891.47,mortgage,79,5
41,115891.47,3010.1,382.44,2627.66,113263.81,mortgage,79,5
42,113263.81,3010.1,373.77,2636.33,110627.48,mortgage,79,5
43,110627.48,3010.1,365.07,2645.03,107982.45,mortgage,79,5
44,107982.45,3010.1,356.34,2653.76,105328.69,mortgage,79,5
45,105328.69,3010.1,347.58,2662.52,102666.17,mortgage,79,5
46,102666.17,3010.1,338.8,2671.3,99994.87,mortgage,79,5
47,99994.87,3010.1,329.98,2680.12,97314.75,mortgage,79,5
48,97314.75,3010.1,321.14,2688.96,94625.79,mortgage,79,5
49,94625.79,3010.1,312.27,2697.83,91927.96,mortgage,79,5
50,91927.96,3010.1,303.36,2706.74,89221.22,mortgage,79,5
51,89221.22,3010.1,294.43,2715.67,86505.55,mortgage,79,5
52,86505.55,3010.1,285.47,2724.63,83780.92,mortgage,79,5
53,83780.92,3010.1,276.48,2733.62,81047.3,mortgage,79,5
54,81047.3,3010.1,267.46,2742.64,78304.66,mortgage,79,5
55,78304.66,3010.1,258.41,2751.69,75552.97,mortgage,79,5
56,75552.97,3010.1,249.32,2760.78,72792.19,mortgage,79,5
57,72792.19,3010.1,240.21,2769.89,70022.3,mortgage,79,5
58,70022.3,3010.1,231.07,2779.03,67243.27,mortgage,79,5
59,67243.27,3010.1,221.9,2788.2,64455.07,mortgage,79,5
60,64455.07,3010.1,212.7,2797.4,61657.67,mortgage,79,5
61,61657.67,3010.1,203.47,2806.63,58851.04,mortgage,79,5
62,58851.04,3010.1,194.21,2815.89,56035.15,mortgage,79,5
63,56035.15,3010.1,184.92,2825.18,53209.97,mortgage,79,5
64,53209.97,3010.1,175.59,2834.51,50375.46,mortgage,79,5
65,50375.46,3010.1,166.24,2843.86,47531.6,mortgage,79,5
66,47531.6,3010.1,156.85,2853.25,44678.35,mortgage,79,5
67,44678.35,3010.1,147.44,2862.66,41815.69,mortgage,79,5
68,41815.69,3010.1,137.99,2872.11,38943.58,mortgage,79,5
69,38943.58,3010.1,128.51,2881.59,36061.99,mortgage,79,5
70,36061.99,3010.1,119.0,2891.1,33170.89,mortgage,79,5
71,33170.89,3010.1,109.46,2900.64,30270.25,mortgage,79,5
72,30270.25,3010.1,99.89,2910.21,27360.04,mortgage,79,5
73,27360.04,3010.1,90.29,2919.81,24440.23,mortgage,79,5
74,24440.23,3010.1,80.65,2929.45,21510.78,mortgage,79,5
75,21510.78,3010.1,70.99,2939.11,18571.67,mortgage,79,5
76,18571.67,3010.1,61.29,2948.81,15622.86,mortgage,79,5
77,15622.86,3010.1,51.56,2958.54,12664.32,mortgage,79,5
78,12664.32,3010.1,41.79,2968.31,9696.01,mortgage,79,5
79,9696.01,3010.1,32.0,2978.1,6717.91,mortgage,79,5
80,6717.91,3010.1,22.17,2987.93,3729.98,mortgage,79,5
81,3729.98,3010.1,12.31,2997.79,732.19,mortgage,79,5
82,732.19,3010.1,2.42,3007.68,-2275.49,mortgage,79,5
0,20000.0,1191.04,108.0,1083.04,18916.96,WellsFargo2,80,1
1,18916.96,1191.04,102.15,1088.89,17828.07,WellsFargo2,80,1
2,17828.07,1191.04,96.27,1094.77,16733.3,WellsFargo2,80,1
3,16733.3,1191.04,90.36,1100.68,15632.62,WellsFargo2,80,1
4,15632.62,1191.04,84.42,1106.62,14526.0,WellsFargo2,80,1
5,14526.0,1191.04,78.44,1112.6,13413.4,WellsFargo2,80,1
6,13413.4,1191.04,72.43,1118.61,12294.79,WellsFargo2,80,1
7,12294.79,1191.04,66.39,1124.65,11170.14,WellsFargo2,80,1
8,11170.14,1191.04,60.32,1130.72,10039.42,WellsFargo2,80,1
9,10039.42,1191.04,54.21,1136.83,8902.59,WellsFargo2,80,1
10,8902.59,1191.04,48.07,1142.97,7759.62,WellsFargo2,80,1
11,7759.62,1191.04,41.9,1149.14,6610.48,WellsFargo2,80,1
12,6610.48,1191.04,35.7,1155.34,5455.14,WellsFargo2,80,1
13,5455.14,1191.04,29.46,1161.58,4293.56,WellsFargo2,80,1
14,4293.56,1191.04,23.19,1167.85,3125.71,WellsFargo2,80,1
15,3125.71,1191.04,16.88,1174.16,1951.55,WellsFargo2,80,1
16,1951.55,1191.04,10.54,1180.5,771.05,WellsFargo2,80,1
17,771.05,1191.04,4.16,1186.88,-415.83,WellsFargo2,80,1
0,5000.0,333.0,36.0,297.0,4703.0,Car,80,2
1,4703.0,333.0,33.86,299.14,4403.86,Car,80,2
2,4403.86,333.0,31.71,301.29,4102.57,Car,80,2
3,4102.57,333.0,29.54,303.46,3799.11,Car,80,2
4,3799.11,333.0,27.35,305.65,3493.46,Car,80,2
5,3493.46,333.0,25.15,307.85,3185.61,Car,80,2
6,3185.61,333.0,22.94,310.06,2875.55,Car,80,2
7,2875.55,333.0,20.7,312.3,2563.25,Car,80,2
8,2563.25,333.0,18.46,314.54,2248.71,Car,80,2
9,2248.71,333.0,16.19,316.81,1931.9,Car,80,2
10,1931.9,333.0,13.91,319.09,1612.81,Car,80,2
11,1612.81,333.0,11.61,321.39,1291.42,Car,80,2
12,1291.42,333.0,9.3,323.7,967.72,Car,80,2
13,967.72,333.0,6.97,326.03,641.69,Car,80,2
14,641.69,333.0,4.62,328.38,313.31,Car,80,2
15,313.31,333.0,2.26,330.74,-17.43,Car,80,2
0,4000.0,70.0,16.0,54.0,3946.0,testing,80,3
1,3946.0,70.0,15.78,54.22,3891.78,testing,80,3
2,3891.78,70.0,15.57,54.43,3837.35,testing,80,3
3,3837.35,70.0,15.35,54.65,3782.7,testing,80,3
4,3782.7,70.0,15.13,54.87,3727.83,testing,80,3
5,3727.83,70.0,14.91,55.09,3672.74,testing,80,3
6,3672.74,70.0,14.69,55.31,3617.43,testing,80,3
7,3617.43,70.0,14.47,55.53,3561.9,testing,80,3
8,3561.9,70.0,14.25,55.75,3506.15,testing,80,3
9,3506.15,70.0,14.02,55.98,3450.17,testing,80,3
10,3450.17,70.0,13.8,56.2,3393.97,testing,80,3
11,3393.97,70.0,13.58,56.42,3337.55,testing,80,3
12,3337.55,70.0,13.35,56.65,3280.9,testing,80,3
13,3280.9,70.0,13.12,56.88,3224.02,testing,80,3
14,3224.02,70.0,12.9,57.1,3166.92,testing,80,3
15,3166.92,87.43,12.67,74.76,3092.16,testing,80,3
16,3092.16,1594.04,12.37,1581.67,1510.49,testing,80,3
17,1510.49,1594.04,6.04,1588.0,-77.51,testing,80,3
0,180000.0,1331.44,594.0,737.44,179262.56,mortgage,80,4
1,179262.56,1331.44,591.57,739.87,178522.69,mortgage,80,4
2,178522.69,1331.44,589.12,742.32,177780.37,mortgage,80,4
3,177780.37,1331.44,586.68,744.76,177035.61,mortgage,80,4
4,177035.61,1331.44,584.22,747.22,176288.39,mortgage,80,4
5,176288.39,1331.44,581.75,749.69,175538.7,mortgage,80,4
6,175538.7,1331.44,579.28,752.16,174786.54,mortgage,80,4
7,174786.54,1331.44,576.8,754.64,174031.9,mortgage,80,4
8,174031.9,1331.44,574.31,757.13,173274.77,mortgage,80,4
9,173274.77,1331.44,571.81,759.63,172515.14,mortgage,80,4
10,172515.14,1331.44,569.3,762.14,171753.0,mortgage,80,4
11,171753.0,1331.44,566.78,764.66,170988.34,mortgage,80,4
12,170988.34,1331.44,564.26,767.18,170221.16,mortgage,80,4
13,170221.16,1331.44,561.73,769.71,169451.45,mortgage,80,4
14,169451.45,1331.44,559.19,772.25,168679.2,mortgage,80,4
15,168679.2,1331.44,556.64,774.8,167904.4,mortgage,80,4
16,167904.4,1331.44,554.08,777.36,167127.04,mortgage,80,4
17,167127.04,1408.95,551.52,857.43,166269.61,mortgage,80,4
18,166269.61,2925.48,548.69,2376.79,163892.82,mortgage,80,4
19,163892.82,2925.48,540.85,2384.63,161508.19,mortgage,80,4
20,161508.19,2925.48,532.98,2392.5,159115.69,mortgage,80,4
21,159115.69,2925.48,525.08,2400.4,156715.29,mortgage,80,4
22,156715.29,2925.48,517.16,2408.32,154306.97,mortgage,80,4
23,154306.97,2925.48,509.21,2416.27,151890.7,mortgage,80,4
24,151890.7,2925.48,501.24,2424.24,149466.46,mortgage,80,4
25,149466.46,2925.48,493.24,2432.24,147034.22,mortgage,80,4
26,147034.22,2925.48,485.21,2440.27,144593.95,mortgage,80,4
27,144593.95,2925.48,477.16,2448.32,142145.63,mortgage,80,4
28,142145.63,2925.48,469.08,2456.4,139689.23,mortgage,80,4
29,139689.23,2925.48,460.97,2464.51,137224.72,mortgage,80,4
30,137224.72,2925.48,452.84,2472.64,134752.08,mortgage,80,4
31,134752.08,2925.48,444.68,2480.8,132271.28,mortgage,80,4
32,132271.28,2925.48,436.5,2488.98,129782.3,mortgage,80,4
33,129782.3,2925.48,428.28,2497.2,127285.1,mortgage,80,4
34,127285.1,2925.48,420.04,2505.44,124779.66,mortgage,80,4
35,124779.66,2925.48,411.77,2513.71,122265.95,mortgage,80,4
36,122265.95,2925.48,403.48,2522.0,119743.95,mortgage,80,4
37,119743.95,2925.48,395.16,2530.32,117213.63,mortgage,80,4
38,117213.63,2925.48,386.8,2538.68,114674.95,mortgage,80,4
39,114674.95,2925.48,378.43,2547.05,112127.9,mortgage,80,4
40,112127.9,2925.48,370.02,2555.46,109572.44,mortgage,80,4
41,109572.44,2925.48,361.59,2563.89,107008.55,mortgage,80,4
42,107008.55,2925.48,353.13,2572.35,104436.2,mortgage,80,4
43,104436.2,2925.48,344.64,2580.84,101855.36,mortgage,80,4
44,101855.36,2925.48,336.12,2589.36,99266.0,mortgage,80,4
45,99266.0,2925.48,327.58,2597.9,96668.1,mortgage,80,4
46,96668.1,2925.48,319.0,2606.48,94061.62,mortgage,80,4
47,94061.62,2925.48,310.4,2615.08,91446.54,mortgage,80,4
48,91446.54,2925.48,301.77,2623.71,88822.83,mortgage,80,4
49,88822.83,2925.48,293.12,2632.36,86190.47,mortgage,80,4
50,86190.47,2925.48,284.43,2641.05,83549.42,mortgage,80,4
51,83549.42,2925.48,275.71,2649.77,80899.65,mortgage,80,4
52,80899.65,2925.48,266.97,2658.51,78241.14,mortgage,80,4
53,78241.14,2925.48,258.2,2667.28,75573.86,mortgage,80,4
54,75573.86,2925.48,249.39,2676.09,72897.77,mortgage,80,4
55,72897.77,2925.48,240.56,2684.92,70212.85,mortgage,80,4
56,70212.85,2925.48,231.7,2693.78,67519.07,mortgage,80,4
57,67519.07,2925.48,222.81,2702.67,64816.4,mortgage,80,4
58,64816.4,2925.48,213.89,2711.59,62104.81,mortgage,80,4
59,62104.81,2925.48,204.95,2720.53,59384.28,mortgage,80,4
60,59384.28,2925.48,195.97,2729.51,56654.77,mortgage,80,4
61,56654.77,2925.48,186.96,2738.52,53916.25,mortgage,80,4
62,53916.25,2925.48,177.92,2747.56,51168.69,mortgage,80,4
63,51168.69,2925.48,168.86,2756.62,48412.07,mortgage,80,4
64,48412.07,2925.48,159.76,2765.72,45646.35,mortgage,80,4
65,45646.35,2925.48,150.63,2774.85,42871.5,mortgage,80,4
66,42871.5,2925.48,141.48,2784.0,40087.5,mortgage,80,4
67,40087.5,2925.48,132.29,2793.19,37294.31,mortgage,80,4
68,37294.31,2925.48,123.07,2802.41,34491.9,mortgage,80,4
69,34491.9,2925.48,113.82,2811.66,31680.24,mortgage,80,4
70,31680.24,2925.48,104.54,2820.94,28859.3,mortgage,80,4
71,28859.3,2925.48,95.24,2830.24,26029.06,mortgage,80,4
72,26029.06,2925.48,85.9,2839.58,23189.48,mortgage,80,4
73,23189.48,2925.48,76.53,2848.95,20340.53,mortgage,80,4
74,20340.53,2925.48,67.12,2858.36,17482.17,mortgage,80,4
75,17482.17,2925.48,57.69,2867.79,14614.38,mortgage,80,4
76,14614.38,2925.48,48.23,2877.25,11737.13,mortgage,80,4
77,11737.13,2925.48,38.73,2886.75,8850.38,mortgage,80,4
78,8850.38,2925.48,29.21,2896.27,5954.11,mortgage,80,4
79,5954.11,2925.48,19.65,2905.83,3048.28,mortgage,80,4
80,3048.28,2925.48,10.06,2915.42,132.86,mortgage,80,4
81,132.86,2925.48,0.44,2925.04,-2792.18,mortgage,80,4
0,8250.57,84.62,53.63,30.99,8219.58,WellsFargo1,80,5
1,8219.58,84.62,53.43,31.19,8188.39,WellsFargo1,80,5
2,8188.39,84.62,53.22,31.4,8156.99,WellsFargo1,80,5
3,8156.99,84.62,53.02,31.6,8125.39,WellsFargo1,80,5
4,8125.39,84.62,52.82,31.8,8093.59,WellsFargo1,80,5
5,8093.59,84.62,52.61,32.01,8061.58,WellsFargo1,80,5
6,8061.58,84.62,52.4,32.22,8029.36,WellsFargo1,80,5
7,8029.36,84.62,52.19,32.43,7996.93,WellsFargo1,80,5
8,7996.93,84.62,51.98,32.64,7964.29,WellsFargo1,80,5
9,7964.29,84.62,51.77,32.85,7931.44,WellsFargo1,80,5
10,7931.44,84.62,51.55,33.07,7898.37,WellsFargo1,80,5
11,7898.37,84.62,51.34,33.28,7865.09,WellsFargo1,80,5
12,7865.09,84.62,51.12,33.5,7831.59,WellsFargo1,80,5
13,7831.59,84.62,50.91,33.71,7797.88,WellsFargo1,80,5
14,7797.88,84.62,50.69,33.93,7763.95,WellsFargo1,80,5
15,7763.95,84.62,50.47,34.15,7729.8,WellsFargo1,80,5
16,7729.8,84.62,50.24,34.38,7695.42,WellsFargo1,80,5
17,7695.42,84.62,50.02,34.6,7660.82,WellsFargo1,80,5
18,7660.82,84.62,49.8,34.82,7626.0,WellsFargo1,80,5
19,7626.0,84.62,49.57,35.05,7590.95,WellsFargo1,80,5
20,7590.95,84.62,49.34,35.28,7555.67,WellsFargo1,80,5
21,7555.67,84.62,49.11,35.51,7520.16,WellsFargo1,80,5
22,7520.16,84.62,48.88,35.74,7484.42,WellsFargo1,80,5
23,7484.42,84.62,48.65,35.97,7448.45,WellsFargo1,80,5
24,7448.45,84.62,48.41,36.21,7412.24,WellsFargo1,80,5
25,7412.24,84.62,48.18,36.44,7375.8,WellsFargo1,80,5
26,7375.8,84.62,47.94,36.68,7339.12,WellsFargo1,80,5
27,7339.12,84.62,47.7,36.92,7302.2,WellsFargo1,80,5
28,7302.2,84.62,47.46,37.16,7265.04,WellsFargo1,80,5
29,7265.04,84.62,47.22,37.4,7227.64,WellsFargo1,80,5
30,7227.64,84.62,46.98,37.64,7190.0,WellsFargo1,80,5
31,7190.0,84.62,46.73,37.89,7152.11,WellsFargo1,80,5
32,7152.11,84.62,46.49,38.13,7113.98,WellsFargo1,80,5
33,7113.98,84.62,46.24,38.38,7075.6,WellsFargo1,80,5
34,7075.6,84.62,45.99,38.63,7036.97,WellsFargo1,80,5
35,7036.97,84.62,45.74,38.88,6998.09,WellsFargo1,80,5
36,6998.09,84.62,45.49,39.13,6958.96,WellsFargo1,80,5
37,6958.96,84.62,45.23,39.39,6919.57,WellsFargo1,80,5
38,6919.57,84.62,44.98,39.64,6879.93,WellsFargo1,80,5
39,6879.93,84.62,44.72,39.9,6840.03,WellsFargo1,80,5
40,6840.03,84.62,44.46,40.16,6799.87,WellsFargo1,80,5
41,6799.87,84.62,44.2,40.42,6759.45,WellsFargo1,80,5
42,6759.45,84.62,43.94,40.68,6718.77,WellsFargo1,80,5
43,6718.77,84.62,43.67,40.95,6677.82,WellsFargo1,80,5
44,6677.82,84.62,43.41,41.21,6636.61,WellsFargo1,80,5
45,6636.61,84.62,43.14,41.48,6595.13,WellsFargo1,80,5
46,6595.13,84.62,42.87,41.75,6553.38,WellsFargo1,80,5
47,6553.38,84.62,42.6,42.02,6511.36,WellsFargo1,80,5
48,6511.36,84.62,42.32,42.3,6469.06,WellsFargo1,80,5
49,6469.06,84.62,42.05,42.57,6426.49,WellsFargo1,80,5
50,6426.49,84.62,41.77,42.85,6383.64,WellsFargo1,80,5
51,6383.64,84.62,41.49,43.13,6340.51,WellsFargo1,80,5
52,6340.51,84.62,41.21,43.41,6297.1,WellsFargo1,80,5
53,6297.1,84.62,40.93,43.69,6253.41,WellsFargo1,80,5
54,6253.41,84.62,40.65,43.97,6209.44,WellsFargo1,80,5
55,6209.44,84.62,40.36,44.26,6165.18,WellsFargo1,80,5
56,6165.18,84.62,40.07,44.55,6120.63,WellsFargo1,80,5
57,6120.63,84.62,39.78,44.84,6075.79,WellsFargo1,80,5
58,6075.79,84.62,39.49,45.13,6030.66,WellsFargo1,80,5
59,6030.66,84.62,39.2,45.42,5985.24,WellsFargo1,80,5
60,5985.24,84.62,38.9,45.72,5939.52,WellsFargo1,80,5
61,5939.52,84.62,38.61,46.01,5893.51,WellsFargo1,80,5
62,5893.51,84.62,38.31,46.31,5847.2,WellsFargo1,80,5
63,5847.2,84.62,38.01,46.61,5800.59,WellsFargo1,80,5
64,5800.59,84.62,37.7,46.92,5753.67,WellsFargo1,80,5
65,5753.67,84.62,37.4,47.22,5706.45,WellsFargo1,80,5
66,5706.45,84.62,37.09,47.53,5658.92,WellsFargo1,80,5
67,5658.92,84.62,36.78,47.84,5611.08,WellsFargo1,80,5
68,5611.08,84.62,36.47,48.15,5562.93,WellsFargo1,80,5
69,5562.93,84.62,36.16,48.46,5514.47,WellsFargo1,80,5
70,5514.47,84.62,35.84,48.78,5465.69,WellsFargo1,80,5
71,5465.69,84.62,35.53,49.09,5416.6,WellsFargo1,80,5
72,5416.6,84.62,35.21,49.41,5367.19,WellsFargo1,80,5
73,5367.19,84.62,34.89,49.73,5317.46,WellsFargo1,80,5
74,5317.46,84.62,34.56,50.06,5267.4,WellsFargo1,80,5
75,5267.4,84.62,34.24,50.38,5217.02,WellsFargo1,80,5
76,5217.02,84.62,33.91,50.71,5166.31,WellsFargo1,80,5
77,5166.31,84.62,33.58,51.04,5115.27,WellsFargo1,80,5
78,5115.27,84.62,33.25,51.37,5063.9,WellsFargo1,80,5
79,5063.9,84.62,32.92,51.7,5012.2,WellsFargo1,80,5
80,5012.2,84.62,32.58,52.04,4960.16,WellsFargo1,80,5
81,4960.16,2876.8,32.24,2844.56,2115.6,WellsFargo1,80,5
82,2115.6,3010.1,13.75,2996.35,-880.75,WellsFargo1,80,5
0,20000.0,1191.04,108.0,1083.04,18916.96,WellsFargo2,81,1
1,18916.96,1191.04,102.15,1088.89,17828.07,WellsFargo2,81,1
2,17828.07,1191.04,96.27,1094.77,16733.3,WellsFargo2,81,1
3,16733.3,1191.04,90.36,1100.68,15632.62,WellsFargo2,81,1
4,15632.62,1191.04,84.42,1106.62,14526.0,WellsFargo2,81,1
5,14526.0,1191.04,78.44,1112.6,13413.4,WellsFargo2,81,1
6,13413.4,1191.04,72.43,1118.61,12294.79,WellsFargo2,81,1
7,12294.79,1191.04,66.39,1124.65,11170.14,WellsFargo2,81,1
8,11170.14,1191.04,60.32,1130.72,10039.42,WellsFargo2,81,1
9,10039.42,1191.04,54.21,1136.83,8902.59,WellsFargo2,81,1
10,8902.59,1191.04,48.07,1142.97,7759.62,WellsFargo2,81,1
11,7759.62,1191.04,41.9,1149.14,6610.48,WellsFargo2,81,1
12,6610.48,1191.04,35.7,1155.34,5455.14,WellsFargo2,81,1
13,5455.14,1191.04,29.46,1161.58,4293.56,WellsFargo2,81,1
14,4293.56,1191.04,23.19,1167.85,3125.71,WellsFargo2,81,1
15,3125.71,1191.04,16.88,1174.16,1951.55,WellsFargo2,81,1
16,1951.55,1191.04,10.54,1180.5,771.05,WellsFargo2,81,1
17,771.05,1191.04,4.16,1186.88,-415.83,WellsFargo2,81,1
0,5000.0,333.0,36.0,297.0,4703.0,Car,81,2
1,4703.0,333.0,33.86,299.14,4403.86,Car,81,2
2,4403.86,333.0,31.71,301.29,4102.57,Car,81,2
3,4102.57,333.0,29.54,303.46,3799.11,Car,81,2
4,3799.11,333.0,27.35,305.65,3493.46,Car,81,2
5,3493.46,333.0,25.15,307.85,3185.61,Car,81,2
6,3185.61,333.0,22.94,310.06,2875.55,Car,81,2
7,2875.55,333.0,20.7,312.3,2563.25,Car,81,2
8,2563.25,333.0,18.46,314.54,2248.71,Car,81,2
9,2248.71,333.0,16.19,316.81,1931.9,Car,81,2
10,1931.9,333.0,13.91,319.09,1612.81,Car,81,2
11,1612.81,333.0,11.61,321.39,1291.42,Car,81,2
12,1291.42,333.0,9.3,323.7,967.72,Car,81,2
13,967.72,333.0,6.97,326.03,641.69,Car,81,2
14,641.69,333.0,4.62,328.38,313.31,Car,81,2
15,313.31,333.0,2.26,330.74,-17.43,Car,81,2
0,8250.57,84.62,53.63,30.99,8219.58,WellsFargo1,81,3
1,8219.58,84.62,53.43,31.19,8188.39,WellsFargo1,81,3
2,8188.39,84.62,53.22,31.4,8156.99,WellsFargo1,81,3
3,8156.99,84.62,53.02,31.6,8125.39,WellsFargo1,81,3
4,8125.39,84.62,52.82,31.8,8093.59,WellsFargo1,81,3
5,8093.59,84.62,52.61,32.01,8061.58,WellsFargo1,81,3
6,8061.58,84.62,52.4,32.22,8029.36,WellsFargo1,81,3
7,8029.36,84.62,52.19,32.43,7996.93,WellsFargo1,81,3
8,7996.93,84.62,51.98,32.64,7964.29,WellsFargo1,81,3
9,7964.29,84.62,51.77,32.85,7931.44,WellsFargo1,81,3
10,7931.44,84.62,51.55,33.07,7898.37,WellsFargo1,81,3
11,7898.37,84.62,51.34,33.28,7865.09,WellsFargo1,81,3
12,7865.09,84.62,51.12,33.5,7831.59,WellsFargo1,81,3
13,7831.59,84.62,50.91,33.71,7797.88,WellsFargo1,81,3
14,7797.88,84.62,50.69,33.93,7763.95,WellsFargo1,81,3
15,7763.95,102.05,50.47,51.58,7712.37,WellsFargo1,81,3
16,7712.37,1608.66,50.13,1558.53,6153.84,WellsFargo1,81,3
17,6153.84,1608.66,40.0,1568.66,4585.18,WellsFargo1,81,3
18,4585.18,1608.66,29.8,1578.86,3006.32,WellsFargo1,81,3
19,3006.32,1608.66,19.54,1589.12,1417.2,WellsFargo1,81,3
20,1417.2,1608.66,9.21,1599.45,-182.25,WellsFargo1,81,3
0,4000.0,70.0,16.0,54.0,3946.0,testing,81,4
1,3946.0,70.0,15.78,54.22,3891.78,testing,81,4
2,3891.78,70.0,15.57,54.43,3837.35,testing,81,4
3,3837.35,70.0,15.35,54.65,3782.7,testing,81,4
4,3782.7,70.0,15.13,54.87,3727.83,testing,81,4
5,3727.83,70.0,14.91,55.09,3672.74,testing,81,4
6,3672.74,70.0,14.69,55.31,3617.43,testing,81,4
7,3617.43,70.0,14.47,55.53,3561.9,testing,81,4
8,3561.9,70.0,14.25,55.75,3506.15,testing,81,4
9,3506.15,70.0,14.02,55.98,3450.17,testing,81,4
10,3450.17,70.0,13.8,56.2,3393.97,testing,81,4
11,3393.97,70.0,13.58,56.42,3337.55,testing,81,4
12,3337.55,70.0,13.35,56.65,3280.9,testing,81,4
13,3280.9,70.0,13.12,56.88,3224.02,testing,81,4
14,3224.02,70.0,12.9,57.1,3166.92,testing,81,4
15,3166.92,70.0,12.67,57.33,3109.59,testing,81,4
16,3109.59,70.0,12.44,57.56,3052.03,testing,81,4
17,3052.03,70.0,12.21,57.79,2994.24,testing,81,4
18,2994.24,70.0,11.98,58.02,2936.22,testing,81,4
19,2936.22,70.0,11.74,58.26,2877.96,testing,81,4
20,2877.96,252.25,11.51,240.74,2637.22,testing,81,4
21,2637.22,1678.66,10.55,1668.11,969.11,testing,81,4
22,969.11,1678.66,3.88,1674.78,-705.67,testing,81,4
0,180000.0,1331.44,594.0,737.44,179262.56,mortgage,81,5
1,179262.56,1331.44,591.57,739.87,178522.69,mortgage,81,5
2,178522.69,1331.44,589.12,742.32,177780.37,mortgage,81,5
3,177780.37,1331.44,586.68,744.76,177035.61,mortgage,81,5
4,177035.61,1331.44,584.22,747.22,176288.39,mortgage,81,5
5,176288.39,1331.44,581.75,749.69,175538.7,mortgage,81,5
6,175538.7,1331.44,579.28,752.16,174786.54,mortgage,81,5
7,174786.54,1331.44,576.8,754.64,174031.9,mortgage,81,5
8,174031.9,1331.44,574.31,757.13,173274.77,mortgage,81,5
9,173274.77,1331.44,571.81,759.63,172515.14,mortgage,81,5
10,172515.14,1331.44,569.3,762.14,171753.0,mortgage,81,5
11,171753.0,1331.44,566.78,764.66,170988.34,mortgage,81,5
12,170988.34,1331.44,564.26,767.18,170221.16,mortgage,81,5
13,170221.16,1331.44,561.73,769.71,169451.45,mortgage,81,5
14,169451.45,1331.44,559.19,772.25,168679.2,mortgage,81,5
15,168679.2,1331.44,556.64,774.8,167904.4,mortgage,81,5
16,167904.4,1331.44,554.08,777.36,167127.04,mortgage,81,5
17,167127.04,1331.44,551.52,779.92,166347.12,mortgage,81,5
18,166347.12,1331.44,548.95,782.49,165564.63,mortgage,81,5
19,165564.63,1331.44,546.36,785.08,164779.55,mortgage,81,5
20,164779.55,1331.44,543.77,787.67,163991.88,mortgage,81,5
21,163991.88,1331.44,541.17,790.27,163201.61,mortgage,81,5
22,163201.61,2037.11,538.57,1498.54,161703.07,mortgage,81,5
23,161703.07,3010.1,533.62,2476.48,159226.59,mortgage,81,5
24,159226.59,3010.1,525.45,2484.65,156741.94,mortgage,81,5
25,156741.94,3010.1,517.25,2492.85,154249.09,mortgage,81,5
26,154249.09,3010.1,509.02,2501.08,151748.01,mortgage,81,5
27,151748.01,3010.1,500.77,2509.33,149238.68,mortgage,81,5
28,149238.68,3010.1,492.49,2517.61,146721.07,mortgage,81,5
29,146721.07,3010.1,484.18,2525.92,144195.15,mortgage,81,5
30,144195.15,3010.1,475.84,2534.26,141660.89,mortgage,81,5
31,141660.89,3010.1,467.48,2542.62,139118.27,mortgage,81,5
32,139118.27,3010.1,459.09,2551.01,136567.26,mortgage,81,5
33,136567.26,3010.1,450.67,2559.43,134007.83,mortgage,81,5
34,134007.83,3010.1,442.23,2567.87,131439.96,mortgage,81,5
35,131439.96,3010.1,433.75,2576.35,128863.61,mortgage,81,5
36,128863.61,3010.1,425.25,2584.85,126278.76,mortgage,81,5
37,126278.76,3010.1,416.72,2593.38,123685.38,mortgage,81,5
38,123685.38,3010.1,408.16,2601.94,121083.44,mortgage,81,5
39,121083.44,3010.1,399.58,2610.52,118472.92,mortgage,81,5
40,118472.92,3010.1,390.96,2619.14,115853.78,mortgage,81,5
41,115853.78,3010.1,382.32,2627.78,113226.0,mortgage,81,5
42,113226.0,3010.1,373.65,2636.45,110589.55,mortgage,81,5
43,110589.55,3010.1,364.95,2645.15,107944.4,mortgage,81,5
44,107944.4,3010.1,356.22,2653.88,105290.52,mortgage,81,5
45,105290.52,3010.1,347.46,2662.64,102627.88,mortgage,81,5
46,102627.88,3010.1,338.67,2671.43,99956.45,mortgage,81,5
47,99956.45,3010.1,329.86,2680.24,97276.21,mortgage,81,5
48,97276.21,3010.1,321.01,2689.09,94587.12,mortgage,81,5
49,94587.12,3010.1,312.14,2697.96,91889.16,mortgage,81,5
50,91889.16,3010.1,303.23,2706.87,89182.29,mortgage,81,5
51,89182.29,3010.1,294.3,2715.8,86466.49,mortgage,81,5
52,86466.49,3010.1,285.34,2724.76,83741.73,mortgage,81,5
53,83741.73,3010.1,276.35,2733.75,81007.98,mortgage,81,5
54,81007.98,3010.1,267.33,2742.77,78265.21,mortgage,81,5
55,78265.21,3010.1,258.28,2751.82,75513.39,mortgage,81,5
56,75513.39,3010.1,249.19,2760.91,72752.48,mortgage,81,5
57,72752.48,3010.1,240.08,2770.02,69982.46,mortgage,81,5
58,69982.46,3010.1,230.94,2779.16,67203.3,mortgage,81,5
59,67203.3,3010.1,221.77,2788.33,64414.97,mortgage,81,5
60,64414.97,3010.1,212.57,2797.53,61617.44,mortgage,81,5
61,61617.44,3010.1,203.34,2806.76,58810.68,mortgage,81,5
62,58810.68,3010.1,194.08,2816.02,55994.66,mortgage,81,5
63,55994.66,3010.1,184.78,2825.32,53169.34,mortgage,81,5
64,53169.34,3010.1,175.46,2834.64,50334.7,mortgage,81,5
65,50334.7,3010.1,166.1,2844.0,47490.7,mortgage,81,5
66,47490.7,3010.1,156.72,2853.38,44637.32,mortgage,81,5
67,44637.32,3010.1,147.3,2862.8,41774.52,mortgage,81,5
68,41774.52,3010.1,137.86,2872.24,38902.28,mortgage,81,5
69,38902.28,3010.1,128.38,2881.72,36020.56,mortgage,81,5
70,36020.56,3010.1,118.87,2891.23,33129.33,mortgage,81,5
71,33129.33,3010.1,109.33,2900.77,30228.56,mortgage,81,5
72,30228.56,3010.1,99.75,2910.35,27318.21,mortgage,81,5
73,27318.21,3010.1,90.15,2919.95,24398.26,mortgage,81,5
74,24398.26,3010.1,80.51,2929.59,21468.67,mortgage,81,5
75,21468.67,3010.1,70.85,2939.25,18529.42,mortgage,81,5
76,18529.42,3010.1,61.15,2948.95,15580.47,mortgage,81,5
77,15580.47,3010.1,51.42,2958.68,12621.79,mortgage,81,5
78,12621.79,3010.1,41.65,2968.45,9653.34,mortgage,81,5
79,9653.34,3010.1,31.86,2978.24,6675.1,mortgage,81,5
80,6675.1,3010.1,22.03,2988.07,3687.03,mortgage,81,5
81,3687.03,3010.1,12.17,2997.93,689.1,mortgage,81,5
82,689.1,3010.1,2.27,3007.83,-2318.73,mortgage,81,5
0,20000.0,1191.04,108.0,1083.04,18916.96,WellsFargo2,82,1
1,18916.96,1191.04,102.15,1088.89,17828.07,WellsFargo2,82,1
2,17828.07,1191.04,96.27,1094.77,16733.3,WellsFargo2,82,1
3,16733.3,1191.04,90.36,1100.68,15632.62,WellsFargo2,82,1
4,15632.62,1191.04,84.42,1106.62,14526.0,WellsFargo2,82,1
5,14526.0,1191.04,78.44,1112.6,13413.4,WellsFargo2,82,1
6,13413.4,1191.04,72.43,1118.61,12294.79,WellsFargo2,82,1
7,12294.79,1191.04,66.39,1124.65,11170.14,WellsFargo2,82,1
8,11170.14,1191.04,60.32,1130.72,10039.42,WellsFargo2,82,1
9,10039.42,1191.04,54.21,1136.83,8902.59,WellsFargo2,82,1
10,8902.59,1191.04,48.07,1142.97,7759.62,WellsFargo2,82,1
11,7759.62,1191.04,41.9,1149.14,6610.48,WellsFargo2,82,1
12,6610.48,1191.04,35.7,1155.34,5455.14,WellsFargo2,82,1
13,5455.14,1191.04,29.46,1161.58,4293.56,WellsFargo2,82,1
14,4293.56,1191.04,23.19,1167.85,3125.71,WellsFargo2,82,1
15,3125.71,1191.04,16.88,1174.16,1951.55,WellsFargo2,82,1
16,1951.55,1191.04,10.54,1180.5,771.05,WellsFargo2,82,1
17,771.05,1191.04,4.16,1186.88,-415.83,WellsFargo2,82,1
0,5000.0,333.0,36.0,297.0,4703.0,Car,82,2
1,4703.0,333.0,33.86,299.14,4403.86,Car,82,2
2,4403.86,333.0,31.71,301.29,4102.57,Car,82,2
3,4102.57,333.0,29.54,303.46,3799.11,Car,82,2
4,3799.11,333.0,27.35,305.65,3493.46,Car,82,2
5,3493.46,333.0,25.15,307.85,3185.61,Car,82,2
6,3185.61,333.0,22.94,310.06,2875.55,Car,82,2
7,2875.55,333.0,20.7,312.3,2563.25,Car,82,2
8,2563.25,333.0,18.46,314.54,2248.71,Car,82,2
9,2248.71,333.0,16.19,316.81,1931.9,Car,82,2
10,1931.9,333.0,13.91,319.09,1612.81,Car,82,2
11,1612.81,333.0,11.61,321.39,1291.42,Car,82,2
12,1291.42,333.0,9.3,323.7,967.72,Car,82,2
13,967.72,333.0,6.97,326.03,641.69,Car,82,2
14,641.69,333.0,4.62,328.38,313.31,Car,82,2
15,313.31,333.0,2.26,330.74,-17.43,Car,82,2
0,8250.57,84.62,53.63,30.99,8219.58,WellsFargo1,82,3
1,8219.58,84.62,53.43,31.19,8188.39,WellsFargo1,82,3
2,8188.39,84.62,53.22,31.4,8156.99,WellsFargo1,82,3
3,8156.99,84.62,53.02,31.6,8125.39,WellsFargo1,82,3
4,8125.39,84.62,52.82,31.8,8093.59,WellsFargo1,82,3
5,8093.59,84.62,52.61,32.01,8061.58,WellsFargo1,82,3
6,8061.58,84.62,52.4,32.22,8029.36,WellsFargo1,82,3
7,8029.36,84.62,52.19,32.43,7996.93,WellsFargo1,82,3
8,7996.93,84.62,51.98,32.64,7964.29,WellsFargo1,82,3
9,7964.29,84.62,51.77,32.85,7931.44,WellsFargo1,82,3
10,7931.44,84.62,51.55,33.07,7898.37,WellsFargo1,82,3
11,7898.37,84.62,51.34,33.28,7865.09,WellsFargo1,82,3
12,7865.09,84.62,51.12,33.5,7831.59,WellsFargo1,82,3
13,7831.59,84.62,50.91,33.71,7797.88,WellsFargo1,82,3
14,7797.88,84.62,50.69,33.93,7763.95,WellsFargo1,82,3
15,7763.95,102.05,50.47,51.58,7712.37,WellsFargo1,82,3
16,7712.37,1608.66,50.13,1558.53,6153.84,WellsFargo1,82,3
17,6153.84,1608.66,40.0,1568.66,4585.18,WellsFargo1,82,3
18,4585.18,1608.66,29.8,1578.86,3006.32,WellsFargo1,82,3
19,3006.32,1608.66,19.54,1589.12,1417.2,WellsFargo1,82,3
20,1417.2,1608.66,9.21,1599.45,-182.25,WellsFargo1,82,3
0,180000.0,1331.44,594.0,737.44,179262.56,mortgage,82,4
1,179262.56,1331.44,591.57,739.87,178522.69,mortgage,82,4
2,178522.69,1331.44,589.12,742.32,177780.37,mortgage,82,4
3,177780.37,1331.44,586.68,744.76,177035.61,mortgage,82,4
4,177035.61,1331.44,584.22,747.22,176288.39,mortgage,82,4
5,176288.39,1331.44,581.75,749.69,175538.7,mortgage,82,4
6,175538.7,1331.44,579.28,752.16,174786.54,mortgage,82,4
7,174786.54,1331.44,576.8,754.64,174031.9,mortgage,82,4
8,174031.9,1331.44,574.31,757.13,173274.77,mortgage,82,4
9,173274.77,1331.44,571.81,759.63,172515.14,mortgage,82,4
10,172515.14,1331.44,569.3,762.14,171753.0,mortgage,82,4
11,171753.0,1331.44,566.78,764.66,170988.34,mortgage,82,4
12,170988.34,1331.44,564.26,767.18,170221.16,mortgage,82,4
13,170221.16,1331.44,561.73,769.71,169451.45,mortgage,82,4
14,169451.45,1331.44,559.19,772.25,168679.2,mortgage,82,4
15,168679.2,1331.44,556.64,774.8,167904.4,mortgage,82,4
16,167904.4,1331.44,554.08,777.36,167127.04,mortgage,82,4
17,167127.04,1331.44,551.52,779.92,166347.12,mortgage,82,4
18,166347.12,1331.44,548.95,782.49,165564.63,mortgage,82,4
19,165564.63,1331.44,546.36,785.08,164779.55,mortgage,82,4
20,164779.55,1513.69,543.77,969.92,163809.63,mortgage,82,4
21,163809.63,2940.1,540.57,2399.53,161410.1,mortgage,82,4
22,161410.1,2940.1,532.65,2407.45,159002.65,mortgage,82,4
23,159002.65,2940.1,524.71,2415.39,156587.26,mortgage,82,4
24,156587.26,2940.1,516.74,2423.36,154163.9,mortgage,82,4
25,154163.9,2940.1,508.74,2431.36,151732.54,mortgage,82,4
26,151732.54,2940.1,500.72,2439.38,149293.16,mortgage,82,4
27,149293.16,2940.1,492.67,2447.43,146845.73,mortgage,82,4
28,146845.73,2940.1,484.59,2455.51,144390.22,mortgage,82,4
29,144390.22,2940.1,476.49,2463.61,141926.61,mortgage,82,4
30,141926.61,2940.1,468.36,2471.74,139454.87,mortgage,82,4
31,139454.87,2940.1,460.2,2479.9,136974.97,mortgage,82,4
32,136974.97,2940.1,452.02,2488.08,134486.89,mortgage,82,4
33,134486.89,2940.1,443.81,2496.29,131990.6,mortgage,82,4
34,131990.6,2940.1,435.57,2504.53,129486.07,mortgage,82,4
35,129486.07,2940.1,427.3,2512.8,126973.27,mortgage,82,4
36,126973.27,2940.1,419.01,2521.09,124452.18,mortgage,82,4
37,124452.18,2940.1,410.69,2529.41,121922.77,mortgage,82,4
38,121922.77,2940.1,402.35,2537.75,119385.02,mortgage,82,4
39,119385.02,2940.1,393.97,2546.13,116838.89,mortgage,82,4
40,116838.89,2940.1,385.57,2554.53,114284.36,mortgage,82,4
41,114284.36,2940.1,377.14,2562.96,111721.4,mortgage,82,4
42,111721.4,2940.1,368.68,2571.42,109149.98,mortgage,82,4
43,109149.98,2940.1,360.19,2579.91,106570.07,mortgage,82,4
44,106570.07,2940.1,351.68,2588.42,103981.65,mortgage,82,4
45,103981.65,2940.1,343.14,2596.96,101384.69,mortgage,82,4
46,101384.69,2940.1,334.57,2605.53,98779.16,mortgage,82,4
47,98779.16,2940.1,325.97,2614.13,96165.03,mortgage,82,4
48,96165.03,2940.1,317.34,2622.76,93542.27,mortgage,82,4
49,93542.27,2940.1,308.69,2631.41,90910.86,mortgage,82,4
50,90910.86,2940.1,300.01,2640.09,88270.77,mortgage,82,4
51,88270.77,2940.1,291.29,2648.81,85621.96,mortgage,82,4
52,85621.96,2940.1,282.55,2657.55,82964.41,mortgage,82,4
53,82964.41,2940.1,273.78,2666.32,80298.09,mortgage,82,4
54,80298.09,2940.1,264.98,2675.12,77622.97,mortgage,82,4
55,77622.97,2940.1,256.16,2683.94,74939.03,mortgage,82,4
56,74939.03,2940.1,247.3,2692.8,72246.23,mortgage,82,4
57,72246.23,2940.1,238.41,2701.69,69544.54,mortgage,82,4
58,69544.54,2940.1,229.5,2710.6,66833.94,mortgage,82,4
59,66833.94,2940.1,220.55,2719.55,64114.39,mortgage,82,4
60,64114.39,2940.1,211.58,2728.52,61385.87,mortgage,82,4
61,61385.87,2940.1,202.57,2737.53,58648.34,mortgage,82,4
62,58648.34,2940.1,193.54,2746.56,55901.78,mortgage,82,4
63,55901.78,2940.1,184.48,2755.62,53146.16,mortgage,82,4
64,53146.16,2940.1,175.38,2764.72,50381.44,mortgage,82,4
65,50381.44,2940.1,166.26,2773.84,47607.6,mortgage,82,4
66,47607.6,2940.1,157.11,2782.99,44824.61,mortgage,82,4
67,44824.61,2940.1,147.92,2792.18,42032.43,mortgage,82,4
68,42032.43,2940.1,138.71,2801.39,39231.04,mortgage,82,4
69,39231.04,2940.1,129.46,2810.64,36420.4,mortgage,82,4
70,36420.4,2940.1,120.19,2819.91,33600.49,mortgage,82,4
71,33600.49,2940.1,110.88,2829.22,30771.27,mortgage,82,4
72,30771.27,2940.1,101.55,2838.55,27932.72,mortgage,82,4
73,27932.72,2940.1,92.18,2847.92,25084.8,mortgage,82,4
74,25084.8,2940.1,82.78,2857.32,22227.48,mortgage,82,4
75,22227.48,2940.1,73.35,2866.75,19360.73,mortgage,82,4
76,19360.73,2940.1,63.89,2876.21,16484.52,mortgage,82,4
77,16484.52,2940.1,54.4,2885.7,13598.82,mortgage,82,4
78,13598.82,2940.1,44.88,2895.22,10703.6,mortgage,82,4
79,10703.6,2940.1,35.32,2904.78,7798.82,mortgage,82,4
80,7798.82,2940.1,25.74,2914.36,4884.46,mortgage,82,4
81,4884.46,2940.1,16.12,2923.98,1960.48,mortgage,82,4
82,1960.48,2940.1,6.47,2933.63,-973.15,mortgage,82,4
0,4000.0,70.0,16.0,54.0,3946.0,testing,82,5
1,3946.0,70.0,15.78,54.22,3891.78,testing,82,5
2,3891.78,70.0,15.57,54.43,3837.35,testing,82,5
3,3837.35,70.0,15.35,54.65,3782.7,testing,82,5
4,3782.7,70.0,15.13,54.87,3727.83,testing,82,5
5,3727.83,70.0,14.91,55.09,3672.74,testing,82,5
6,3672.74,70.0,14.69,55.31,3617.43,testing,82,5
7,3617.43,70.0,14.47,55.53,3561.9,testing,82,5
8,3561.9,70.0,14.25,55.75,3506.15,testing,82,5
9,3506.15,70.0,14.02,55.98,3450.17,testing,82,5
10,3450.17,70.0,13.8,56.2,3393.97,testing,82,5
11,3393.97,70.0,13.58,56.42,3337.55,testing,82,5
12,3337.55,70.0,13.35,56.65,3280.9,testing,82,5
13,3280.9,70.0,13.12,56.88,3224.02,testing,82,5
14,3224.02,70.0,12.9,57.1,3166.92,testing,82,5
15,3166.92,70.0,12.67,57.33,3109.59,testing,82,5
16,3109.59,70.0,12.44,57.56,3052.03,testing,82,5
17,3052.03,70.0,12.21,57.79,2994.24,testing,82,5
18,2994.24,70.0,11.98,58.02,2936.22,testing,82,5
19,2936.22,70.0,11.74,58.26,2877.96,testing,82,5
20,2877.96,70.0,11.51,58.49,2819.47,testing,82,5
21,2819.47,70.0,11.28,58.72,2760.75,testing,82,5
22,2760.75,70.0,11.04,58.96,2701.79,testing,82,5
23,2701.79,70.0,10.81,59.19,2642.6,testing,82,5
24,2642.6,70.0,10.57,59.43,2583.17,testing,82,5
25,2583.17,70.0,10.33,59.67,2523.5,testing,82,5
26,2523.5,70.0,10.09,59.91,2463.59,testing,82,5
27,2463.59,70.0,9.85,60.15,2403.44,testing,82,5
28,2403.44,70.0,9.61,60.39,2343.05,testing,82,5
29,2343.05,70.0,9.37,60.63,2282.42,testing,82,5
30,2282.42,70.0,9.13,60.87,2221.55,testing,82,5
31,2221.55,70.0,8.89,61.11,2160.44,testing,82,5
32,2160.44,70.0,8.64,61.36,2099.08,testing,82,5
33,2099.08,70.0,8.4,61.6,2037.48,testing,82,5
34,2037.48,70.0,8.15,61.85,1975.63,testing,82,5
35,1975.63,70.0,7.9,62.1,1913.53,testing,82,5
36,1913.53,70.0,7.65,62.35,1851.18,testing,82,5
37,1851.18,70.0,7.4,62.6,1788.58,testing,82,5
38,1788.58,70.0,7.15,62.85,1725.73,testing,82,5
39,1725.73,70.0,6.9,63.1,1662.63,testing,82,5
40,1662.63,70.0,6.65,63.35,1599.28,testing,82,5
41,1599.28,70.0,6.4,63.6,1535.68,testing,82,5
42,1535.68,70.0,6.14,63.86,1471.82,testing,82,5
43,1471.82,70.0,5.89,64.11,1407.71,testing,82,5
44,1407.71,70.0,5.63,64.37,1343.34,testing,82,5
45,1343.34,70.0,5.37,64.63,1278.71,testing,82,5
46,1278.71,70.0,5.11,64.89,1213.82,testing,82,5
47,1213.82,70.0,4.86,65.14,1148.68,testing,82,5
48,1148.68,70.0,4.59,65.41,1083.27,testing,82,5
49,1083.27,70.0,4.33,65.67,1017.6,testing,82,5
50,1017.6,70.0,4.07,65.93,951.67,testing,82,5
51,951.67,70.0,3.81,66.19,885.48,testing,82,5
52,885.48,70.0,3.54,66.46,819.02,testing,82,5
53,819.02,70.0,3.28,66.72,752.3,testing,82,5
54,752.3,70.0,3.01,66.99,685.31,testing,82,5
55,685.31,70.0,2.74,67.26,618.05,testing,82,5
56,618.05,70.0,2.47,67.53,550.52,testing,82,5
57,550.52,70.0,2.2,67.8,482.72,testing,82,5
58,482.72,70.0,1.93,68.07,414.65,testing,82,5
59,414.65,70.0,1.66,68.34,346.31,testing,82,5
60,346.31,70.0,1.39,68.61,277.7,testing,82,5
61,277.7,70.0,1.11,68.89,208.81,testing,82,5
62,208.81,70.0,0.84,69.16,139.65,testing,82,5
63,139.65,70.0,0.56,69.44,70.21,testing,82,5
64,70.21,70.0,0.28,69.72,0.49,testing,82,5
65,0.49,70.0,0.0,70.0,-69.51,testing,82,5
0,20000.0,1191.04,108.0,1083.04,18916.96,WellsFargo2,83,1
1,18916.96,1191.04,102.15,1088.89,17828.07,WellsFargo2,83,1
2,17828.07,1191.04,96.27,1094.77,16733.3,WellsFargo2,83,1
3,16733.3,1191.04,90.36,1100.68,15632.62,WellsFargo2,83,1
4,15632.62,1191.04,84.42,1106.62,14526.0,WellsFargo2,83,1
5,14526.0,1191.04,78.44,1112.6,13413.4,WellsFargo2,83,1
6,13413.4,1191.04,72.43,1118.61,12294.79,WellsFargo2,83,1
7,12294.79,1191.04,66.39,1124.65,11170.14,WellsFargo2,83,1
8,11170.14,1191.04,60.32,1130.72,10039.42,WellsFargo2,83,1
9,10039.42,1191.04,54.21,1136.83,8902.59,WellsFargo2,83,1
10,8902.59,1191.04,48.07,1142.97,7759.62,WellsFargo2,83,1
11,7759.62,1191.04,41.9,1149.14,6610.48,WellsFargo2,83,1
12,6610.48,1191.04,35.7,1155.34,5455.14,WellsFargo2,83,1
13,5455.14,1191.04,29.46,1161.58,4293.56,WellsFargo2,83,1
14,4293.56,1191.04,23.19,1167.85,3125.71,WellsFargo2,83,1
15,3125.71,1191.04,16.88,1174.16,1951.55,WellsFargo2,83,1
16,1951.55,1191.04,10.54,1180.5,771.05,WellsFargo2,83,1
17,771.05,1191.04,4.16,1186.88,-415.83,WellsFargo2,83,1
0,5000.0,333.0,36.0,297.0,4703.0,Car,83,2
1,4703.0,333.0,33.86,299.14,4403.86,Car,83,2
2,4403.86,333.0,31.71,301.29,4102.57,Car,83,2
3,4102.57,333.0,29.54,303.46,3799.11,Car,83,2
4,3799.11,333.0,27.35,305.65,3493.46,Car,83,2
5,3493.46,333.0,25.15,307.85,3185.61,Car,83,2
6,3185.61,333.0,22.94,310.06,2875.55,Car,83,2
7,2875.55,333.0,20.7,312.3,2563.25,Car,83,2
8,2563.25,333.0,18.46,314.54,2248.71,Car,83,2
9,2248.71,333.0,16.19,316.81,1931.9,Car,83,2
10,1931.9,333.0,13.91,319.09,1612.81,Car,83,2
11,1612.81,333.0,11.61,321.39,1291.42,Car,83,2
12,1291.42,333.0,9.3,323.7,967.72,Car,83,2
13,967.72,333.0,6.97,326.03,641.69,Car,83,2
14,641.69,333.0,4.62,328.38,313.31,Car,83,2
15,313.31,333.0,2.26,330.74,-17.43,Car,83,2
0,180000.0,1331.44,594.0,737.44,179262.56,mortgage,83,3
1,179262.56,1331.44,591.57,739.87,178522.69,mortgage,83,3
2,178522.69,1331.44,589.12,742.32,177780.37,mortgage,83,3
3,177780.37,1331.44,586.68,744.76,177035.61,mortgage,83,3
4,177035.61,1331.44,584.22,747.22,176288.39,mortgage,83,3
5,176288.39,1331.44,581.75,749.69,175538.7,mortgage,83,3
6,175538.7,1331.44,579.28,752.16,174786.54,mortgage,83,3
7,174786.54,1331.44,576.8,754.64,174031.9,mortgage,83,3
8,174031.9,1331.44,574.31,757.13,173274.77,mortgage,83,3
9,173274.77,1331.44,571.81,759.63,172515.14,mortgage,83,3
10,172515.14,1331.44,569.3,762.14,171753.0,mortgage,83,3
11,171753.0,1331.44,566.78,764.66,170988.34,mortgage,83,3
12,170988.34,1331.44,564.26,767.18,170221.16,mortgage,83,3
13,170221.16,1331.44,561.73,769.71,169451.45,mortgage,83,3
14,169451.45,1331.44,559.19,772.25,168679.2,mortgage,83,3
15,168679.2,1348.87,556.64,792.23,167886.97,mortgage,83,3
16,167886.97,2855.48,554.03,2301.45,165585.52,mortgage,83,3
17,165585.52,2855.48,546.43,2309.05,163276.47,mortgage,83,3
18,163276.47,2855.48,538.81,2316.67,160959.8,mortgage,83,3
19,160959.8,2855.48,531.17,2324.31,158635.49,mortgage,83,3
20,158635.49,2855.48,523.5,2331.98,156303.51,mortgage,83,3
21,156303.51,2855.48,515.8,2339.68,153963.83,mortgage,83,3
22,153963.83,2855.48,508.08,2347.4,151616.43,mortgage,83,3
23,151616.43,2855.48,500.33,2355.15,149261.28,mortgage,83,3
24,149261.28,2855.48,492.56,2362.92,146898.36,mortgage,83,3
25,146898.36,2855.48,484.76,2370.72,144527.64,mortgage,83,3
26,144527.64,2855.48,476.94,2378.54,142149.1,mortgage,83,3
27,142149.1,2855.48,469.09,2386.39,139762.71,mortgage,83,3
28,139762.71,2855.48,461.22,2394.26,137368.45,mortgage,83,3
29,137368.45,2855.48,453.32,2402.16,134966.29,mortgage,83,3
30,134966.29,2855.48,445.39,2410.09,132556.2,mortgage,83,3
31,132556.2,2855.48,437.44,2418.04,130138.16,mortgage,83,3
32,130138.16,2855.48,429.46,2426.02,127712.14,mortgage,83,3
33,127712.14,2855.48,421.45,2434.03,125278.11,mortgage,83,3
34,125278.11,2855.48,413.42,2442.06,122836.05,mortgage,83,3
35,122836.05,2855.48,405.36,2450.12,120385.93,mortgage,83,3
36,120385.93,2855.48,397.27,2458.21,117927.72,mortgage,83,3
37,117927.72,2855.48,389.16,2466.32,115461.4,mortgage,83,3
38,115461.4,2855.48,381.02,2474.46,112986.94,mortgage,83,3
39,112986.94,2855.48,372.86,2482.62,110504.32,mortgage,83,3
40,110504.32,2855.48,364.66,2490.82,108013.5,mortgage,83,3
41,108013.5,2855.48,356.44,2499.04,105514.46,mortgage,83,3
42,105514.46,2855.48,348.2,2507.28,103007.18,mortgage,83,3
43,103007.18,2855.48,339.92,2515.56,100491.62,mortgage,83,3
44,100491.62,2855.48,331.62,2523.86,97967.76,mortgage,83,3
45,97967.76,2855.48,323.29,2532.19,95435.57,mortgage,83,3
46,95435.57,2855.48,314.94,2540.54,92895.03,mortgage,83,3
47,92895.03,2855.48,306.55,2548.93,90346.1,mortgage,83,3
48,90346.1,2855.48,298.14,2557.34,87788.76,mortgage,83,3
49,87788.76,2855.48,289.7,2565.78,85222.98,mortgage,83,3
50,85222.98,2855.48,281.24,2574.24,82648.74,mortgage,83,3
51,82648.74,2855.48,272.74,2582.74,80066.0,mortgage,83,3
52,80066.0,2855.48,264.22,2591.26,77474.74,mortgage,83,3
53,77474.74,2855.48,255.67,2599.81,74874.93,mortgage,83,3
54,74874.93,2855.48,247.09,2608.39,72266.54,mortgage,83,3
55,72266.54,2855.48,238.48,2617.0,69649.54,mortgage,83,3
56,69649.54,2855.48,229.84,2625.64,67023.9,mortgage,83,3
57,67023.9,2855.48,221.18,2634.3,64389.6,mortgage,83,3
58,64389.6,2855.48,212.49,2642.99,61746.61,mortgage,83,3
59,61746.61,2855.48,203.76,2651.72,59094.89,mortgage,83,3
60,59094.89,2855.48,195.01,2660.47,56434.42,mortgage,83,3
61,56434.42,2855.48,186.23,2669.25,53765.17,mortgage,83,3
62,53765.17,2855.48,177.43,2678.05,51087.12,mortgage,83,3
63,51087.12,2855.48,168.59,2686.89,48400.23,mortgage,83,3
64,48400.23,2855.48,159.72,2695.76,45704.47,mortgage,83,3
65,45704.47,2855.48,150.82,2704.66,42999.81,mortgage,83,3
66,42999.81,2855.48,141.9,2713.58,40286.23,mortgage,83,3
67,40286.23,2855.48,132.94,2722.54,37563.69,mortgage,83,3
68,37563.69,2855.48,123.96,2731.52,34832.17,mortgage,83,3
69,34832.17,2855.48,114.95,2740.53,32091.64,mortgage,83,3
70,32091.64,2855.48,105.9,2749.58,29342.06,mortgage,83,3
71,29342.06,2855.48,96.83,2758.65,26583.41,mortgage,83,3
72,26583.41,2855.48,87.73,2767.75,23815.66,mortgage,83,3
73,23815.66,2855.48,78.59,2776.89,21038.77,mortgage,83,3
74,21038.77,2855.48,69.43,2786.05,18252.72,mortgage,83,3
75,18252.72,2855.48,60.23,2795.25,15457.47,mortgage,83,3
76,15457.47,2855.48,51.01,2804.47,12653.0,mortgage,83,3
77,12653.0,2855.48,41.75,2813.73,9839.27,mortgage,83,3
78,9839.27,2855.48,32.47,2823.01,7016.26,mortgage,83,3
79,7016.26,2855.48,23.15,2832.33,4183.93,mortgage,83,3
80,4183.93,2855.48,13.81,2841.67,1342.26,mortgage,83,3
81,1342.26,2855.48,4.43,2851.05,-1508.79,mortgage,83,3
0,4000.0,70.0,16.0,54.0,3946.0,testing,83,4
1,3946.0,70.0,15.78,54.22,3891.78,testing,83,4
2,3891.78,70.0,15.57,54.43,3837.35,testing,83,4
3,3837.35,70.0,15.35,54.65,3782.7,testing,83,4
4,3782.7,70.0,15.13,54.87,3727.83,testing,83,4
5,3727.83,70.0,14.91,55.09,3672.74,testing,83,4
6,3672.74,70.0,14.69,55.31,3617.43,testing,83,4
7,3617.43,70.0,14.47,55.53,3561.9,testing,83,4
8,3561.9,70.0,14.25,55.75,3506.15,testing,83,4
9,3506.15,70.0,14.02,55.98,3450.17,testing,83,4
10,3450.17,70.0,13.8,56.2,3393.97,testing,83,4
11,3393.97,70.0,13.58,56.42,3337.55,testing,83,4
12,3337.55,70.0,13.35,56.65,3280.9,testing,83,4
13,3280.9,70.0,13.12,56.88,3224.02,testing,83,4
14,3224.02,70.0,12.9,57.1,3166.92,testing,83,4
15,3166.92,70.0,12.67,57.33,3109.59,testing,83,4
16,3109.59,70.0,12.44,57.56,3052.03,testing,83,4
17,3052.03,70.0,12.21,57.79,2994.24,testing,83,4
18,2994.24,70.0,11.98,58.02,2936.22,testing,83,4
19,2936.22,70.0,11.74,58.26,2877.96,testing,83,4
20,2877.96,70.0,11.51,58.49,2819.47,testing,83,4
21,2819.47,70.0,11.28,58.72,2760.75,testing,83,4
22,2760.75,70.0,11.04,58.96,2701.79,testing,83,4
23,2701.79,70.0,10.81,59.19,2642.6,testing,83,4
24,2642.6,70.0,10.57,59.43,2583.17,testing,83,4
25,2583.17,70.0,10.33,59.67,2523.5,testing,83,4
26,2523.5,70.0,10.09,59.91,2463.59,testing,83,4
27,2463.59,70.0,9.85,60.15,2403.44,testing,83,4
28,2403.44,70.0,9.61,60.39,2343.05,testing,83,4
29,2343.05,70.0,9.37,60.63,2282.42,testing,83,4
30,2282.42,70.0,9.13,60.87,2221.55,testing,83,4
31,2221.55,70.0,8.89,61.11,2160.44,testing,83,4
32,2160.44,70.0,8.64,61.36,2099.08,testing,83,4
33,2099.08,70.0,8.4,61.6,2037.48,testing,83,4
34,2037.48,70.0,8.15,61.85,1975.63,testing,83,4
35,1975.63,70.0,7.9,62.1,1913.53,testing,83,4
36,1913.53,70.0,7.65,62.35,1851.18,testing,83,4
37,1851.18,70.0,7.4,62.6,1788.58,testing,83,4
38,1788.58,70.0,7.15,62.85,1725.73,testing,83,4
39,1725.73,70.0,6.9,63.1,1662.63,testing,83,4
40,1662.63,70.0,6.65,63.35,1599.28,testing,83,4
41,1599.28,70.0,6.4,63.6,1535.68,testing,83,4
42,1535.68,70.0,6.14,63.86,1471.82,testing,83,4
43,1471.82,70.0,5.89,64.11,1407.71,testing,83,4
44,1407.71,70.0,5.63,64.37,1343.34,testing,83,4
45,1343.34,70.0,5.37,64.63,1278.71,testing,83,4
46,1278.71,70.0,5.11,64.89,1213.82,testing,83,4
47,1213.82,70.0,4.86,65.14,1148.68,testing,83,4
48,1148.68,70.0,4.59,65.41,1083.27,testing,83,4
49,1083.27,70.0,4.33,65.67,1017.6,testing,83,4
50,1017.6,70.0,4.07,65.93,951.67,testing,83,4
51,951.67,70.0,3.81,66.19,885.48,testing,83,4
52,885.48,70.0,3.54,66.46,819.02,testing,83,4
53,819.02,70.0,3.28,66.72,752.3,testing,83,4
54,752.3,70.0,3.01,66.99,685.31,testing,83,4
55,685.31,70.0,2.74,67.26,618.05,testing,83,4
56,618.05,70.0,2.47,67.53,550.52,testing,83,4
57,550.52,70.0,2.2,67.8,482.72,testing,83,4
58,482.72,70.0,1.93,68.07,414.65,testing,83,4
59,414.65,70.0,1.66,68.34,346.31,testing,83,4
60,346.31,70.0,1.39,68.61,277.7,testing,83,4
61,277.7,70.0,1.11,68.89,208.81,testing,83,4
62,208.81,70.0,0.84,69.16,139.65,testing,83,4
63,139.65,70.0,0.56,69.44,70.21,testing,83,4
64,70.21,70.0,0.28,69.72,0.49,testing,83,4
65,0.49,70.0,0.0,70.0,-69.51,testing,83,4
0,8250.57,84.62,53.63,30.99,8219.58,WellsFargo1,83,5
1,8219.58,84.62,53.43,31.19,8188.39,WellsFargo1,83,5
2,8188.39,84.62,53.22,31.4,8156.99,WellsFargo1,83,5
3,8156.99,84.62,53.02,31.6,8125.39,WellsFargo1,83,5
4,8125.39,84.62,52.82,31.8,8093.59,WellsFargo1,83,5
5,8093.59,84.62,52.61,32.01,8061.58,WellsFargo1,83,5
6,8061.58,84.62,52.4,32.22,8029.36,WellsFargo1,83,5
7,8029.36,84.62,52.19,32.43,7996.93,WellsFargo1,83,5
8,7996.93,84.62,51.98,32.64,7964.29,WellsFargo1,83,5
9,7964.29,84.62,51.77,32.85,7931.44,WellsFargo1,83,5
10,7931.44,84.62,51.55,33.07,7898.37,WellsFargo1,83,5
11,7898.37,84.62,51.34,33.28,7865.09,WellsFargo1,83,5
12,7865.09,84.62,51.12,33.5,7831.59,WellsFargo1,83,5
13,7831.59,84.62,50.91,33.71,7797.88,WellsFargo1,83,5
14,7797.88,84.62,50.69,33.93,7763.95,WellsFargo1,83,5
15,7763.95,84.62,50.47,34.15,7729.8,WellsFargo1,83,5
16,7729.8,84.62,50.24,34.38,7695.42,WellsFargo1,83,5
17,7695.42,84.62,50.02,34.6,7660.82,WellsFargo1,83,5
18,7660.82,84.62,49.8,34.82,7626.0,WellsFargo1,83,5
19,7626.0,84.62,49.57,35.05,7590.95,WellsFargo1,83,5
20,7590.95,84.62,49.34,35.28,7555.67,WellsFargo1,83,5
21,7555.67,84.62,49.11,35.51,7520.16,WellsFargo1,83,5
22,7520.16,84.62,48.88,35.74,7484.42,WellsFargo1,83,5
23,7484.42,84.62,48.65,35.97,7448.45,WellsFargo1,83,5
24,7448.45,84.62,48.41,36.21,7412.24,WellsFargo1,83,5
25,7412.24,84.62,48.18,36.44,7375.8,WellsFargo1,83,5
26,7375.8,84.62,47.94,36.68,7339.12,WellsFargo1,83,5
27,7339.12,84.62,47.7,36.92,7302.2,WellsFargo1,83,5
28,7302.2,84.62,47.46,37.16,7265.04,WellsFargo1,83,5
29,7265.04,84.62,47.22,37.4,7227.64,WellsFargo1,83,5
30,7227.64,84.62,46.98,37.64,7190.0,WellsFargo1,83,5
31,7190.0,84.62,46.73,37.89,7152.11,WellsFargo1,83,5
32,7152.11,84.62,46.49,38.13,7113.98,WellsFargo1,83,5
33,7113.98,84.62,46.24,38.38,7075.6,WellsFargo1,83,5
34,7075.6,84.62,45.99,38.63,7036.97,WellsFargo1,83,5
35,7036.97,84.62,45.74,38.88,6998.09,WellsFargo1,83,5
36,6998.09,84.62,45.49,39.13,6958.96,WellsFargo1,83,5
37,6958.96,84.62,45.23,39.39,6919.57,WellsFargo1,83,5
38,6919.57,84.62,44.98,39.64,6879.93,WellsFargo1,83,5
39,6879.93,84.62,44.72,39.9,6840.03,WellsFargo1,83,5
40,6840.03,84.62,44.46,40.16,6799.87,WellsFargo1,83,5
41,6799.87,84.62,44.2,40.42,6759.45,WellsFargo1,83,5
42,6759.45,84.62,43.94,40.68,6718.77,WellsFargo1,83,5
43,6718.77,84.62,43.67,40.95,6677.82,WellsFargo1,83,5
44,6677.82,84.62,43.41,41.21,6636.61,WellsFargo1,83,5
45,6636.61,84.62,43.14,41.48,6595.13,WellsFargo1,83,5
46,6595.13,84.62,42.87,41.75,6553.38,WellsFargo1,83,5
47,6553.38,84.62,42.6,42.02,6511.36,WellsFargo1,83,5
48,6511.36,84.62,42.32,42.3,6469.06,WellsFargo1,83,5
49,6469.06,84.62,42.05,42.57,6426.49,WellsFargo1,83,5
50,6426.49,84.62,41.77,42.85,6383.64,WellsFargo1,83,5
51,6383.64,84.62,41.49,43.13,6340.51,WellsFargo1,83,5
52,6340.51,84.62,41.21,43.41,6297.1,WellsFargo1,83,5
53,6297.1,84.62,40.93,43.69,6253.41,WellsFargo1,83,5
54,6253.41,84.62,40.65,43.97,6209.44,WellsFargo1,83,5
55,6209.44,84.62,40.36,44.26,6165.18,WellsFargo1,83,5
56,6165.18,84.62,40.07,44.55,6120.63,WellsFargo1,83,5
57,6120.63,84.62,39.78,44.84,6075.79,WellsFargo1,83,5
58,6075.79,84.62,39.49,45.13,6030.66,WellsFargo1,83,5
59,6030.66,84.62,39.2,45.42,5985.24,WellsFargo1,83,5
60,5985.24,84.62,38.9,45.72,5939.52,WellsFargo1,83,5
61,5939.52,84.62,38.61,46.01,5893.51,WellsFargo1,83,5
62,5893.51,84.62,38.31,46.31,5847.2,WellsFargo1,83,5
63,5847.2,84.62,38.01,46.61,5800.59,WellsFargo1,83,5
64,5800.59,84.62,37.7,46.92,5753.67,WellsFargo1,83,5
65,5753.67,154.13,37.4,116.73,5636.94,WellsFargo1,83,5
66,5636.94,3010.1,36.64,2973.46,2663.48,WellsFargo1,83,5
67,2663.48,3010.1,17.31,2992.79,-329.31,WellsFargo1,83,5
0,20000.0,1191.04,108.0,1083.04,18916.96,WellsFargo2,84,1
1,18916.96,1191.04,102.15,1088.89,17828.07,WellsFargo2,84,1
2,17828.07,1191.04,96.27,1094.77,16733.3,WellsFargo2,84,1
3,16733.3,1191.04,90.36,1100.68,15632.62,WellsFargo2,84,1
4,15632.62,1191.04,84.42,1106.62,14526.0,WellsFargo2,84,1
5,14526.0,1191.04,78.44,1112.6,13413.4,WellsFargo2,84,1
6,13413.4,1191.04,72.43,1118.61,12294.79,WellsFargo2,84,1
7,12294.79,1191.04,66.39,1124.65,11170.14,WellsFargo2,84,1
8,11170.14,1191.04,60.32,1130.72,10039.42,WellsFargo2,84,1
9,10039.42,1191.04,54.21,1136.83,8902.59,WellsFargo2,84,1
10,8902.59,1191.04,48.07,1142.97,7759.62,WellsFargo2,84,1
11,7759.62,1191.04,41.9,1149.14,6610.48,WellsFargo2,84,1
12,6610.48,1191.04,35.7,1155.34,5455.14,WellsFargo2,84,1
13,5455.14,1191.04,29.46,1161.58,4293.56,WellsFargo2,84,1
14,4293.56,1191.04,23.19,1167.85,3125.71,WellsFargo2,84,1
15,3125.71,1191.04,16.88,1174.16,1951.55,WellsFargo2,84,1
16,1951.55,1191.04,10.54,1180.5,771.05,WellsFargo2,84,1
17,771.05,1191.04,4.16,1186.88,-415.83,WellsFargo2,84,1
0,5000.0,333.0,36.0,297.0,4703.0,Car,84,2
1,4703.0,333.0,33.86,299.14,4403.86,Car,84,2
2,4403.86,333.0,31.71,301.29,4102.57,Car,84,2
3,4102.57,333.0,29.54,303.46,3799.11,Car,84,2
4,3799.11,333.0,27.35,305.65,3493.46,Car,84,2
5,3493.46,333.0,25.15,307.85,3185.61,Car,84,2
6,3185.61,333.0,22.94,310.06,2875.55,Car,84,2
7,2875.55,333.0,20.7,312.3,2563.25,Car,84,2
8,2563.25,333.0,18.46,314.54,2248.71,Car,84,2
9,2248.71,333.0,16.19,316.81,1931.9,Car,84,2
10,1931.9,333.0,13.91,319.09,1612.81,Car,84,2
11,1612.81,333.0,11.61,321.39,1291.42,Car,84,2
12,1291.42,333.0,9.3,323.7,967.72,Car,84,2
13,967.72,333.0,6.97,326.03,641.69,Car,84,2
14,641.69,333.0,4.62,328.38,313.31,Car,84,2
15,313.31,333.0,2.26,330.74,-17.43,Car,84,2
0,180000.0,1331.44,594.0,737.44,179262.56,mortgage,84,3
1,179262.56,1331.44,591.57,739.87,178522.69,mortgage,84,3
2,178522.69,1331.44,589.12,742.32,177780.37,mortgage,84,3
3,177780.37,1331.44,586.68,744.76,177035.61,mortgage,84,3
4,177035.61,1331.44,584.22,747.22,176288.39,mortgage,84,3
5,176288.39,1331.44,581.75,749.69,175538.7,mortgage,84,3
6,175538.7,1331.44,579.28,752.16,174786.54,mortgage,84,3
7,174786.54,1331.44,576.8,754.64,174031.9,mortgage,84,3
8,174031.9,1331.44,574.31,757.13,173274.77,mortgage,84,3
9,173274.77,1331.44,571.81,759.63,172515.14,mortgage,84,3
10,172515.14,1331.44,569.3,762.14,171753.0,mortgage,84,3
11,171753.0,1331.44,566.78,764.66,170988.34,mortgage,84,3
12,170988.34,1331.44,564.26,767.18,170221.16,mortgage,84,3
13,170221.16,1331.44,561.73,769.71,169451.45,mortgage,84,3
14,169451.45,1331.44,559.19,772.25,168679.2,mortgage,84,3
15,168679.2,1348.87,556.64,792.23,167886.97,mortgage,84,3
16,167886.97,2855.48,554.03,2301.45,165585.52,mortgage,84,3
17,165585.52,2855.48,546.43,2309.05,163276.47,mortgage,84,3
18,163276.47,2855.48,538.81,2316.67,160959.8,mortgage,84,3
19,160959.8,2855.48,531.17,2324.31,158635.49,mortgage,84,3
20,158635.49,2855.48,523.5,2331.98,156303.51,mortgage,84,3
21,156303.51,2855.48,515.8,2339.68,153963.83,mortgage,84,3
22,153963.83,2855.48,508.08,2347.4,151616.43,mortgage,84,3
23,151616.43,2855.48,500.33,2355.15,149261.28,mortgage,84,3
24,149261.28,2855.48,492.56,2362.92,146898.36,mortgage,84,3
25,146898.36,2855.48,484.76,2370.72,144527.64,mortgage,84,3
26,144527.64,2855.48,476.94,2378.54,142149.1,mortgage,84,3
27,142149.1,2855.48,469.09,2386.39,139762.71,mortgage,84,3
28,139762.71,2855.48,461.22,2394.26,137368.45,mortgage,84,3
29,137368.45,2855.48,453.32,2402.16,134966.29,mortgage,84,3
30,134966.29,2855.48,445.39,2410.09,132556.2,mortgage,84,3
31,132556.2,2855.48,437.44,2418.04,130138.16,mortgage,84,3
32,130138.16,2855.48,429.46,2426.02,127712.14,mortgage,84,3
33,127712.14,2855.48,421.45,2434.03,125278.11,mortgage,84,3
34,125278.11,2855.48,413.42,2442.06,122836.05,mortgage,84,3
35,122836.05,2855.48,405.36,2450.12,120385.93,mortgage,84,3
36,120385.93,2855.48,397.27,2458.21,117927.72,mortgage,84,3
37,117927.72,2855.48,389.16,2466.32,115461.4,mortgage,84,3
38,115461.4,2855.48,381.02,2474.46,112986.94,mortgage,84,3
39,112986.94,2855.48,372.86,2482.62,110504.32,mortgage,84,3
40,110504.32,2855.48,364.66,2490.82,108013.5,mortgage,84,3
41,108013.5,2855.48,356.44,2499.04,105514.46,mortgage,84,3
42,105514.46,2855.48,348.2,2507.28,103007.18,mortgage,84,3
43,103007.18,2855.48,339.92,2515.56,100491.62,mortgage,84,3
44,100491.62,2855.48,331.62,2523.86,97967.76,mortgage,84,3
45,97967.76,2855.48,323.29,2532.19,95435.57,mortgage,84,3
46,95435.57,2855.48,314.94,2540.54,92895.03,mortgage,84,3
47,92895.03,2855.48,306.55,2548.93,90346.1,mortgage,84,3
48,90346.1,2855.48,298.14,2557.34,87788.76,mortgage,84,3
49,87788.76,2855.48,289.7,2565.78,85222.98,mortgage,84,3
50,85222.98,2855.48,281.24,2574.24,82648.74,mortgage,84,3
51,82648.74,2855.48,272.74,2582.74,80066.0,mortgage,84,3
52,80066.0,2855.48,264.22,2591.26,77474.74,mortgage,84,3
53,77474.74,2855.48,255.67,2599.81,74874.93,mortgage,84,3
54,74874.93,2855.48,247.09,2608.39,72266.54,mortgage,84,3
55,72266.54,2855.48,238.48,2617.0,69649.54,mortgage,84,3
56,69649.54,2855.48,229.84,2625.64,67023.9,mortgage,84,3
57,67023.9,2855.48,221.18,2634.3,64389.6,mortgage,84,3
58,64389.6,2855.48,212.49,2642.99,61746.61,mortgage,84,3
59,61746.61,2855.48,203.76,2651.72,59094.89,mortgage,84,3
60,59094.89,2855.48,195.01,2660.47,56434.42,mortgage,84,3
61,56434.42,2855.48,186.23,2669.25,53765.17,mortgage,84,3
62,53765.17,2855.48,177.43,2678.05,51087.12,mortgage,84,3
63,51087.12,2855.48,168.59,2686.89,48400.23,mortgage,84,3
64,48400.23,2855.48,159.72,2695.76,45704.47,mortgage,84,3
65,45704.47,2855.48,150.82,2704.66,42999.81,mortgage,84,3
66,42999.81,2855.48,141.9,2713.58,40286.23,mortgage,84,3
67,40286.23,2855.48,132.94,2722.54,37563.69,mortgage,84,3
68,37563.69,2855.48,123.96,2731.52,34832.17,mortgage,84,3
69,34832.17,2855.48,114.95,2740.53,32091.64,mortgage,84,3
70,32091.64,2855.48,105.9,2749.58,29342.06,mortgage,84,3
71,29342.06,2855.48,96.83,2758.65,26583.41,mortgage,84,3
72,26583.41,2855.48,87.73,2767.75,23815.66,mortgage,84,3
73,23815.66,2855.48,78.59,2776.89,21038.77,mortgage,84,3
74,21038.77,2855.48,69.43,2786.05,18252.72,mortgage,84,3
75,18252.72,2855.48,60.23,2795.25,15457.47,mortgage,84,3
76,15457.47,2855.48,51.01,2804.47,12653.0,mortgage,84,3
77,12653.0,2855.48,41.75,2813.73,9839.27,mortgage,84,3
78,9839.27,2855.48,32.47,2823.01,7016.26,mortgage,84,3
79,7016.26,2855.48,23.15,2832.33,4183.93,mortgage,84,3
80,4183.93,2855.48,13.81,2841.67,1342.26,mortgage,84,3
81,1342.26,2855.48,4.43,2851.05,-1508.79,mortgage,84,3
0,8250.57,84.62,53.63,30.99,8219.58,WellsFargo1,84,4
1,8219.58,84.62,53.43,31.19,8188.39,WellsFargo1,84,4
2,8188.39,84.62,53.22,31.4,8156.99,WellsFargo1,84,4
3,8156.99,84.62,53.02,31.6,8125.39,WellsFargo1,84,4
4,8125.39,84.62,52.82,31.8,8093.59,WellsFargo1,84,4
5,8093.59,84.62,52.61,32.01,8061.58,WellsFargo1,84,4
6,8061.58,84.62,52.4,32.22,8029.36,WellsFargo1,84,4
7,8029.36,84.62,52.19,32.43,7996.93,WellsFargo1,84,4
8,7996.93,84.62,51.98,32.64,7964.29,WellsFargo1,84,4
9,7964.29,84.62,51.77,32.85,7931.44,WellsFargo1,84,4
10,7931.44,84.62,51.55,33.07,7898.37,WellsFargo1,84,4
11,7898.37,84.62,51.34,33.28,7865.09,WellsFargo1,84,4
12,7865.09,84.62,51.12,33.5,7831.59,WellsFargo1,84,4
13,7831.59,84.62,50.91,33.71,7797.88,WellsFargo1,84,4
14,7797.88,84.62,50.69,33.93,7763.95,WellsFargo1,84,4
15,7763.95,84.62,50.47,34.15,7729.8,WellsFargo1,84,4
16,7729.8,84.62,50.24,34.38,7695.42,WellsFargo1,84,4
17,7695.42,84.62,50.02,34.6,7660.82,WellsFargo1,84,4
18,7660.82,84.62,49.8,34.82,7626.0,WellsFargo1,84,4
19,7626.0,84.62,49.57,35.05,7590.95,WellsFargo1,84,4
20,7590.95,84.62,49.34,35.28,7555.67,WellsFargo1,84,4
21,7555.67,84.62,49.11,35.51,7520.16,WellsFargo1,84,4
22,7520.16,84.62,48.88,35.74,7484.42,WellsFargo1,84,4
23,7484.42,84.62,48.65,35.97,7448.45,WellsFargo1,84,4
24,7448.45,84.62,48.41,36.21,7412.24,WellsFargo1,84,4
25,7412.24,84.62,48.18,36.44,7375.8,WellsFargo1,84,4
26,7375.8,84.62,47.94,36.68,7339.12,WellsFargo1,84,4
27,7339.12,84.62,47.7,36.92,7302.2,WellsFargo1,84,4
28,7302.2,84.62,47.46,37.16,7265.04,WellsFargo1,84,4
29,7265.04,84.62,47.22,37.4,7227.64,WellsFargo1,84,4
30,7227.64,84.62,46.98,37.64,7190.0,WellsFargo1,84,4
31,7190.0,84.62,46.73,37.89,7152.11,WellsFargo1,84,4
32,7152.11,84.62,46.49,38.13,7113.98,WellsFargo1,84,4
33,7113.98,84.62,46.24,38.38,7075.6,WellsFargo1,84,4
34,7075.6,84.62,45.99,38.63,7036.97,WellsFargo1,84,4
35,7036.97,84.62,45.74,38.88,6998.09,WellsFargo1,84,4
36,6998.09,84.62,45.49,39.13,6958.96,WellsFargo1,84,4
37,6958.96,84.62,45.23,39.39,6919.57,WellsFargo1,84,4
38,6919.57,84.62,44.98,39.64,6879.93,WellsFargo1,84,4
39,6879.93,84.62,44.72,39.9,6840.03,WellsFargo1,84,4
40,6840.03,84.62,44.46,40.16,6799.87,WellsFargo1,84,4
41,6799.87,84.62,44.2,40.42,6759.45,WellsFargo1,84,4
42,6759.45,84.62,43.94,40.68,6718.77,WellsFargo1,84,4
43,6718.77,84.62,43.67,40.95,6677.82,WellsFargo1,84,4
44,6677.82,84.62,43.41,41.21,6636.61,WellsFargo1,84,4
45,6636.61,84.62,43.14,41.48,6595.13,WellsFargo1,84,4
46,6595.13,84.62,42.87,41.75,6553.38,WellsFargo1,84,4
47,6553.38,84.62,42.6,42.02,6511.36,WellsFargo1,84,4
48,6511.36,84.62,42.32,42.3,6469.06,WellsFargo1,84,4
49,6469.06,84.62,42.05,42.57,6426.49,WellsFargo1,84,4
50,6426.49,84.62,41.77,42.85,6383.64,WellsFargo1,84,4
51,6383.64,84.62,41.49,43.13,6340.51,WellsFargo1,84,4
52,6340.51,84.62,41.21,43.41,6297.1,WellsFargo1,84,4
53,6297.1,84.62,40.93,43.69,6253.41,WellsFargo1,84,4
54,6253.41,84.62,40.65,43.97,6209.44,WellsFargo1,84,4
55,6209.44,84.62,40.36,44.26,6165.18,WellsFargo1,84,4
56,6165.18,84.62,40.07,44.55,6120.63,WellsFargo1,84,4
57,6120.63,84.62,39.78,44.84,6075.79,WellsFargo1,84,4
58,6075.79,84.62,39.49,45.13,6030.66,WellsFargo1,84,4
59,6030.66,84.62,39.2,45.42,5985.24,WellsFargo1,84,4
60,5985.24,84.62,38.9,45.72,5939.52,WellsFargo1,84,4
61,5939.52,84.62,38.61,46.01,5893.51,WellsFargo1,84,4
62,5893.51,84.62,38.31,46.31,5847.2,WellsFargo1,84,4
63,5847.2,84.62,38.01,46.61,5800.59,WellsFargo1,84,4
64,5800.59,84.62,37.7,46.92,5753.67,WellsFargo1,84,4
65,5753.67,84.62,37.4,47.22,5706.45,WellsFargo1,84,4
66,5706.45,84.62,37.09,47.53,5658.92,WellsFargo1,84,4
67,5658.92,84.62,36.78,47.84,5611.08,WellsFargo1,84,4
68,5611.08,84.62,36.47,48.15,5562.93,WellsFargo1,84,4
69,5562.93,84.62,36.16,48.46,5514.47,WellsFargo1,84,4
70,5514.47,84.62,35.84,48.78,5465.69,WellsFargo1,84,4
71,5465.69,84.62,35.53,49.09,5416.6,WellsFargo1,84,4
72,5416.6,84.62,35.21,49.41,5367.19,WellsFargo1,84,4
73,5367.19,84.62,34.89,49.73,5317.46,WellsFargo1,84,4
74,5317.46,84.62,34.56,50.06,5267.4,WellsFargo1,84,4
75,5267.4,84.62,34.24,50.38,5217.02,WellsFargo1,84,4
76,5217.02,84.62,33.91,50.71,5166.31,WellsFargo1,84,4
77,5166.31,84.62,33.58,51.04,5115.27,WellsFargo1,84,4
78,5115.27,84.62,33.25,51.37,5063.9,WellsFargo1,84,4
79,5063.9,84.62,32.92,51.7,5012.2,WellsFargo1,84,4
80,5012.2,84.62,32.58,52.04,4960.16,WellsFargo1,84,4
81,4960.16,1593.41,32.24,1561.17,3398.99,WellsFargo1,84,4
82,3398.99,2940.1,22.09,2918.01,480.98,WellsFargo1,84,4
83,480.98,2940.1,3.13,2936.97,-2455.99,WellsFargo1,84,4
0,4000.0,70.0,16.0,54.0,3946.0,testing,84,5
1,3946.0,70.0,15.78,54.22,3891.78,testing,84,5
2,3891.78,70.0,15.57,54.43,3837.35,testing,84,5
3,3837.35,70.0,15.35,54.65,3782.7,testing,84,5
4,3782.7,70.0,15.13,54.87,3727.83,testing,84,5
5,3727.83,70.0,14.91,55.09,3672.74,testing,84,5
6,3672.74,70.0,14.69,55.31,3617.43,testing,84,5
7,3617.43,70.0,14.47,55.53,3561.9,testing,84,5
8,3561.9,70.0,14.25,55.75,3506.15,testing,84,5
9,3506.15,70.0,14.02,55.98,3450.17,testing,84,5
10,3450.17,70.0,13.8,56.2,3393.97,testing,84,5
11,3393.97,70.0,13.58,56.42,3337.55,testing,84,5
12,3337.55,70.0,13.35,56.65,3280.9,testing,84,5
13,3280.9,70.0,13.12,56.88,3224.02,testing,84,5
14,3224.02,70.0,12.9,57.1,3166.92,testing,84,5
15,3166.92,70.0,12.67,57.33,3109.59,testing,84,5
16,3109.59,70.0,12.44,57.56,3052.03,testing,84,5
17,3052.03,70.0,12.21,57.79,2994.24,testing,84,5
18,2994.24,70.0,11.98,58.02,2936.22,testing,84,5
19,2936.22,70.0,11.74,58.26,2877.96,testing,84,5
20,2877.96,70.0,11.51,58.49,2819.47,testing,84,5
21,2819.47,70.0,11.28,58.72,2760.75,testing,84,5
22,2760.75,70.0,11.04,58.96,2701.79,testing,84,5
23,2701.79,70.0,10.81,59.19,2642.6,testing,84,5
24,2642.6,70.0,10.57,59.43,2583.17,testing,84,5
25,2583.17,70.0,10.33,59.67,2523.5,testing,84,5
26,2523.5,70.0,10.09,59.91,2463.59,testing,84,5
27,2463.59,70.0,9.85,60.15,2403.44,testing,84,5
28,2403.44,70.0,9.61,60.39,2343.05,testing,84,5
29,2343.05,70.0,9.37,60.63,2282.42,testing,84,5
30,2282.42,70.0,9.13,60.87,2221.55,testing,84,5
31,2221.55,70.0,8.89,61.11,2160.44,testing,84,5
32,2160.44,70.0,8.64,61.36,2099.08,testing,84,5
33,2099.08,70.0,8.4,61.6,2037.48,testing,84,5
34,2037.48,70.0,8.15,61.85,1975.63,testing,84,5
35,1975.63,70.0,7.9,62.1,1913.53,testing,84,5
36,1913.53,70.0,7.65,62.35,1851.18,testing,84,5
37,1851.18,70.0,7.4,62.6,1788.58,testing,84,5
38,1788.58,70.0,7.15,62.85,1725.73,testing,84,5
39,1725.73,70.0,6.9,63.1,1662.63,testing,84,5
40,1662.63,70.0,6.65,63.35,1599.28,testing,84,5
41,1599.28,70.0,6.4,63.6,1535.68,testing,84,5
42,1535.68,70.0,6.14,63.86,1471.82,testing,84,5
43,1471.82,70.0,5.89,64.11,1407.71,testing,84,5
44,1407.71,70.0,5.63,64.37,1343.34,testing,84,5
45,1343.34,70.0,5.37,64.63,1278.71,testing,84,5
46,1278.71,70.0,5.11,64.89,1213.82,testing,84,5
47,1213.82,70.0,4.86,65.14,1148.68,testing,84,5
48,1148.68,70.0,4.59,65.41,1083.27,testing,84,5
49,1083.27,70.0,4.33,65.67,1017.6,testing,84,5
50,1017.6,70.0,4.07,65.93,951.67,testing,84,5
51,951.67,70.0,3.81,66.19,885.48,testing,84,5
52,885.48,70.0,3.54,66.46,819.02,testing,84,5
53,819.02,70.0,3.28,66.72,752.3,testing,84,5
54,752.3,70.0,3.01,66.99,685.31,testing,84,5
55,685.31,70.0,2.74,67.26,618.05,testing,84,5
56,618.05,70.0,2.47,67.53,550.52,testing,84,5
57,550.52,70.0,2.2,67.8,482.72,testing,84,5
58,482.72,70.0,1.93,68.07,414.65,testing,84,5
59,414.65,70.0,1.66,68.34,346.31,testing,84,5
60,346.31,70.0,1.39,68.61,277.7,testing,84,5
61,277.7,70.0,1.11,68.89,208.81,testing,84,5
62,208.81,70.0,0.84,69.16,139.65,testing,84,5
63,139.65,70.0,0.56,69.44,70.21,testing,84,5
64,70.21,70.0,0.28,69.72,0.49,testing,84,5
65,0.49,70.0,0.0,70.0,-69.51,testing,84,5
0,20000.0,1191.04,108.0,1083.04,18916.96,WellsFargo2,85,1
1,18916.96,1191.04,102.15,1088.89,17828.07,WellsFargo2,85,1
2,17828.07,1191.04,96.27,1094.77,16733.3,WellsFargo2,85,1
3,16733.3,1191.04,90.36,1100.68,15632.62,WellsFargo2,85,1
4,15632.62,1191.04,84.42,1106.62,14526.0,WellsFargo2,85,1
5,14526.0,1191.04,78.44,1112.6,13413.4,WellsFargo2,85,1
6,13413.4,1191.04,72.43,1118.61,12294.79,WellsFargo2,85,1
7,12294.79,1191.04,66.39,1124.65,11170.14,WellsFargo2,85,1
8,11170.14,1191.04,60.32,1130.72,10039.42,WellsFargo2,85,1
9,10039.42,1191.04,54.21,1136.83,8902.59,WellsFargo2,85,1
10,8902.59,1191.04,48.07,1142.97,7759.62,WellsFargo2,85,1
11,7759.62,1191.04,41.9,1149.14,6610.48,WellsFargo2,85,1
12,6610.48,1191.04,35.7,1155.34,5455.14,WellsFargo2,85,1
13,5455.14,1191.04,29.46,1161.58,4293.56,WellsFargo2,85,1
14,4293.56,1191.04,23.19,1167.85,3125.71,WellsFargo2,85,1
15,3125.71,1191.04,16.88,1174.16,1951.55,WellsFargo2,85,1
16,1951.55,1191.04,10.54,1180.5,771.05,WellsFargo2,85,1
17,771.05,1191.04,4.16,1186.88,-415.83,WellsFargo2,85,1
0,8250.57,84.62,53.63,30.99,8219.58,WellsFargo1,85,2
1,8219.58,84.62,53.43,31.19,8188.39,WellsFargo1,85,2
2,8188.39,84.62,53.22,31.4,8156.99,WellsFargo1,85,2
3,8156.99,84.62,53.02,31.6,8125.39,WellsFargo1,85,2
4,8125.39,84.62,52.82,31.8,8093.59,WellsFargo1,85,2
5,8093.59,84.62,52.61,32.01,8061.58,WellsFargo1,85,2
6,8061.58,84.62,52.4,32.22,8029.36,WellsFargo1,85,2
7,8029.36,84.62,52.19,32.43,7996.93,WellsFargo1,85,2
8,7996.93,84.62,51.98,32.64,7964.29,WellsFargo1,85,2
9,7964.29,84.62,51.77,32.85,7931.44,WellsFargo1,85,2
10,7931.44,84.62,51.55,33.07,7898.37,WellsFargo1,85,2
11,7898.37,84.62,51.34,33.28,7865.09,WellsFargo1,85,2
12,7865.09,84.62,51.12,33.5,7831.59,WellsFargo1,85,2
13,7831.59,84.62,50.91,33.71,7797.88,WellsFargo1,85,2
14,7797.88,84.62,50.69,33.93,7763.95,WellsFargo1,85,2
15,7763.95,84.62,50.47,34.15,7729.8,WellsFargo1,85,2
16,7729.8,84.62,50.24,34.38,7695.42,WellsFargo1,85,2
17,7695.42,500.45,50.02,450.43,7244.99,WellsFargo1,85,2
18,7244.99,1275.66,47.09,1228.57,6016.42,WellsFargo1,85,2
19,6016.42,1275.66,39.11,1236.55,4779.87,WellsFargo1,85,2
20,4779.87,1275.66,31.07,1244.59,3535.28,WellsFargo1,85,2
21,3535.28,1275.66,22.98,1252.68,2282.6,WellsFargo1,85,2
22,2282.6,1275.66,14.84,1260.82,1021.78,WellsFargo1,85,2
23,1021.78,1275.66,6.64,1269.02,-247.24,WellsFargo1,85,2
0,4000.0,70.0,16.0,54.0,3946.0,testing,85,3
1,3946.0,70.0,15.78,54.22,3891.78,testing,85,3
2,3891.78,70.0,15.57,54.43,3837.35,testing,85,3
3,3837.35,70.0,15.35,54.65,3782.7,testing,85,3
4,3782.7,70.0,15.13,54.87,3727.83,testing,85,3
5,3727.83,70.0,14.91,55.09,3672.74,testing,85,3
6,3672.74,70.0,14.69,55.31,3617.43,testing,85,3
7,3617.43,70.0,14.47,55.53,3561.9,testing,85,3
8,3561.9,70.0,14.25,55.75,3506.15,testing,85,3
9,3506.15,70.0,14.02,55.98,3450.17,testing,85,3
10,3450.17,70.0,13.8,56.2,3393.97,testing,85,3
11,3393.97,70.0,13.58,56.42,3337.55,testing,85,3
12,3337.55,70.0,13.35,56.65,3280.9,testing,85,3
13,3280.9,70.0,13.12,56.88,3224.02,testing,85,3
14,3224.02,70.0,12.9,57.1,3166.92,testing,85,3
15,3166.92,70.0,12.67,57.33,3109.59,testing,85,3
16,3109.59,70.0,12.44,57.56,3052.03,testing,85,3
17,3052.03,70.0,12.21,57.79,2994.24,testing,85,3
18,2994.24,70.0,11.98,58.02,2936.22,testing,85,3
19,2936.22,70.0,11.74,58.26,2877.96,testing,85,3
20,2877.96,70.0,11.51,58.49,2819.47,testing,85,3
21,2819.47,70.0,11.28,58.72,2760.75,testing,85,3
22,2760.75,70.0,11.04,58.96,2701.79,testing,85,3
23,2701.79,317.24,10.81,306.43,2395.36,testing,85,3
24,2395.36,1345.66,9.58,1336.08,1059.28,testing,85,3
25,1059.28,1345.66,4.24,1341.42,-282.14,testing,85,3
0,5000.0,333.0,36.0,297.0,4703.0,Car,85,4
1,4703.0,333.0,33.86,299.14,4403.86,Car,85,4
2,4403.86,333.0,31.71,301.29,4102.57,Car,85,4
3,4102.57,333.0,29.54,303.46,3799.11,Car,85,4
4,3799.11,333.0,27.35,305.65,3493.46,Car,85,4
5,3493.46,333.0,25.15,307.85,3185.61,Car,85,4
6,3185.61,333.0,22.94,310.06,2875.55,Car,85,4
7,2875.55,333.0,20.7,312.3,2563.25,Car,85,4
8,2563.25,333.0,18.46,314.54,2248.71,Car,85,4
9,2248.71,333.0,16.19,316.81,1931.9,Car,85,4
10,1931.9,333.0,13.91,319.09,1612.81,Car,85,4
11,1612.81,333.0,11.61,321.39,1291.42,Car,85,4
12,1291.42,333.0,9.3,323.7,967.72,Car,85,4
13,967.72,333.0,6.97,326.03,641.69,Car,85,4
14,641.69,333.0,4.62,328.38,313.31,Car,85,4
15,313.31,333.0,2.26,330.74,-17.43,Car,85,4
0,180000.0,1331.44,594.0,737.44,179262.56,mortgage,85,5
1,179262.56,1331.44,591.57,739.87,178522.69,mortgage,85,5
2,178522.69,1331.44,589.12,742.32,177780.37,mortgage,85,5
3,177780.37,1331.44,586.68,744.76,177035.61,mortgage,85,5
4,177035.61,1331.44,584.22,747.22,176288.39,mortgage,85,5
5,176288.39,1331.44,581.75,749.69,175538.7,mortgage,85,5
6,175538.7,1331.44,579.28,752.16,174786.54,mortgage,85,5
7,174786.54,1331.44,576.8,754.64,174031.9,mortgage,85,5
8,174031.9,1331.44,574.31,757.13,173274.77,mortgage,85,5
9,173274.77,1331.44,571.81,759.63,172515.14,mortgage,85,5
10,172515.14,1331.44,569.3,762.14,171753.0,mortgage,85,5
11,171753.0,1331.44,566.78,764.66,170988.34,mortgage,85,5
12,170988.34,1331.44,564.26,767.18,170221.16,mortgage,85,5
13,170221.16,1331.44,561.73,769.71,169451.45,mortgage,85,5
14,169451.45,1331.44,559.19,772.25,168679.2,mortgage,85,5
15,168679.2,1348.87,556.64,792.23,167886.97,mortgage,85,5
16,167886.97,3010.1,554.03,2456.07,165430.9,mortgage,85,5
17,165430.9,3010.1,545.92,2464.18,162966.72,mortgage,85,5
18,162966.72,3010.1,537.79,2472.31,160494.41,mortgage,85,5
19,160494.41,3010.1,529.63,2480.47,158013.94,mortgage,85,5
20,158013.94,3010.1,521.45,2488.65,155525.29,mortgage,85,5
21,155525.29,3010.1,513.23,2496.87,153028.42,mortgage,85,5
22,153028.42,3010.1,504.99,2505.11,150523.31,mortgage,85,5
23,150523.31,3010.1,496.73,2513.37,148009.94,mortgage,85,5
24,148009.94,3010.1,488.43,2521.67,145488.27,mortgage,85,5
25,145488.27,3010.1,480.11,2529.99,142958.28,mortgage,85,5
26,142958.28,3010.1,471.76,2538.34,140419.94,mortgage,85,5
27,140419.94,3010.1,463.39,2546.71,137873.23,mortgage,85,5
28,137873.23,3010.1,454.98,2555.12,135318.11,mortgage,85,5
29,135318.11,3010.1,446.55,2563.55,132754.56,mortgage,85,5
30,132754.56,3010.1,438.09,2572.01,130182.55,mortgage,85,5
31,130182.55,3010.1,429.6,2580.5,127602.05,mortgage,85,5
32,127602.05,3010.1,421.09,2589.01,125013.04,mortgage,85,5
33,125013.04,3010.1,412.54,2597.56,122415.48,mortgage,85,5
34,122415.48,3010.1,403.97,2606.13,119809.35,mortgage,85,5
35,119809.35,3010.1,395.37,2614.73,117194.62,mortgage,85,5
36,117194.62,3010.1,386.74,2623.36,114571.26,mortgage,85,5
37,114571.26,3010.1,378.09,2632.01,111939.25,mortgage,85,5
38,111939.25,3010.1,369.4,2640.7,109298.55,mortgage,85,5
39,109298.55,3010.1,360.69,2649.41,106649.14,mortgage,85,5
40,106649.14,3010.1,351.94,2658.16,103990.98,mortgage,85,5
41,103990.98,3010.1,343.17,2666.93,101324.05,mortgage,85,5
42,101324.05,3010.1,334.37,2675.73,98648.32,mortgage,85,5
43,98648.32,3010.1,325.54,2684.56,95963.76,mortgage,85,5
44,95963.76,3010.1,316.68,2693.42,93270.34,mortgage,85,5
45,93270.34,3010.1,307.79,2702.31,90568.03,mortgage,85,5
46,90568.03,3010.1,298.87,2711.23,87856.8,mortgage,85,5
47,87856.8,3010.1,289.93,2720.17,85136.63,mortgage,85,5
48,85136.63,3010.1,280.95,2729.15,82407.48,mortgage,85,5
49,82407.48,3010.1,271.94,2738.16,79669.32,mortgage,85,5
50,79669.32,3010.1,262.91,2747.19,76922.13,mortgage,85,5
51,76922.13,3010.1,253.84,2756.26,74165.87,mortgage,85,5
52,74165.87,3010.1,244.75,2765.35,71400.52,mortgage,85,5
53,71400.52,3010.1,235.62,2774.48,68626.04,mortgage,85,5
54,68626.04,3010.1,226.47,2783.63,65842.41,mortgage,85,5
55,65842.41,3010.1,217.28,2792.82,63049.59,mortgage,85,5
56,63049.59,3010.1,208.06,2802.04,60247.55,mortgage,85,5
57,60247.55,3010.1,198.82,2811.28,57436.27,mortgage,85,5
58,57436.27,3010.1,189.54,2820.56,54615.71,mortgage,85,5
59,54615.71,3010.1,180.23,2829.87,51785.84,mortgage,85,5
60,51785.84,3010.1,170.89,2839.21,48946.63,mortgage,85,5
61,48946.63,3010.1,161.52,2848.58,46098.05,mortgage,85,5
62,46098.05,3010.1,152.12,2857.98,43240.07,mortgage,85,5
63,43240.07,3010.1,142.69,2867.41,40372.66,mortgage,85,5
64,40372.66,3010.1,133.23,2876.87,37495.79,mortgage,85,5
65,37495.79,3010.1,123.74,2886.36,34609.43,mortgage,85,5
66,34609.43,3010.1,114.21,2895.89,31713.54,mortgage,85,5
67,31713.54,3010.1,104.65,2905.45,28808.09,mortgage,85,5
68,28808.09,3010.1,95.07,2915.03,25893.06,mortgage,85,5
69,25893.06,3010.1,85.45,2924.65,22968.41,mortgage,85,5
70,22968.41,3010.1,75.8,2934.3,20034.11,mortgage,85,5
71,20034.11,3010.1,66.11,2943.99,17090.12,mortgage,85,5
72,17090.12,3010.1,56.4,2953.7,14136.42,mortgage,85,5
73,14136.42,3010.1,46.65,2963.45,11172.97,mortgage,85,5
74,11172.97,3010.1,36.87,2973.23,8199.74,mortgage,85,5
75,8199.74,3010.1,27.06,2983.04,5216.7,mortgage,85,5
76,5216.7,3010.1,17.22,2992.88,2223.82,mortgage,85,5
77,2223.82,3010.1,7.34,3002.76,-778.94,mortgage,85,5
0,20000.0,1191.04,108.0,1083.04,18916.96,WellsFargo2,86,1
1,18916.96,1191.04,102.15,1088.89,17828.07,WellsFargo2,86,1
2,17828.07,1191.04,96.27,1094.77,16733.3,WellsFargo2,86,1
3,16733.3,1191.04,90.36,1100.68,15632.62,WellsFargo2,86,1
4,15632.62,1191.04,84.42,1106.62,14526.0,WellsFargo2,86,1
5,14526.0,1191.04,78.44,1112.6,13413.4,WellsFargo2,86,1
6,13413.4,1191.04,72.43,1118.61,12294.79,WellsFargo2,86,1
7,12294.79,1191.04,66.39,1124.65,11170.14,WellsFargo2,86,1
8,11170.14,1191.04,60.32,1130.72,10039.42,WellsFargo2,86,1
9,10039.42,1191.04,54.21,1136.83,8902.59,WellsFargo2,86,1
10,8902.59,1191.04,48.07,1142.97,7759.62,WellsFargo2,86,1
11,7759.62,1191.04,41.9,1149.14,6610.48,WellsFargo2,86,1
12,6610.48,1191.04,35.7,1155.34,5455.14,WellsFargo2,86,1
13,5455.14,1191.04,29.46,1161.58,4293.56,WellsFargo2,86,1
14,4293.56,1191.04,23.19,1167.85,3125.71,WellsFargo2,86,1
15,3125.71,1191.04,16.88,1174.16,1951.55,WellsFargo2,86,1
16,1951.55,1191.04,10.54,1180.5,771.05,WellsFargo2,86,1
17,771.05,1191.04,4.16,1186.88,-415.83,WellsFargo2,86,1
0,8250.57,84.62,53.63,30.99,8219.58,WellsFargo1,86,2
1,8219.58,84.62,53.43,31.19,8188.39,WellsFargo1,86,2
2,8188.39,84.62,53.22,31.4,8156.99,WellsFargo1,86,2
3,8156.99,84.62,53.02,31.6,8125.39,WellsFargo1,86,2
4,8125.39,84.62,52.82,31.8,8093.59,WellsFargo1,86,2
5,8093.59,84.62,52.61,32.01,8061.58,WellsFargo1,86,2
6,8061.58,84.62,52.4,32.22,8029.36,WellsFargo1,86,2
7,8029.36,84.62,52.19,32.43,7996.93,WellsFargo1,86,2
8,7996.93,84.62,51.98,32.64,7964.29,WellsFargo1,86,2
9,7964.29,84.62,51.77,32.85,7931.44,WellsFargo1,86,2
10,7931.44,84.62,51.55,33.07,7898.37,WellsFargo1,86,2
11,7898.37,84.62,51.34,33.28,7865.09,WellsFargo1,86,2
12,7865.09,84.62,51.12,33.5,7831.59,WellsFargo1,86,2
13,7831.59,84.62,50.91,33.71,7797.88,WellsFargo1,86,2
14,7797.88,84.62,50.69,33.93,7763.95,WellsFargo1,86,2
15,7763.95,84.62,50.47,34.15,7729.8,WellsFargo1,86,2
16,7729.8,84.62,50.24,34.38,7695.42,WellsFargo1,86,2
17,7695.42,500.45,50.02,450.43,7244.99,WellsFargo1,86,2
18,7244.99,1275.66,47.09,1228.57,6016.42,WellsFargo1,86,2
19,6016.42,1275.66,39.11,1236.55,4779.87,WellsFargo1,86,2
20,4779.87,1275.66,31.07,1244.59,3535.28,WellsFargo1,86,2
21,3535.28,1275.66,22.98,1252.68,2282.6,WellsFargo1,86,2
22,2282.6,1275.66,14.84,1260.82,1021.78,WellsFargo1,86,2
23,1021.78,1275.66,6.64,1269.02,-247.24,WellsFargo1,86,2
0,4000.0,70.0,16.0,54.0,3946.0,testing,86,3
1,3946.0,70.0,15.78,54.22,3891.78,testing,86,3
2,3891.78,70.0,15.57,54.43,3837.35,testing,86,3
3,3837.35,70.0,15.35,54.65,3782.7,testing,86,3
4,3782.7,70.0,15.13,54.87,3727.83,testing,86,3
5,3727.83,70.0,14.91,55.09,3672.74,testing,86,3
6,3672.74,70.0,14.69,55.31,3617.43,testing,86,3
7,3617.43,70.0,14.47,55.53,3561.9,testing,86,3
8,3561.9,70.0,14.25,55.75,3506.15,testing,86,3
9,3506.15,70.0,14.02,55.98,3450.17,testing,86,3
10,3450.17,70.0,13.8,56.2,3393.97,testing,86,3
11,3393.97,70.0,13.58,56.42,3337.55,testing,86,3
12,3337.55,70.0,13.35,56.65,3280.9,testing,86,3
13,3280.9,70.0,13.12,56.88,3224.02,testing,86,3
14,3224.02,70.0,12.9,57.1,3166.92,testing,86,3
15,3166.92,70.0,12.67,57.33,3109.59,testing,86,3
16,3109.59,70.0,12.44,57.56,3052.03,testing,86,3
17,3052.03,70.0,12.21,57.79,2994.24,testing,86,3
18,2994.24,70.0,11.98,58.02,2936.22,testing,86,3
19,2936.22,70.0,11.74,58.26,2877.96,testing,86,3
20,2877.96,70.0,11.51,58.49,2819.47,testing,86,3
21,2819.47,70.0,11.28,58.72,2760.75,testing,86,3
22,2760.75,70.0,11.04,58.96,2701.79,testing,86,3
23,2701.79,317.24,10.81,306.43,2395.36,testing,86,3
24,2395.36,1345.66,9.58,1336.08,1059.28,testing,86,3
25,1059.28,1345.66,4.24,1341.42,-282.14,testing,86,3
0,180000.0,1331.44,594.0,737.44,179262.56,mortgage,86,4
1,179262.56,1331.44,591.57,739.87,178522.69,mortgage,86,4
2,178522.69,1331.44,589.12,742.32,177780.37,mortgage,86,4
3,177780.37,1331.44,586.68,744.76,177035.61,mortgage,86,4
4,177035.61,1331.44,584.22,747.22,176288.39,mortgage,86,4
5,176288.39,1331.44,581.75,749.69,175538.7,mortgage,86,4
6,175538.7,1331.44,579.28,752.16,174786.54,mortgage,86,4
7,174786.54,1331.44,576.8,754.64,174031.9,mortgage,86,4
8,174031.9,1331.44,574.31,757.13,173274.77,mortgage,86,4
9,173274.77,1331.44,571.81,759.63,172515.14,mortgage,86,4
10,172515.14,1331.44,569.3,762.14,171753.0,mortgage,86,4
11,171753.0,1331.44,566.78,764.66,170988.34,mortgage,86,4
12,170988.34,1331.44,564.26,767.18,170221.16,mortgage,86,4
13,170221.16,1331.44,561.73,769.71,169451.45,mortgage,86,4
14,169451.45,1331.44,559.19,772.25,168679.2,mortgage,86,4
15,168679.2,1331.44,556.64,774.8,167904.4,mortgage,86,4
16,167904.4,1331.44,554.08,777.36,167127.04,mortgage,86,4
17,167127.04,1331.44,551.52,779.92,166347.12,mortgage,86,4
18,166347.12,1331.44,548.95,782.49,165564.63,mortgage,86,4
19,165564.63,1331.44,546.36,785.08,164779.55,mortgage,86,4
20,164779.55,1331.44,543.77,787.67,163991.88,mortgage,86,4
21,163991.88,1331.44,541.17,790.27,163201.61,mortgage,86,4
22,163201.61,1331.44,538.57,792.87,162408.74,mortgage,86,4
23,162408.74,1331.44,535.95,795.49,161613.25,mortgage,86,4
24,161613.25,1331.44,533.32,798.12,160815.13,mortgage,86,4
25,160815.13,1613.58,530.69,1082.89,159732.24,mortgage,86,4
26,159732.24,2677.1,527.12,2149.98,157582.26,mortgage,86,4
27,157582.26,2677.1,520.02,2157.08,155425.18,mortgage,86,4
28,155425.18,2677.1,512.9,2164.2,153260.98,mortgage,86,4
29,153260.98,2677.1,505.76,2171.34,151089.64,mortgage,86,4
30,151089.64,2677.1,498.6,2178.5,148911.14,mortgage,86,4
31,148911.14,2677.1,491.41,2185.69,146725.45,mortgage,86,4
32,146725.45,2677.1,484.19,2192.91,144532.54,mortgage,86,4
33,144532.54,2677.1,476.96,2200.14,142332.4,mortgage,86,4
34,142332.4,2677.1,469.7,2207.4,140125.0,mortgage,86,4
35,140125.0,2677.1,462.41,2214.69,137910.31,mortgage,86,4
36,137910.31,2677.1,455.1,2222.0,135688.31,mortgage,86,4
37,135688.31,2677.1,447.77,2229.33,133458.98,mortgage,86,4
38,133458.98,2677.1,440.41,2236.69,131222.29,mortgage,86,4
39,131222.29,2677.1,433.03,2244.07,128978.22,mortgage,86,4
40,128978.22,2677.1,425.63,2251.47,126726.75,mortgage,86,4
41,126726.75,2677.1,418.2,2258.9,124467.85,mortgage,86,4
42,124467.85,2677.1,410.74,2266.36,122201.49,mortgage,86,4
43,122201.49,2677.1,403.26,2273.84,119927.65,mortgage,86,4
44,119927.65,2677.1,395.76,2281.34,117646.31,mortgage,86,4
45,117646.31,2677.1,388.23,2288.87,115357.44,mortgage,86,4
46,115357.44,2677.1,380.68,2296.42,113061.02,mortgage,86,4
47,113061.02,2677.1,373.1,2304.0,110757.02,mortgage,86,4
48,110757.02,2677.1,365.5,2311.6,108445.42,mortgage,86,4
49,108445.42,2677.1,357.87,2319.23,106126.19,mortgage,86,4
50,106126.19,2677.1,350.22,2326.88,103799.31,mortgage,86,4
51,103799.31,2677.1,342.54,2334.56,101464.75,mortgage,86,4
52,101464.75,2677.1,334.83,2342.27,99122.48,mortgage,86,4
53,99122.48,2677.1,327.1,2350.0,96772.48,mortgage,86,4
54,96772.48,2677.1,319.35,2357.75,94414.73,mortgage,86,4
55,94414.73,2677.1,311.57,2365.53,92049.2,mortgage,86,4
56,92049.2,2677.1,303.76,2373.34,89675.86,mortgage,86,4
57,89675.86,2677.1,295.93,2381.17,87294.69,mortgage,86,4
58,87294.69,2677.1,288.07,2389.03,84905.66,mortgage,86,4
59,84905.66,2677.1,280.19,2396.91,82508.75,mortgage,86,4
60,82508.75,2677.1,272.28,2404.82,80103.93,mortgage,86,4
61,80103.93,2677.1,264.34,2412.76,77691.17,mortgage,86,4
62,77691.17,2677.1,256.38,2420.72,75270.45,mortgage,86,4
63,75270.45,2677.1,248.39,2428.71,72841.74,mortgage,86,4
64,72841.74,2677.1,240.38,2436.72,70405.02,mortgage,86,4
65,70405.02,2677.1,232.34,2444.76,67960.26,mortgage,86,4
66,67960.26,2677.1,224.27,2452.83,65507.43,mortgage,86,4
67,65507.43,2677.1,216.17,2460.93,63046.5,mortgage,86,4
68,63046.5,2677.1,208.05,2469.05,60577.45,mortgage,86,4
69,60577.45,2677.1,199.91,2477.19,58100.26,mortgage,86,4
70,58100.26,2677.1,191.73,2485.37,55614.89,mortgage,86,4
71,55614.89,2677.1,183.53,2493.57,53121.32,mortgage,86,4
72,53121.32,2677.1,175.3,2501.8,50619.52,mortgage,86,4
73,50619.52,2677.1,167.04,2510.06,48109.46,mortgage,86,4
74,48109.46,2677.1,158.76,2518.34,45591.12,mortgage,86,4
75,45591.12,2677.1,150.45,2526.65,43064.47,mortgage,86,4
76,43064.47,2677.1,142.11,2534.99,40529.48,mortgage,86,4
77,40529.48,2677.1,133.75,2543.35,37986.13,mortgage,86,4
78,37986.13,2677.1,125.35,2551.75,35434.38,mortgage,86,4
79,35434.38,2677.1,116.93,2560.17,32874.21,mortgage,86,4
80,32874.21,2677.1,108.48,2568.62,30305.59,mortgage,86,4
81,30305.59,2677.1,100.01,2577.09,27728.5,mortgage,86,4
82,27728.5,2677.1,91.5,2585.6,25142.9,mortgage,86,4
83,25142.9,2677.1,82.97,2594.13,22548.77,mortgage,86,4
84,22548.77,2677.1,74.41,2602.69,19946.08,mortgage,86,4
85,19946.08,2677.1,65.82,2611.28,17334.8,mortgage,86,4
86,17334.8,2677.1,57.2,2619.9,14714.9,mortgage,86,4
87,14714.9,2677.1,48.56,2628.54,12086.36,mortgage,86,4
88,12086.36,2677.1,39.88,2637.22,9449.14,mortgage,86,4
89,9449.14,2677.1,31.18,2645.92,6803.22,mortgage,86,4
90,6803.22,2677.1,22.45,2654.65,4148.57,mortgage,86,4
91,4148.57,2677.1,13.69,2663.41,1485.16,mortgage,86,4
92,1485.16,2677.1,4.9,2672.2,-1187.04,mortgage,86,4
0,5000.0,333.0,36.0,297.0,4703.0,Car,86,5
1,4703.0,333.0,33.86,299.14,4403.86,Car,86,5
2,4403.86,333.0,31.71,301.29,4102.57,Car,86,5
3,4102.57,333.0,29.54,303.46,3799.11,Car,86,5
4,3799.11,333.0,27.35,305.65,3493.46,Car,86,5
5,3493.46,333.0,25.15,307.85,3185.61,Car,86,5
6,3185.61,333.0,22.94,310.06,2875.55,Car,86,5
7,2875.55,333.0,20.7,312.3,2563.25,Car,86,5
8,2563.25,333.0,18.46,314.54,2248.71,Car,86,5
9,2248.71,333.0,16.19,316.81,1931.9,Car,86,5
10,1931.9,333.0,13.91,319.09,1612.81,Car,86,5
11,1612.81,333.0,11.61,321.39,1291.42,Car,86,5
12,1291.42,333.0,9.3,323.7,967.72,Car,86,5
13,967.72,333.0,6.97,326.03,641.69,Car,86,5
14,641.69,333.0,4.62,328.38,313.31,Car,86,5
15,313.31,333.0,2.26,330.74,-17.43,Car,86,5
0,20000.0,1191.04,108.0,1083.04,18916.96,WellsFargo2,87,1
1,18916.96,1191.04,102.15,1088.89,17828.07,WellsFargo2,87,1
2,17828.07,1191.04,96.27,1094.77,16733.3,WellsFargo2,87,1
3,16733.3,1191.04,90.36,1100.68,15632.62,WellsFargo2,87,1
4,15632.62,1191.04,84.42,1106.62,14526.0,WellsFargo2,87,1
5,14526.0,1191.04,78.44,1112.6,13413.4,WellsFargo2,87,1
6,13413.4,1191.04,72.43,1118.61,12294.79,WellsFargo2,87,1
7,12294.79,1191.04,66.39,1124.65,11170.14,WellsFargo2,87,1
8,11170.14,1191.04,60.32,1130.72,10039.42,WellsFargo2,87,1
9,10039.42,1191.04,54.21,1136.83,8902.59,WellsFargo2,87,1
10,8902.59,1191.04,48.07,1142.97,7759.62,WellsFargo2,87,1
11,7759.62,1191.04,41.9,1149.14,6610.48,WellsFargo2,87,1
12,6610.48,1191.04,35.7,1155.34,5455.14,WellsFargo2,87,1
13,5455.14,1191.04,29.46,1161.58,4293.56,WellsFargo2,87,1
14,4293.56,1191.04,23.19,1167.85,3125.71,WellsFargo2,87,1
15,3125.71,1191.04,16.88,1174.16,1951.55,WellsFargo2,87,1
16,1951.55,1191.04,10.54,1180.5,771.05,WellsFargo2,87,1
17,771.05,1191.04,4.16,1186.88,-415.83,WellsFargo2,87,1
0,8250.57,84.62,53.63,30.99,8219.58,WellsFargo1,87,2
1,8219.58,84.62,53.43,31.19,8188.39,WellsFargo1,87,2
2,8188.39,84.62,53.22,31.4,8156.99,WellsFargo1,87,2
3,8156.99,84.62,53.02,31.6,8125.39,WellsFargo1,87,2
4,8125.39,84.62,52.82,31.8,8093.59,WellsFargo1,87,2
5,8093.59,84.62,52.61,32.01,8061.58,WellsFargo1,87,2
6,8061.58,84.62,52.4,32.22,8029.36,WellsFargo1,87,2
7,8029.36,84.62,52.19,32.43,7996.93,WellsFargo1,87,2
8,7996.93,84.62,51.98,32.64,7964.29,WellsFargo1,87,2
9,7964.29,84.62,51.77,32.85,7931.44,WellsFargo1,87,2
10,7931.44,84.62,51.55,33.07,7898.37,WellsFargo1,87,2
11,7898.37,84.62,51.34,33.28,7865.09,WellsFargo1,87,2
12,7865.09,84.62,51.12,33.5,7831.59,WellsFargo1,87,2
13,7831.59,84.62,50.91,33.71,7797.88,WellsFargo1,87,2
14,7797.88,84.62,50.69,33.93,7763.95,WellsFargo1,87,2
15,7763.95,84.62,50.47,34.15,7729.8,WellsFargo1,87,2
16,7729.8,84.62,50.24,34.38,7695.42,WellsFargo1,87,2
17,7695.42,500.45,50.02,450.43,7244.99,WellsFargo1,87,2
18,7244.99,1275.66,47.09,1228.57,6016.42,WellsFargo1,87,2
19,6016.42,1275.66,39.11,1236.55,4779.87,WellsFargo1,87,2
20,4779.87,1275.66,31.07,1244.59,3535.28,WellsFargo1,87,2
21,3535.28,1275.66,22.98,1252.68,2282.6,WellsFargo1,87,2
22,2282.6,1275.66,14.84,1260.82,1021.78,WellsFargo1,87,2
23,1021.78,1275.66,6.64,1269.02,-247.24,WellsFargo1,87,2
0,5000.0,333.0,36.0,297.0,4703.0,Car,87,3
1,4703.0,333.0,33.86,299.14,4403.86,Car,87,3
2,4403.86,333.0,31.71,301.29,4102.57,Car,87,3
3,4102.57,333.0,29.54,303.46,3799.11,Car,87,3
4,3799.11,333.0,27.35,305.65,3493.46,Car,87,3
5,3493.46,333.0,25.15,307.85,3185.61,Car,87,3
6,3185.61,333.0,22.94,310.06,2875.55,Car,87,3
7,2875.55,333.0,20.7,312.3,2563.25,Car,87,3
8,2563.25,333.0,18.46,314.54,2248.71,Car,87,3
9,2248.71,333.0,16.19,316.81,1931.9,Car,87,3
10,1931.9,333.0,13.91,319.09,1612.81,Car,87,3
11,1612.81,333.0,11.61,321.39,1291.42,Car,87,3
12,1291.42,333.0,9.3,323.7,967.72,Car,87,3
13,967.72,333.0,6.97,326.03,641.69,Car,87,3
14,641.69,333.0,4.62,328.38,313.31,Car,87,3
15,313.31,333.0,2.26,330.74,-17.43,Car,87,3
0,4000.0,70.0,16.0,54.0,3946.0,testing,87,4
1,3946.0,70.0,15.78,54.22,3891.78,testing,87,4
2,3891.78,70.0,15.57,54.43,3837.35,testing,87,4
3,3837.35,70.0,15.35,54.65,3782.7,testing,87,4
4,3782.7,70.0,15.13,54.87,3727.83,testing,87,4
5,3727.83,70.0,14.91,55.09,3672.74,testing,87,4
6,3672.74,70.0,14.69,55.31,3617.43,testing,87,4
7,3617.43,70.0,14.47,55.53,3561.9,testing,87,4
8,3561.9,70.0,14.25,55.75,3506.15,testing,87,4
9,3506.15,70.0,14.02,55.98,3450.17,testing,87,4
10,3450.17,70.0,13.8,56.2,3393.97,testing,87,4
11,3393.97,70.0,13.58,56.42,3337.55,testing,87,4
12,3337.55,70.0,13.35,56.65,3280.9,testing,87,4
13,3280.9,70.0,13.12,56.88,3224.02,testing,87,4
14,3224.02,70.0,12.9,57.1,3166.92,testing,87,4
15,3166.92,87.43,12.67,74.76,3092.16,testing,87,4
16,3092.16,1678.66,12.37,1666.29,1425.87,testing,87,4
17,1425.87,1678.66,5.7,1672.96,-247.09,testing,87,4
0,180000.0,1331.44,594.0,737.44,179262.56,mortgage,87,5
1,179262.56,1331.44,591.57,739.87,178522.69,mortgage,87,5
2,178522.69,1331.44,589.12,742.32,177780.37,mortgage,87,5
3,177780.37,1331.44,586.68,744.76,177035.61,mortgage,87,5
4,177035.61,1331.44,584.22,747.22,176288.39,mortgage,87,5
5,176288.39,1331.44,581.75,749.69,175538.7,mortgage,87,5
6,175538.7,1331.44,579.28,752.16,174786.54,mortgage,87,5
7,174786.54,1331.44,576.8,754.64,174031.9,mortgage,87,5
8,174031.9,1331.44,574.31,757.13,173274.77,mortgage,87,5
9,173274.77,1331.44,571.81,759.63,172515.14,mortgage,87,5
10,172515.14,1331.44,569.3,762.14,171753.0,mortgage,87,5
11,171753.0,1331.44,566.78,764.66,170988.34,mortgage,87,5
12,170988.34,1331.44,564.26,767.18,170221.16,mortgage,87,5
13,170221.16,1331.44,561.73,769.71,169451.45,mortgage,87,5
14,169451.45,1331.44,559.19,772.25,168679.2,mortgage,87,5
15,168679.2,1331.44,556.64,774.8,167904.4,mortgage,87,5
16,167904.4,1331.44,554.08,777.36,167127.04,mortgage,87,5
17,167127.04,1578.53,551.52,1027.01,166100.03,mortgage,87,5
18,166100.03,3010.1,548.13,2461.97,163638.06,mortgage,87,5
19,163638.06,3010.1,540.01,2470.09,161167.97,mortgage,87,5
20,161167.97,3010.1,531.85,2478.25,158689.72,mortgage,87,5
21,158689.72,3010.1,523.68,2486.42,156203.3,mortgage,87,5
22,156203.3,3010.1,515.47,2494.63,153708.67,mortgage,87,5
23,153708.67,3010.1,507.24,2502.86,151205.81,mortgage,87,5
24,151205.81,3010.1,498.98,2511.12,148694.69,mortgage,87,5
25,148694.69,3010.1,490.69,2519.41,146175.28,mortgage,87,5
26,146175.28,3010.1,482.38,2527.72,143647.56,mortgage,87,5
27,143647.56,3010.1,474.04,2536.06,141111.5,mortgage,87,5
28,141111.5,3010.1,465.67,2544.43,138567.07,mortgage,87,5
29,138567.07,3010.1,457.27,2552.83,136014.24,mortgage,87,5
30,136014.24,3010.1,448.85,2561.25,133452.99,mortgage,87,5
31,133452.99,3010.1,440.39,2569.71,130883.28,mortgage,87,5
32,130883.28,3010.1,431.91,2578.19,128305.09,mortgage,87,5
33,128305.09,3010.1,423.41,2586.69,125718.4,mortgage,87,5
34,125718.4,3010.1,414.87,2595.23,123123.17,mortgage,87,5
35,123123.17,3010.1,406.31,2603.79,120519.38,mortgage,87,5
36,120519.38,3010.1,397.71,2612.39,117906.99,mortgage,87,5
37,117906.99,3010.1,389.09,2621.01,115285.98,mortgage,87,5
38,115285.98,3010.1,380.44,2629.66,112656.32,mortgage,87,5
39,112656.32,3010.1,371.77,2638.33,110017.99,mortgage,87,5
40,110017.99,3010.1,363.06,2647.04,107370.95,mortgage,87,5
41,107370.95,3010.1,354.32,2655.78,104715.17,mortgage,87,5
42,104715.17,3010.1,345.56,2664.54,102050.63,mortgage,87,5
43,102050.63,3010.1,336.77,2673.33,99377.3,mortgage,87,5
44,99377.3,3010.1,327.95,2682.15,96695.15,mortgage,87,5
45,96695.15,3010.1,319.09,2691.01,94004.14,mortgage,87,5
46,94004.14,3010.1,310.21,2699.89,91304.25,mortgage,87,5
47,91304.25,3010.1,301.3,2708.8,88595.45,mortgage,87,5
48,88595.45,3010.1,292.36,2717.74,85877.71,mortgage,87,5
49,85877.71,3010.1,283.4,2726.7,83151.01,mortgage,87,5
50,83151.01,3010.1,274.4,2735.7,80415.31,mortgage,87,5
51,80415.31,3010.1,265.37,2744.73,77670.58,mortgage,87,5
52,77670.58,3010.1,256.31,2753.79,74916.79,mortgage,87,5
53,74916.79,3010.1,247.23,2762.87,72153.92,mortgage,87,5
54,72153.92,3010.1,238.11,2771.99,69381.93,mortgage,87,5
55,69381.93,3010.1,228.96,2781.14,66600.79,mortgage,87,5
56,66600.79,3010.1,219.78,2790.32,63810.47,mortgage,87,5
57,63810.47,3010.1,210.57,2799.53,61010.94,mortgage,87,5
58,61010.94,3010.1,201.34,2808.76,58202.18,mortgage,87,5
59,58202.18,3010.1,192.07,2818.03,55384.15,mortgage,87,5
60,55384.15,3010.1,182.77,2827.33,52556.82,mortgage,87,5
61,52556.82,3010.1,173.44,2836.66,49720.16,mortgage,87,5
62,49720.16,3010.1,164.08,2846.02,46874.14,mortgage,87,5
63,46874.14,3010.1,154.68,2855.42,44018.72,mortgage,87,5
64,44018.72,3010.1,145.26,2864.84,41153.88,mortgage,87,5
65,41153.88,3010.1,135.81,2874.29,38279.59,mortgage,87,5
66,38279.59,3010.1,126.32,2883.78,35395.81,mortgage,87,5
67,35395.81,3010.1,116.81,2893.29,32502.52,mortgage,87,5
68,32502.52,3010.1,107.26,2902.84,29599.68,mortgage,87,5
69,29599.68,3010.1,97.68,2912.42,26687.26,mortgage,87,5
70,26687.26,3010.1,88.07,2922.03,23765.23,mortgage,87,5
71,23765.23,3010.1,78.43,2931.67,20833.56,mortgage,87,5
72,20833.56,3010.1,68.75,2941.35,17892.21,mortgage,87,5
73,17892.21,3010.1,59.04,2951.06,14941.15,mortgage,87,5
74,14941.15,3010.1,49.31,2960.79,11980.36,mortgage,87,5
75,11980.36,3010.1,39.54,2970.56,9009.8,mortgage,87,5
76,9009.8,3010.1,29.73,2980.37,6029.43,mortgage,87,5
77,6029.43,3010.1,19.9,2990.2,3039.23,mortgage,87,5
78,3039.23,3010.1,10.03,3000.07,39.16,mortgage,87,5
79,39.16,3010.1,0.13,3009.97,-2970.81,mortgage,87,5
0,20000.0,1191.04,108.0,1083.04,18916.96,WellsFargo2,88,1
1,18916.96,1191.04,102.15,1088.89,17828.07,WellsFargo2,88,1
2,17828.07,1191.04,96.27,1094.77,16733.3,WellsFargo2,88,1
3,16733.3,1191.04,90.36,1100.68,15632.62,WellsFargo2,88,1
4,15632.62,1191.04,84.42,1106.62,14526.0,WellsFargo2,88,1
5,14526.0,1191.04,78.44,1112.6,13413.4,WellsFargo2,88,1
6,13413.4,1191.04,72.43,1118.61,12294.79,WellsFargo2,88,1
7,12294.79,1191.04,66.39,1124.65,11170.14,WellsFargo2,88,1
8,11170.14,1191.04,60.32,1130.72,10039.42,WellsFargo2,88,1
9,10039.42,1191.04,54.21,1136.83,8902.59,WellsFargo2,88,1
10,8902.59,1191.04,48.07,1142.97,7759.62,WellsFargo2,88,1
11,7759.62,1191.04,41.9,1149.14,6610.48,WellsFargo2,88,1
12,6610.48,1191.04,35.7,1155.34,5455.14,WellsFargo2,88,1
13,5455.14,1191.04,29.46,1161.58,4293.56,WellsFargo2,88,1
14,4293.56,1191.04,23.19,1167.85,3125.71,WellsFargo2,88,1
15,3125.71,1191.04,16.88,1174.16,1951.55,WellsFargo2,88,1
16,1951.55,1191.04,10.54,1180.5,771.05,WellsFargo2,88,1
17,771.05,1191.04,4.16,1186.88,-415.83,WellsFargo2,88,1
0,8250.57,84.62,53.63,30.99,8219.58,WellsFargo1,88,2
1,8219.58,84.62,53.43,31.19,8188.39,WellsFargo1,88,2
2,8188.39,84.62,53.22,31.4,8156.99,WellsFargo1,88,2
3,8156.99,84.62,53.02,31.6,8125.39,WellsFargo1,88,2
4,8125.39,84.62,52.82,31.8,8093.59,WellsFargo1,88,2
5,8093.59,84.62,52.61,32.01,8061.58,WellsFargo1,88,2
6,8061.58,84.62,52.4,32.22,8029.36,WellsFargo1,88,2
7,8029.36,84.62,52.19,32.43,7996.93,WellsFargo1,88,2
8,7996.93,84.62,51.98,32.64,7964.29,WellsFargo1,88,2
9,7964.29,84.62,51.77,32.85,7931.44,WellsFargo1,88,2
10,7931.44,84.62,51.55,33.07,7898.37,WellsFargo1,88,2
11,7898.37,84.62,51.34,33.28,7865.09,WellsFargo1,88,2
12,7865.09,84.62,51.12,33.5,7831.59,WellsFargo1,88,2
13,7831.59,84.62,50.91,33.71,7797.88,WellsFargo1,88,2
14,7797.88,84.62,50.69,33.93,7763.95,WellsFargo1,88,2
15,7763.95,84.62,50.47,34.15,7729.8,WellsFargo1,88,2
16,7729.8,84.62,50.24,34.38,7695.42,WellsFargo1,88,2
17,7695.42,500.45,50.02,450.43,7244.99,WellsFargo1,88,2
18,7244.99,1275.66,47.09,1228.57,6016.42,WellsFargo1,88,2
19,6016.42,1275.66,39.11,1236.55,4779.87,WellsFargo1,88,2
20,4779.87,1275.66,31.07,1244.59,3535.28,WellsFargo1,88,2
21,3535.28,1275.66,22.98,1252.68,2282.6,WellsFargo1,88,2
22,2282.6,1275.66,14.84,1260.82,1021.78,WellsFargo1,88,2
23,1021.78,1275.66,6.64,1269.02,-247.24,WellsFargo1,88,2
0,5000.0,333.0,36.0,297.0,4703.0,Car,88,3
1,4703.0,333.0,33.86,299.14,4403.86,Car,88,3
2,4403.86,333.0,31.71,301.29,4102.57,Car,88,3
3,4102.57,333.0,29.54,303.46,3799.11,Car,88,3
4,3799.11,333.0,27.35,305.65,3493.46,Car,88,3
5,3493.46,333.0,25.15,307.85,3185.61,Car,88,3
6,3185.61,333.0,22.94,310.06,2875.55,Car,88,3
7,2875.55,333.0,20.7,312.3,2563.25,Car,88,3
8,2563.25,333.0,18.46,314.54,2248.71,Car,88,3
9,2248.71,333.0,16.19,316.81,1931.9,Car,88,3
10,1931.9,333.0,13.91,319.09,1612.81,Car,88,3
11,1612.81,333.0,11.61,321.39,1291.42,Car,88,3
12,1291.42,333.0,9.3,323.7,967.72,Car,88,3
13,967.72,333.0,6.97,326.03,641.69,Car,88,3
14,641.69,333.0,4.62,328.38,313.31,Car,88,3
15,313.31,333.0,2.26,330.74,-17.43,Car,88,3
0,180000.0,1331.44,594.0,737.44,179262.56,mortgage,88,4
1,179262.56,1331.44,591.57,739.87,178522.69,mortgage,88,4
2,178522.69,1331.44,589.12,742.32,177780.37,mortgage,88,4
3,177780.37,1331.44,586.68,744.76,177035.61,mortgage,88,4
4,177035.61,1331.44,584.22,747.22,176288.39,mortgage,88,4
5,176288.39,1331.44,581.75,749.69,175538.7,mortgage,88,4
6,175538.7,1331.44,579.28,752.16,174786.54,mortgage,88,4
7,174786.54,1331.44,576.8,754.64,174031.9,mortgage,88,4
8,174031.9,1331.44,574.31,757.13,173274.77,mortgage,88,4
9,173274.77,1331.44,571.81,759.63,172515.14,mortgage,88,4
10,172515.14,1331.44,569.3,762.14,171753.0,mortgage,88,4
11,171753.0,1331.44,566.78,764.66,170988.34,mortgage,88,4
12,170988.34,1331.44,564.26,767.18,170221.16,mortgage,88,4
13,170221.16,1331.44,561.73,769.71,169451.45,mortgage,88,4
14,169451.45,1331.44,559.19,772.25,168679.2,mortgage,88,4
15,168679.2,1348.87,556.64,792.23,167886.97,mortgage,88,4
16,167886.97,2940.1,554.03,2386.07,165500.9,mortgage,88,4
17,165500.9,2940.1,546.15,2393.95,163106.95,mortgage,88,4
18,163106.95,2940.1,538.25,2401.85,160705.1,mortgage,88,4
19,160705.1,2940.1,530.33,2409.77,158295.33,mortgage,88,4
20,158295.33,2940.1,522.37,2417.73,155877.6,mortgage,88,4
21,155877.6,2940.1,514.4,2425.7,153451.9,mortgage,88,4
22,153451.9,2940.1,506.39,2433.71,151018.19,mortgage,88,4
23,151018.19,2940.1,498.36,2441.74,148576.45,mortgage,88,4
24,148576.45,2940.1,490.3,2449.8,146126.65,mortgage,88,4
25,146126.65,2940.1,482.22,2457.88,143668.77,mortgage,88,4
26,143668.77,2940.1,474.11,2465.99,141202.78,mortgage,88,4
27,141202.78,2940.1,465.97,2474.13,138728.65,mortgage,88,4
28,138728.65,2940.1,457.8,2482.3,136246.35,mortgage,88,4
29,136246.35,2940.1,449.61,2490.49,133755.86,mortgage,88,4
30,133755.86,2940.1,441.39,2498.71,131257.15,mortgage,88,4
31,131257.15,2940.1,433.15,2506.95,128750.2,mortgage,88,4
32,128750.2,2940.1,424.88,2515.22,126234.98,mortgage,88,4
33,126234.98,2940.1,416.58,2523.52,123711.46,mortgage,88,4
34,123711.46,2940.1,408.25,2531.85,121179.61,mortgage,88,4
35,121179.61,2940.1,399.89,2540.21,118639.4,mortgage,88,4
36,118639.4,2940.1,391.51,2548.59,116090.81,mortgage,88,4
37,116090.81,2940.1,383.1,2557.0,113533.81,mortgage,88,4
38,113533.81,2940.1,374.66,2565.44,110968.37,mortgage,88,4
39,110968.37,2940.1,366.2,2573.9,108394.47,mortgage,88,4
40,108394.47,2940.1,357.7,2582.4,105812.07,mortgage,88,4
41,105812.07,2940.1,349.18,2590.92,103221.15,mortgage,88,4
42,103221.15,2940.1,340.63,2599.47,100621.68,mortgage,88,4
43,100621.68,2940.1,332.05,2608.05,98013.63,mortgage,88,4
44,98013.63,2940.1,323.44,2616.66,95396.97,mortgage,88,4
45,95396.97,2940.1,314.81,2625.29,92771.68,mortgage,88,4
46,92771.68,2940.1,306.15,2633.95,90137.73,mortgage,88,4
47,90137.73,2940.1,297.45,2642.65,87495.08,mortgage,88,4
48,87495.08,2940.1,288.73,2651.37,84843.71,mortgage,88,4
49,84843.71,2940.1,279.98,2660.12,82183.59,mortgage,88,4
50,82183.59,2940.1,271.21,2668.89,79514.7,mortgage,88,4
51,79514.7,2940.1,262.4,2677.7,76837.0,mortgage,88,4
52,76837.0,2940.1,253.56,2686.54,74150.46,mortgage,88,4
53,74150.46,2940.1,244.7,2695.4,71455.06,mortgage,88,4
54,71455.06,2940.1,235.8,2704.3,68750.76,mortgage,88,4
55,68750.76,2940.1,226.88,2713.22,66037.54,mortgage,88,4
56,66037.54,2940.1,217.92,2722.18,63315.36,mortgage,88,4
57,63315.36,2940.1,208.94,2731.16,60584.2,mortgage,88,4
58,60584.2,2940.1,199.93,2740.17,57844.03,mortgage,88,4
59,57844.03,2940.1,190.89,2749.21,55094.82,mortgage,88,4
60,55094.82,2940.1,181.81,2758.29,52336.53,mortgage,88,4
61,52336.53,2940.1,172.71,2767.39,49569.14,mortgage,88,4
62,49569.14,2940.1,163.58,2776.52,46792.62,mortgage,88,4
63,46792.62,2940.1,154.42,2785.68,44006.94,mortgage,88,4
64,44006.94,2940.1,145.22,2794.88,41212.06,mortgage,88,4
65,41212.06,2940.1,136.0,2804.1,38407.96,mortgage,88,4
66,38407.96,2940.1,126.75,2813.35,35594.61,mortgage,88,4
67,35594.61,2940.1,117.46,2822.64,32771.97,mortgage,88,4
68,32771.97,2940.1,108.15,2831.95,29940.02,mortgage,88,4
69,29940.02,2940.1,98.8,2841.3,27098.72,mortgage,88,4
70,27098.72,2940.1,89.43,2850.67,24248.05,mortgage,88,4
71,24248.05,2940.1,80.02,2860.08,21387.97,mortgage,88,4
72,21387.97,2940.1,70.58,2869.52,18518.45,mortgage,88,4
73,18518.45,2940.1,61.11,2878.99,15639.46,mortgage,88,4
74,15639.46,2940.1,51.61,2888.49,12750.97,mortgage,88,4
75,12750.97,2940.1,42.08,2898.02,9852.95,mortgage,88,4
76,9852.95,2940.1,32.51,2907.59,6945.36,mortgage,88,4
77,6945.36,2940.1,22.92,2917.18,4028.18,mortgage,88,4
78,4028.18,2940.1,13.29,2926.81,1101.37,mortgage,88,4
79,1101.37,2940.1,3.63,2936.47,-1835.1,mortgage,88,4
0,4000.0,70.0,16.0,54.0,3946.0,testing,88,5
1,3946.0,70.0,15.78,54.22,3891.78,testing,88,5
2,3891.78,70.0,15.57,54.43,3837.35,testing,88,5
3,3837.35,70.0,15.35,54.65,3782.7,testing,88,5
4,3782.7,70.0,15.13,54.87,3727.83,testing,88,5
5,3727.83,70.0,14.91,55.09,3672.74,testing,88,5
6,3672.74,70.0,14.69,55.31,3617.43,testing,88,5
7,3617.43,70.0,14.47,55.53,3561.9,testing,88,5
8,3561.9,70.0,14.25,55.75,3506.15,testing,88,5
9,3506.15,70.0,14.02,55.98,3450.17,testing,88,5
10,3450.17,70.0,13.8,56.2,3393.97,testing,88,5
11,3393.97,70.0,13.58,56.42,3337.55,testing,88,5
12,3337.55,70.0,13.35,56.65,3280.9,testing,88,5
13,3280.9,70.0,13.12,56.88,3224.02,testing,88,5
14,3224.02,70.0,12.9,57.1,3166.92,testing,88,5
15,3166.92,70.0,12.67,57.33,3109.59,testing,88,5
16,3109.59,70.0,12.44,57.56,3052.03,testing,88,5
17,3052.03,70.0,12.21,57.79,2994.24,testing,88,5
18,2994.24,70.0,11.98,58.02,2936.22,testing,88,5
19,2936.22,70.0,11.74,58.26,2877.96,testing,88,5
20,2877.96,70.0,11.51,58.49,2819.47,testing,88,5
21,2819.47,70.0,11.28,58.72,2760.75,testing,88,5
22,2760.75,70.0,11.04,58.96,2701.79,testing,88,5
23,2701.79,70.0,10.81,59.19,2642.6,testing,88,5
24,2642.6,70.0,10.57,59.43,2583.17,testing,88,5
25,2583.17,70.0,10.33,59.67,2523.5,testing,88,5
26,2523.5,70.0,10.09,59.91,2463.59,testing,88,5
27,2463.59,70.0,9.85,60.15,2403.44,testing,88,5
28,2403.44,70.0,9.61,60.39,2343.05,testing,88,5
29,2343.05,70.0,9.37,60.63,2282.42,testing,88,5
30,2282.42,70.0,9.13,60.87,2221.55,testing,88,5
31,2221.55,70.0,8.89,61.11,2160.44,testing,88,5
32,2160.44,70.0,8.64,61.36,2099.08,testing,88,5
33,2099.08,70.0,8.4,61.6,2037.48,testing,88,5
34,2037.48,70.0,8.15,61.85,1975.63,testing,88,5
35,1975.63,70.0,7.9,62.1,1913.53,testing,88,5
36,1913.53,70.0,7.65,62.35,1851.18,testing,88,5
37,1851.18,70.0,7.4,62.6,1788.58,testing,88,5
38,1788.58,70.0,7.15,62.85,1725.73,testing,88,5
39,1725.73,70.0,6.9,63.1,1662.63,testing,88,5
40,1662.63,70.0,6.65,63.35,1599.28,testing,88,5
41,1599.28,70.0,6.4,63.6,1535.68,testing,88,5
42,1535.68,70.0,6.14,63.86,1471.82,testing,88,5
43,1471.82,70.0,5.89,64.11,1407.71,testing,88,5
44,1407.71,70.0,5.63,64.37,1343.34,testing,88,5
45,1343.34,70.0,5.37,64.63,1278.71,testing,88,5
46,1278.71,70.0,5.11,64.89,1213.82,testing,88,5
47,1213.82,70.0,4.86,65.14,1148.68,testing,88,5
48,1148.68,70.0,4.59,65.41,1083.27,testing,88,5
49,1083.27,70.0,4.33,65.67,1017.6,testing,88,5
50,1017.6,70.0,4.07,65.93,951.67,testing,88,5
51,951.67,70.0,3.81,66.19,885.48,testing,88,5
52,885.48,70.0,3.54,66.46,819.02,testing,88,5
53,819.02,70.0,3.28,66.72,752.3,testing,88,5
54,752.3,70.0,3.01,66.99,685.31,testing,88,5
55,685.31,70.0,2.74,67.26,618.05,testing,88,5
56,618.05,70.0,2.47,67.53,550.52,testing,88,5
57,550.52,70.0,2.2,67.8,482.72,testing,88,5
58,482.72,70.0,1.93,68.07,414.65,testing,88,5
59,414.65,70.0,1.66,68.34,346.31,testing,88,5
60,346.31,70.0,1.39,68.61,277.7,testing,88,5
61,277.7,70.0,1.11,68.89,208.81,testing,88,5
62,208.81,70.0,0.84,69.16,139.65,testing,88,5
63,139.65,70.0,0.56,69.44,70.21,testing,88,5
64,70.21,70.0,0.28,69.72,0.49,testing,88,5
65,0.49,70.0,0.0,70.0,-69.51,testing,88,5
0,20000.0,1191.04,108.0,1083.04,18916.96,WellsFargo2,89,1
1,18916.96,1191.04,102.15,1088.89,17828.07,WellsFargo2,89,1
2,17828.07,1191.04,96.27,1094.77,16733.3,WellsFargo2,89,1
3,16733.3,1191.04,90.36,1100.68,15632.62,WellsFargo2,89,1
4,15632.62,1191.04,84.42,1106.62,14526.0,WellsFargo2,89,1
5,14526.0,1191.04,78.44,1112.6,13413.4,WellsFargo2,89,1
6,13413.4,1191.04,72.43,1118.61,12294.79,WellsFargo2,89,1
7,12294.79,1191.04,66.39,1124.65,11170.14,WellsFargo2,89,1
8,11170.14,1191.04,60.32,1130.72,10039.42,WellsFargo2,89,1
9,10039.42,1191.04,54.21,1136.83,8902.59,WellsFargo2,89,1
10,8902.59,1191.04,48.07,1142.97,7759.62,WellsFargo2,89,1
11,7759.62,1191.04,41.9,1149.14,6610.48,WellsFargo2,89,1
12,6610.48,1191.04,35.7,1155.34,5455.14,WellsFargo2,89,1
13,5455.14,1191.04,29.46,1161.58,4293.56,WellsFargo2,89,1
14,4293.56,1191.04,23.19,1167.85,3125.71,WellsFargo2,89,1
15,3125.71,1191.04,16.88,1174.16,1951.55,WellsFargo2,89,1
16,1951.55,1191.04,10.54,1180.5,771.05,WellsFargo2,89,1
17,771.05,1191.04,4.16,1186.88,-415.83,WellsFargo2,89,1
0,8250.57,84.62,53.63,30.99,8219.58,WellsFargo1,89,2
1,8219.58,84.62,53.43,31.19,8188.39,WellsFargo1,89,2
2,8188.39,84.62,53.22,31.4,8156.99,WellsFargo1,89,2
3,8156.99,84.62,53.02,31.6,8125.39,WellsFargo1,89,2
4,8125.39,84.62,52.82,31.8,8093.59,WellsFargo1,89,2
5,8093.59,84.62,52.61,32.01,8061.58,WellsFargo1,89,2
6,8061.58,84.62,52.4,32.22,8029.36,WellsFargo1,89,2
7,8029.36,84.62,52.19,32.43,7996.93,WellsFargo1,89,2
8,7996.93,84.62,51.98,32.64,7964.29,WellsFargo1,89,2
9,7964.29,84.62,51.77,32.85,7931.44,WellsFargo1,89,2
10,7931.44,84.62,51.55,33.07,7898.37,WellsFargo1,89,2
11,7898.37,84.62,51.34,33.28,7865.09,WellsFargo1,89,2
12,7865.09,84.62,51.12,33.5,7831.59,WellsFargo1,89,2
13,7831.59,84.62,50.91,33.71,7797.88,WellsFargo1,89,2
14,7797.88,84.62,50.69,33.93,7763.95,WellsFargo1,89,2
15,7763.95,84.62,50.47,34.15,7729.8,WellsFargo1,89,2
16,7729.8,84.62,50.24,34.38,7695.42,WellsFargo1,89,2
17,7695.42,500.45,50.02,450.43,7244.99,WellsFargo1,89,2
18,7244.99,1275.66,47.09,1228.57,6016.42,WellsFargo1,89,2
19,6016.42,1275.66,39.11,1236.55,4779.87,WellsFargo1,89,2
20,4779.87,1275.66,31.07,1244.59,3535.28,WellsFargo1,89,2
21,3535.28,1275.66,22.98,1252.68,2282.6,WellsFargo1,89,2
22,2282.6,1275.66,14.84,1260.82,1021.78,WellsFargo1,89,2
23,1021.78,1275.66,6.64,1269.02,-247.24,WellsFargo1,89,2
0,180000.0,1331.44,594.0,737.44,179262.56,mortgage,89,3
1,179262.56,1331.44,591.57,739.87,178522.69,mortgage,89,3
2,178522.69,1331.44,589.12,742.32,177780.37,mortgage,89,3
3,177780.37,1331.44,586.68,744.76,177035.61,mortgage,89,3
4,177035.61,1331.44,584.22,747.22,176288.39,mortgage,89,3
5,176288.39,1331.44,581.75,749.69,175538.7,mortgage,89,3
6,175538.7,1331.44,579.28,752.16,174786.54,mortgage,89,3
7,174786.54,1331.44,576.8,754.64,174031.9,mortgage,89,3
8,174031.9,1331.44,574.31,757.13,173274.77,mortgage,89,3
9,173274.77,1331.44,571.81,759.63,172515.14,mortgage,89,3
10,172515.14,1331.44,569.3,762.14,171753.0,mortgage,89,3
11,171753.0,1331.44,566.78,764.66,170988.34,mortgage,89,3
12,170988.34,1331.44,564.26,767.18,170221.16,mortgage,89,3
13,170221.16,1331.44,561.73,769.71,169451.45,mortgage,89,3
14,169451.45,1331.44,559.19,772.25,168679.2,mortgage,89,3
15,168679.2,1331.44,556.64,774.8,167904.4,mortgage,89,3
16,167904.4,1331.44,554.08,777.36,167127.04,mortgage,89,3
17,167127.04,1331.44,551.52,779.92,166347.12,mortgage,89,3
18,166347.12,1331.44,548.95,782.49,165564.63,mortgage,89,3
19,165564.63,1331.44,546.36,785.08,164779.55,mortgage,89,3
20,164779.55,1331.44,543.77,787.67,163991.88,mortgage,89,3
21,163991.88,1331.44,541.17,790.27,163201.61,mortgage,89,3
22,163201.61,1331.44,538.57,792.87,162408.74,mortgage,89,3
23,162408.74,1578.68,535.95,1042.73,161366.01,mortgage,89,3
24,161366.01,2607.1,532.51,2074.59,159291.42,mortgage,89,3
25,159291.42,2607.1,525.66,2081.44,157209.98,mortgage,89,3
26,157209.98,2607.1,518.79,2088.31,155121.67,mortgage,89,3
27,155121.67,2607.1,511.9,2095.2,153026.47,mortgage,89,3
28,153026.47,2607.1,504.99,2102.11,150924.36,mortgage,89,3
29,150924.36,2607.1,498.05,2109.05,148815.31,mortgage,89,3
30,148815.31,2607.1,491.09,2116.01,146699.3,mortgage,89,3
31,146699.3,2607.1,484.11,2122.99,144576.31,mortgage,89,3
32,144576.31,2607.1,477.1,2130.0,142446.31,mortgage,89,3
33,142446.31,2607.1,470.07,2137.03,140309.28,mortgage,89,3
34,140309.28,2607.1,463.02,2144.08,138165.2,mortgage,89,3
35,138165.2,2607.1,455.95,2151.15,136014.05,mortgage,89,3
36,136014.05,2607.1,448.85,2158.25,133855.8,mortgage,89,3
37,133855.8,2607.1,441.72,2165.38,131690.42,mortgage,89,3
38,131690.42,2607.1,434.58,2172.52,129517.9,mortgage,89,3
39,129517.9,2607.1,427.41,2179.69,127338.21,mortgage,89,3
40,127338.21,2607.1,420.22,2186.88,125151.33,mortgage,89,3
41,125151.33,2607.1,413.0,2194.1,122957.23,mortgage,89,3
42,122957.23,2607.1,405.76,2201.34,120755.89,mortgage,89,3
43,120755.89,2607.1,398.49,2208.61,118547.28,mortgage,89,3
44,118547.28,2607.1,391.21,2215.89,116331.39,mortgage,89,3
45,116331.39,2607.1,383.89,2223.21,114108.18,mortgage,89,3
46,114108.18,2607.1,376.56,2230.54,111877.64,mortgage,89,3
47,111877.64,2607.1,369.2,2237.9,109639.74,mortgage,89,3
48,109639.74,2607.1,361.81,2245.29,107394.45,mortgage,89,3
49,107394.45,2607.1,354.4,2252.7,105141.75,mortgage,89,3
50,105141.75,2607.1,346.97,2260.13,102881.62,mortgage,89,3
51,102881.62,2607.1,339.51,2267.59,100614.03,mortgage,89,3
52,100614.03,2607.1,332.03,2275.07,98338.96,mortgage,89,3
53,98338.96,2607.1,324.52,2282.58,96056.38,mortgage,89,3
54,96056.38,2607.1,316.99,2290.11,93766.27,mortgage,89,3
55,93766.27,2607.1,309.43,2297.67,91468.6,mortgage,89,3
56,91468.6,2607.1,301.85,2305.25,89163.35,mortgage,89,3
57,89163.35,2607.1,294.24,2312.86,86850.49,mortgage,89,3
58,86850.49,2607.1,286.61,2320.49,84530.0,mortgage,89,3
59,84530.0,2607.1,278.95,2328.15,82201.85,mortgage,89,3
60,82201.85,2607.1,271.27,2335.83,79866.02,mortgage,89,3
61,79866.02,2607.1,263.56,2343.54,77522.48,mortgage,89,3
62,77522.48,2607.1,255.82,2351.28,75171.2,mortgage,89,3
63,75171.2,2607.1,248.06,2359.04,72812.16,mortgage,89,3
64,72812.16,2607.1,240.28,2366.82,70445.34,mortgage,89,3
65,70445.34,2607.1,232.47,2374.63,68070.71,mortgage,89,3
66,68070.71,2607.1,224.63,2382.47,65688.24,mortgage,89,3
67,65688.24,2607.1,216.77,2390.33,63297.91,mortgage,89,3
68,63297.91,2607.1,208.88,2398.22,60899.69,mortgage,89,3
69,60899.69,2607.1,200.97,2406.13,58493.56,mortgage,89,3
70,58493.56,2607.1,193.03,2414.07,56079.49,mortgage,89,3
71,56079.49,2607.1,185.06,2422.04,53657.45,mortgage,89,3
72,53657.45,2607.1,177.07,2430.03,51227.42,mortgage,89,3
73,51227.42,2607.1,169.05,2438.05,48789.37,mortgage,89,3
74,48789.37,2607.1,161.0,2446.1,46343.27,mortgage,89,3
75,46343.27,2607.1,152.93,2454.17,43889.1,mortgage,89,3
76,43889.1,2607.1,144.83,2462.27,41426.83,mortgage,89,3
77,41426.83,2607.1,136.71,2470.39,38956.44,mortgage,89,3
78,38956.44,2607.1,128.56,2478.54,36477.9,mortgage,89,3
79,36477.9,2607.1,120.38,2486.72,33991.18,mortgage,89,3
80,33991.18,2607.1,112.17,2494.93,31496.25,mortgage,89,3
81,31496.25,2607.1,103.94,2503.16,28993.09,mortgage,89,3
82,28993.09,2607.1,95.68,2511.42,26481.67,mortgage,89,3
83,26481.67,2607.1,87.39,2519.71,23961.96,mortgage,89,3
84,23961.96,2607.1,79.07,2528.03,21433.93,mortgage,89,3
85,21433.93,2607.1,70.73,2536.37,18897.56,mortgage,89,3
86,18897.56,2607.1,62.36,2544.74,16352.82,mortgage,89,3
87,16352.82,2607.1,53.96,2553.14,13799.68,mortgage,89,3
88,13799.68,2607.1,45.54,2561.56,11238.12,mortgage,89,3
89,11238.12,2607.1,37.09,2570.01,8668.11,mortgage,89,3
90,8668.11,2607.1,28.6,2578.5,6089.61,mortgage,89,3
91,6089.61,2607.1,20.1,2587.0,3502.61,mortgage,89,3
92,3502.61,2607.1,11.56,2595.54,907.07,mortgage,89,3
93,907.07,2607.1,2.99,2604.11,-1697.04,mortgage,89,3
0,4000.0,70.0,16.0,54.0,3946.0,testing,89,4
1,3946.0,70.0,15.78,54.22,3891.78,testing,89,4
2,3891.78,70.0,15.57,54.43,3837.35,testing,89,4
3,3837.35,70.0,15.35,54.65,3782.7,testing,89,4
4,3782.7,70.0,15.13,54.87,3727.83,testing,89,4
5,3727.83,70.0,14.91,55.09,3672.74,testing,89,4
6,3672.74,70.0,14.69,55.31,3617.43,testing,89,4
7,3617.43,70.0,14.47,55.53,3561.9,testing,89,4
8,3561.9,70.0,14.25,55.75,3506.15,testing,89,4
9,3506.15,70.0,14.02,55.98,3450.17,testing,89,4
10,3450.17,70.0,13.8,56.2,3393.97,testing,89,4
11,3393.97,70.0,13.58,56.42,3337.55,testing,89,4
12,3337.55,70.0,13.35,56.65,3280.9,testing,89,4
13,3280.9,70.0,13.12,56.88,3224.02,testing,89,4
14,3224.02,70.0,12.9,57.1,3166.92,testing,89,4
15,3166.92,70.0,12.67,57.33,3109.59,testing,89,4
16,3109.59,70.0,12.44,57.56,3052.03,testing,89,4
17,3052.03,70.0,12.21,57.79,2994.24,testing,89,4
18,2994.24,70.0,11.98,58.02,2936.22,testing,89,4
19,2936.22,70.0,11.74,58.26,2877.96,testing,89,4
20,2877.96,70.0,11.51,58.49,2819.47,testing,89,4
21,2819.47,70.0,11.28,58.72,2760.75,testing,89,4
22,2760.75,70.0,11.04,58.96,2701.79,testing,89,4
23,2701.79,70.0,10.81,59.19,2642.6,testing,89,4
24,2642.6,70.0,10.57,59.43,2583.17,testing,89,4
25,2583.17,70.0,10.33,59.67,2523.5,testing,89,4
26,2523.5,70.0,10.09,59.91,2463.59,testing,89,4
27,2463.59,70.0,9.85,60.15,2403.44,testing,89,4
28,2403.44,70.0,9.61,60.39,2343.05,testing,89,4
29,2343.05,70.0,9.37,60.63,2282.42,testing,89,4
30,2282.42,70.0,9.13,60.87,2221.55,testing,89,4
31,2221.55,70.0,8.89,61.11,2160.44,testing,89,4
32,2160.44,70.0,8.64,61.36,2099.08,testing,89,4
33,2099.08,70.0,8.4,61.6,2037.48,testing,89,4
34,2037.48,70.0,8.15,61.85,1975.63,testing,89,4
35,1975.63,70.0,7.9,62.1,1913.53,testing,89,4
36,1913.53,70.0,7.65,62.35,1851.18,testing,89,4
37,1851.18,70.0,7.4,62.6,1788.58,testing,89,4
38,1788.58,70.0,7.15,62.85,1725.73,testing,89,4
39,1725.73,70.0,6.9,63.1,1662.63,testing,89,4
40,1662.63,70.0,6.65,63.35,1599.28,testing,89,4
41,1599.28,70.0,6.4,63.6,1535.68,testing,89,4
42,1535.68,70.0,6.14,63.86,1471.82,testing,89,4
43,1471.82,70.0,5.89,64.11,1407.71,testing,89,4
44,1407.71,70.0,5.63,64.37,1343.34,testing,89,4
45,1343.34,70.0,5.37,64.63,1278.71,testing,89,4
46,1278.71,70.0,5.11,64.89,1213.82,testing,89,4
47,1213.82,70.0,4.86,65.14,1148.68,testing,89,4
48,1148.68,70.0,4.59,65.41,1083.27,testing,89,4
49,1083.27,70.0,4.33,65.67,1017.6,testing,89,4
50,1017.6,70.0,4.07,65.93,951.67,testing,89,4
51,951.67,70.0,3.81,66.19,885.48,testing,89,4
52,885.48,70.0,3.54,66.46,819.02,testing,89,4
53,819.02,70.0,3.28,66.72,752.3,testing,89,4
54,752.3,70.0,3.01,66.99,685.31,testing,89,4
55,685.31,70.0,2.74,67.26,618.05,testing,89,4
56,618.05,70.0,2.47,67.53,550.52,testing,89,4
57,550.52,70.0,2.2,67.8,482.72,testing,89,4
58,482.72,70.0,1.93,68.07,414.65,testing,89,4
59,414.65,70.0,1.66,68.34,346.31,testing,89,4
60,346.31,70.0,1.39,68.61,277.7,testing,89,4
61,277.7,70.0,1.11,68.89,208.81,testing,89,4
62,208.81,70.0,0.84,69.16,139.65,testing,89,4
63,139.65,70.0,0.56,69.44,70.21,testing,89,4
64,70.21,70.0,0.28,69.72,0.49,testing,89,4
65,0.49,70.0,0.0,70.0,-69.51,testing,89,4
0,5000.0,333.0,36.0,297.0,4703.0,Car,89,5
1,4703.0,333.0,33.86,299.14,4403.86,Car,89,5
2,4403.86,333.0,31.71,301.29,4102.57,Car,89,5
3,4102.57,333.0,29.54,303.46,3799.11,Car,89,5
4,3799.11,333.0,27.35,305.65,3493.46,Car,89,5
5,3493.46,333.0,25.15,307.85,3185.61,Car,89,5
6,3185.61,333.0,22.94,310.06,2875.55,Car,89,5
7,2875.55,333.0,20.7,312.3,2563.25,Car,89,5
8,2563.25,333.0,18.46,314.54,2248.71,Car,89,5
9,2248.71,333.0,16.19,316.81,1931.9,Car,89,5
10,1931.9,333.0,13.91,319.09,1612.81,Car,89,5
11,1612.81,333.0,11.61,321.39,1291.42,Car,89,5
12,1291.42,333.0,9.3,323.7,967.72,Car,89,5
13,967.72,333.0,6.97,326.03,641.69,Car,89,5
14,641.69,333.0,4.62,328.38,313.31,Car,89,5
15,313.31,333.0,2.26,330.74,-17.43,Car,89,5
0,20000.0,1191.04,108.0,1083.04,18916.96,WellsFargo2,90,1
1,18916.96,1191.04,102.15,1088.89,17828.07,WellsFargo2,90,1
2,17828.07,1191.04,96.27,1094.77,16733.3,WellsFargo2,90,1
3,16733.3,1191.04,90.36,1100.68,15632.62,WellsFargo2,90,1
4,15632.62,1191.04,84.42,1106.62,14526.0,WellsFargo2,90,1
5,14526.0,1191.04,78.44,1112.6,13413.4,WellsFargo2,90,1
6,13413.4,1191.04,72.43,1118.61,12294.79,WellsFargo2,90,1
7,12294.79,1191.04,66.39,1124.65,11170.14,WellsFargo2,90,1
8,11170.14,1191.04,60.32,1130.72,10039.42,WellsFargo2,90,1
9,10039.42,1191.04,54.21,1136.83,8902.59,WellsFargo2,90,1
10,8902.59,1191.04,48.07,1142.97,7759.62,WellsFargo2,90,1
11,7759.62,1191.04,41.9,1149.14,6610.48,WellsFargo2,90,1
12,6610.48,1191.04,35.7,1155.34,5455.14,WellsFargo2,90,1
13,5455.14,1191.04,29.46,1161.58,4293.56,WellsFargo2,90,1
14,4293.56,1191.04,23.19,1167.85,3125.71,WellsFargo2,90,1
15,3125.71,1191.04,16.88,1174.16,1951.55,WellsFargo2,90,1
16,1951.55,1191.04,10.54,1180.5,771.05,WellsFargo2,90,1
17,771.05,1191.04,4.16,1186.88,-415.83,WellsFargo2,90,1
0,8250.57,84.62,53.63,30.99,8219.58,WellsFargo1,90,2
1,8219.58,84.62,53.43,31.19,8188.39,WellsFargo1,90,2
2,8188.39,84.62,53.22,31.4,8156.99,WellsFargo1,90,2
3,8156.99,84.62,53.02,31.6,8125.39,WellsFargo1,90,2
4,8125.39,84.62,52.82,31.8,8093.59,WellsFargo1,90,2
5,8093.59,84.62,52.61,32.01,8061.58,WellsFargo1,90,2
6,8061.58,84.62,52.4,32.22,8029.36,WellsFargo1,90,2
7,8029.36,84.62,52.19,32.43,7996.93,WellsFargo1,90,2
8,7996.93,84.62,51.98,32.64,7964.29,WellsFargo1,90,2
9,7964.29,84.62,51.77,32.85,7931.44,WellsFargo1,90,2
10,7931.44,84.62,51.55,33.07,7898.37,WellsFargo1,90,2
11,7898.37,84.62,51.34,33.28,7865.09,WellsFargo1,90,2
12,7865.09,84.62,51.12,33.5,7831.59,WellsFargo1,90,2
13,7831.59,84.62,50.91,33.71,7797.88,WellsFargo1,90,2
14,7797.88,84.62,50.69,33.93,7763.95,WellsFargo1,90,2
15,7763.95,84.62,50.47,34.15,7729.8,WellsFargo1,90,2
16,7729.8,84.62,50.24,34.38,7695.42,WellsFargo1,90,2
17,7695.42,500.45,50.02,450.43,7244.99,WellsFargo1,90,2
18,7244.99,1275.66,47.09,1228.57,6016.42,WellsFargo1,90,2
19,6016.42,1275.66,39.11,1236.55,4779.87,WellsFargo1,90,2
20,4779.87,1275.66,31.07,1244.59,3535.28,WellsFargo1,90,2
21,3535.28,1275.66,22.98,1252.68,2282.6,WellsFargo1,90,2
22,2282.6,1275.66,14.84,1260.82,1021.78,WellsFargo1,90,2
23,1021.78,1275.66,6.64,1269.02,-247.24,WellsFargo1,90,2
0,180000.0,1331.44,594.0,737.44,179262.56,mortgage,90,3
1,179262.56,1331.44,591.57,739.87,178522.69,mortgage,90,3
2,178522.69,1331.44,589.12,742.32,177780.37,mortgage,90,3
3,177780.37,1331.44,586.68,744.76,177035.61,mortgage,90,3
4,177035.61,1331.44,584.22,747.22,176288.39,mortgage,90,3
5,176288.39,1331.44,581.75,749.69,175538.7,mortgage,90,3
6,175538.7,1331.44,579.28,752.16,174786.54,mortgage,90,3
7,174786.54,1331.44,576.8,754.64,174031.9,mortgage,90,3
8,174031.9,1331.44,574.31,757.13,173274.77,mortgage,90,3
9,173274.77,1331.44,571.81,759.63,172515.14,mortgage,90,3
10,172515.14,1331.44,569.3,762.14,171753.0,mortgage,90,3
11,171753.0,1331.44,566.78,764.66,170988.34,mortgage,90,3
12,170988.34,1331.44,564.26,767.18,170221.16,mortgage,90,3
13,170221.16,1331.44,561.73,769.71,169451.45,mortgage,90,3
14,169451.45,1331.44,559.19,772.25,168679.2,mortgage,90,3
15,168679.2,1331.44,556.64,774.8,167904.4,mortgage,90,3
16,167904.4,1331.44,554.08,777.36,167127.04,mortgage,90,3
17,167127.04,1331.44,551.52,779.92,166347.12,mortgage,90,3
18,166347.12,1331.44,548.95,782.49,165564.63,mortgage,90,3
19,165564.63,1331.44,546.36,785.08,164779.55,mortgage,90,3
20,164779.55,1331.44,543.77,787.67,163991.88,mortgage,90,3
21,163991.88,1331.44,541.17,790.27,163201.61,mortgage,90,3
22,163201.61,1331.44,538.57,792.87,162408.74,mortgage,90,3
23,162408.74,1578.68,535.95,1042.73,161366.01,mortgage,90,3
24,161366.01,2607.1,532.51,2074.59,159291.42,mortgage,90,3
25,159291.42,2607.1,525.66,2081.44,157209.98,mortgage,90,3
26,157209.98,2607.1,518.79,2088.31,155121.67,mortgage,90,3
27,155121.67,2607.1,511.9,2095.2,153026.47,mortgage,90,3
28,153026.47,2607.1,504.99,2102.11,150924.36,mortgage,90,3
29,150924.36,2607.1,498.05,2109.05,148815.31,mortgage,90,3
30,148815.31,2607.1,491.09,2116.01,146699.3,mortgage,90,3
31,146699.3,2607.1,484.11,2122.99,144576.31,mortgage,90,3
32,144576.31,2607.1,477.1,2130.0,142446.31,mortgage,90,3
33,142446.31,2607.1,470.07,2137.03,140309.28,mortgage,90,3
34,140309.28,2607.1,463.02,2144.08,138165.2,mortgage,90,3
35,138165.2,2607.1,455.95,2151.15,136014.05,mortgage,90,3
36,136014.05,2607.1,448.85,2158.25,133855.8,mortgage,90,3
37,133855.8,2607.1,441.72,2165.38,131690.42,mortgage,90,3
38,131690.42,2607.1,434.58,2172.52,129517.9,mortgage,90,3
39,129517.9,2607.1,427.41,2179.69,127338.21,mortgage,90,3
40,127338.21,2607.1,420.22,2186.88,125151.33,mortgage,90,3
41,125151.33,2607.1,413.0,2194.1,122957.23,mortgage,90,3
42,122957.23,2607.1,405.76,2201.34,120755.89,mortgage,90,3
43,120755.89,2607.1,398.49,2208.61,118547.28,mortgage,90,3
44,118547.28,2607.1,391.21,2215.89,116331.39,mortgage,90,3
45,116331.39,2607.1,383.89,2223.21,114108.18,mortgage,90,3
46,114108.18,2607.1,376.56,2230.54,111877.64,mortgage,90,3
47,111877.64,2607.1,369.2,2237.9,109639.74,mortgage,90,3
48,109639.74,2607.1,361.81,2245.29,107394.45,mortgage,90,3
49,107394.45,2607.1,354.4,2252.7,105141.75,mortgage,90,3
50,105141.75,2607.1,346.97,2260.13,102881.62,mortgage,90,3
51,102881.62,2607.1,339.51,2267.59,100614.03,mortgage,90,3
52,100614.03,2607.1,332.03,2275.07,98338.96,mortgage,90,3
53,98338.96,2607.1,324.52,2282.58,96056.38,mortgage,90,3
54,96056.38,2607.1,316.99,2290.11,93766.27,mortgage,90,3
55,93766.27,2607.1,309.43,2297.67,91468.6,mortgage,90,3
56,91468.6,2607.1,301.85,2305.25,89163.35,mortgage,90,3
57,89163.35,2607.1,294.24,2312.86,86850.49,mortgage,90,3
58,86850.49,2607.1,286.61,2320.49,84530.0,mortgage,90,3
59,84530.0,2607.1,278.95,2328.15,82201.85,mortgage,90,3
60,82201.85,2607.1,271.27,2335.83,79866.02,mortgage,90,3
61,79866.02,2607.1,263.56,2343.54,77522.48,mortgage,90,3
62,77522.48,2607.1,255.82,2351.28,75171.2,mortgage,90,3
63,75171.2,2607.1,248.06,2359.04,72812.16,mortgage,90,3
64,72812.16,2607.1,240.28,2366.82,70445.34,mortgage,90,3
65,70445.34,2607.1,232.47,2374.63,68070.71,mortgage,90,3
66,68070.71,2607.1,224.63,2382.47,65688.24,mortgage,90,3
67,65688.24,2607.1,216.77,2390.33,63297.91,mortgage,90,3
68,63297.91,2607.1,208.88,2398.22,60899.69,mortgage,90,3
69,60899.69,2607.1,200.97,2406.13,58493.56,mortgage,90,3
70,58493.56,2607.1,193.03,2414.07,56079.49,mortgage,90,3
71,56079.49,2607.1,185.06,2422.04,53657.45,mortgage,90,3
72,53657.45,2607.1,177.07,2430.03,51227.42,mortgage,90,3
73,51227.42,2607.1,169.05,2438.05,48789.37,mortgage,90,3
74,48789.37,2607.1,161.0,2446.1,46343.27,mortgage,90,3
75,46343.27,2607.1,152.93,2454.17,43889.1,mortgage,90,3
76,43889.1,2607.1,144.83,2462.27,41426.83,mortgage,90,3
77,41426.83,2607.1,136.71,2470.39,38956.44,mortgage,90,3
78,38956.44,2607.1,128.56,2478.54,36477.9,mortgage,90,3
79,36477.9,2607.1,120.38,2486.72,33991.18,mortgage,90,3
80,33991.18,2607.1,112.17,2494.93,31496.25,mortgage,90,3
81,31496.25,2607.1,103.94,2503.16,28993.09,mortgage,90,3
82,28993.09,2607.1,95.68,2511.42,26481.67,mortgage,90,3
83,26481.67,2607.1,87.39,2519.71,23961.96,mortgage,90,3
84,23961.96,2607.1,79.07,2528.03,21433.93,mortgage,90,3
85,21433.93,2607.1,70.73,2536.37,18897.56,mortgage,90,3
86,18897.56,2607.1,62.36,2544.74,16352.82,mortgage,90,3
87,16352.82,2607.1,53.96,2553.14,13799.68,mortgage,90,3
88,13799.68,2607.1,45.54,2561.56,11238.12,mortgage,90,3
89,11238.12,2607.1,37.09,2570.01,8668.11,mortgage,90,3
90,8668.11,2607.1,28.6,2578.5,6089.61,mortgage,90,3
91,6089.61,2607.1,20.1,2587.0,3502.61,mortgage,90,3
92,3502.61,2607.1,11.56,2595.54,907.07,mortgage,90,3
93,907.07,2607.1,2.99,2604.11,-1697.04,mortgage,90,3
0,5000.0,333.0,36.0,297.0,4703.0,Car,90,4
1,4703.0,333.0,33.86,299.14,4403.86,Car,90,4
2,4403.86,333.0,31.71,301.29,4102.57,Car,90,4
3,4102.57,333.0,29.54,303.46,3799.11,Car,90,4
4,3799.11,333.0,27.35,305.65,3493.46,Car,90,4
5,3493.46,333.0,25.15,307.85,3185.61,Car,90,4
6,3185.61,333.0,22.94,310.06,2875.55,Car,90,4
7,2875.55,333.0,20.7,312.3,2563.25,Car,90,4
8,2563.25,333.0,18.46,314.54,2248.71,Car,90,4
9,2248.71,333.0,16.19,316.81,1931.9,Car,90,4
10,1931.9,333.0,13.91,319.09,1612.81,Car,90,4
11,1612.81,333.0,11.61,321.39,1291.42,Car,90,4
12,1291.42,333.0,9.3,323.7,967.72,Car,90,4
13,967.72,333.0,6.97,326.03,641.69,Car,90,4
14,641.69,333.0,4.62,328.38,313.31,Car,90,4
15,313.31,333.0,2.26,330.74,-17.43,Car,90,4
0,4000.0,70.0,16.0,54.0,3946.0,testing,90,5
1,3946.0,70.0,15.78,54.22,3891.78,testing,90,5
2,3891.78,70.0,15.57,54.43,3837.35,testing,90,5
3,3837.35,70.0,15.35,54.65,3782.7,testing,90,5
4,3782.7,70.0,15.13,54.87,3727.83,testing,90,5
5,3727.83,70.0,14.91,55.09,3672.74,testing,90,5
6,3672.74,70.0,14.69,55.31,3617.43,testing,90,5
7,3617.43,70.0,14.47,55.53,3561.9,testing,90,5
8,3561.9,70.0,14.25,55.75,3506.15,testing,90,5
9,3506.15,70.0,14.02,55.98,3450.17,testing,90,5
10,3450.17,70.0,13.8,56.2,3393.97,testing,90,5
11,3393.97,70.0,13.58,56.42,3337.55,testing,90,5
12,3337.55,70.0,13.35,56.65,3280.9,testing,90,5
13,3280.9,70.0,13.12,56.88,3224.02,testing,90,5
14,3224.02,70.0,12.9,57.1,3166.92,testing,90,5
15,3166.92,87.43,12.67,74.76,3092.16,testing,90,5
16,3092.16,3010.1,12.37,2997.73,94.43,testing,90,5
17,94.43,3010.1,0.38,3009.72,-2915.29,testing,90,5
0,20000.0,1191.04,108.0,1083.04,18916.96,WellsFargo2,91,1
1,18916.96,1191.04,102.15,1088.89,17828.07,WellsFargo2,91,1
2,17828.07,1191.04,96.27,1094.77,16733.3,WellsFargo2,91,1
3,16733.3,1191.04,90.36,1100.68,15632.62,WellsFargo2,91,1
4,15632.62,1191.04,84.42,1106.62,14526.0,WellsFargo2,91,1
5,14526.0,1191.04,78.44,1112.6,13413.4,WellsFargo2,91,1
6,13413.4,1191.04,72.43,1118.61,12294.79,WellsFargo2,91,1
7,12294.79,1191.04,66.39,1124.65,11170.14,WellsFargo2,91,1
8,11170.14,1191.04,60.32,1130.72,10039.42,WellsFargo2,91,1
9,10039.42,1191.04,54.21,1136.83,8902.59,WellsFargo2,91,1
10,8902.59,1191.04,48.07,1142.97,7759.62,WellsFargo2,91,1
11,7759.62,1191.04,41.9,1149.14,6610.48,WellsFargo2,91,1
12,6610.48,1191.04,35.7,1155.34,5455.14,WellsFargo2,91,1
13,5455.14,1191.04,29.46,1161.58,4293.56,WellsFargo2,91,1
14,4293.56,1191.04,23.19,1167.85,3125.71,WellsFargo2,91,1
15,3125.71,1191.04,16.88,1174.16,1951.55,WellsFargo2,91,1
16,1951.55,1191.04,10.54,1180.5,771.05,WellsFargo2,91,1
17,771.05,1191.04,4.16,1186.88,-415.83,WellsFargo2,91,1
0,180000.0,1331.44,594.0,737.44,179262.56,mortgage,91,2
1,179262.56,1331.44,591.57,739.87,178522.69,mortgage,91,2
2,178522.69,1331.44,589.12,742.32,177780.37,mortgage,91,2
3,177780.37,1331.44,586.68,744.76,177035.61,mortgage,91,2
4,177035.61,1331.44,584.22,747.22,176288.39,mortgage,91,2
5,176288.39,1331.44,581.75,749.69,175538.7,mortgage,91,2
6,175538.7,1331.44,579.28,752.16,174786.54,mortgage,91,2
7,174786.54,1331.44,576.8,754.64,174031.9,mortgage,91,2
8,174031.9,1331.44,574.31,757.13,173274.77,mortgage,91,2
9,173274.77,1331.44,571.81,759.63,172515.14,mortgage,91,2
10,172515.14,1331.44,569.3,762.14,171753.0,mortgage,91,2
11,171753.0,1331.44,566.78,764.66,170988.34,mortgage,91,2
12,170988.34,1331.44,564.26,767.18,170221.16,mortgage,91,2
13,170221.16,1331.44,561.73,769.71,169451.45,mortgage,91,2
14,169451.45,1331.44,559.19,772.25,168679.2,mortgage,91,2
15,168679.2,1331.44,556.64,774.8,167904.4,mortgage,91,2
16,167904.4,1331.44,554.08,777.36,167127.04,mortgage,91,2
17,167127.04,1747.27,551.52,1195.75,165931.29,mortgage,91,2
18,165931.29,2522.48,547.57,1974.91,163956.38,mortgage,91,2
19,163956.38,2522.48,541.06,1981.42,161974.96,mortgage,91,2
20,161974.96,2522.48,534.52,1987.96,159987.0,mortgage,91,2
21,159987.0,2522.48,527.96,1994.52,157992.48,mortgage,91,2
22,157992.48,2522.48,521.38,2001.1,155991.38,mortgage,91,2
23,155991.38,2522.48,514.77,2007.71,153983.67,mortgage,91,2
24,153983.67,2522.48,508.15,2014.33,151969.34,mortgage,91,2
25,151969.34,2522.48,501.5,2020.98,149948.36,mortgage,91,2
26,149948.36,2522.48,494.83,2027.65,147920.71,mortgage,91,2
27,147920.71,2522.48,488.14,2034.34,145886.37,mortgage,91,2
28,145886.37,2522.48,481.43,2041.05,143845.32,mortgage,91,2
29,143845.32,2522.48,474.69,2047.79,141797.53,mortgage,91,2
30,141797.53,2522.48,467.93,2054.55,139742.98,mortgage,91,2
31,139742.98,2522.48,461.15,2061.33,137681.65,mortgage,91,2
32,137681.65,2522.48,454.35,2068.13,135613.52,mortgage,91,2
33,135613.52,2522.48,447.52,2074.96,133538.56,mortgage,91,2
34,133538.56,2522.48,440.68,2081.8,131456.76,mortgage,91,2
35,131456.76,2522.48,433.81,2088.67,129368.09,mortgage,91,2
36,129368.09,2522.48,426.91,2095.57,127272.52,mortgage,91,2
37,127272.52,2522.48,420.0,2102.48,125170.04,mortgage,91,2
38,125170.04,2522.48,413.06,2109.42,123060.62,mortgage,91,2
39,123060.62,2522.48,406.1,2116.38,120944.24,mortgage,91,2
40,120944.24,2522.48,399.12,2123.36,118820.88,mortgage,91,2
41,118820.88,2522.48,392.11,2130.37,116690.51,mortgage,91,2
42,116690.51,2522.48,385.08,2137.4,114553.11,mortgage,91,2
43,114553.11,2522.48,378.03,2144.45,112408.66,mortgage,91,2
44,112408.66,2522.48,370.95,2151.53,110257.13,mortgage,91,2
45,110257.13,2522.48,363.85,2158.63,108098.5,mortgage,91,2
46,108098.5,2522.48,356.73,2165.75,105932.75,mortgage,91,2
47,105932.75,2522.48,349.58,2172.9,103759.85,mortgage,91,2
48,103759.85,2522.48,342.41,2180.07,101579.78,mortgage,91,2
49,101579.78,2522.48,335.21,2187.27,99392.51,mortgage,91,2
50,99392.51,2522.48,328.0,2194.48,97198.03,mortgage,91,2
51,97198.03,2522.48,320.75,2201.73,94996.3,mortgage,91,2
52,94996.3,2522.48,313.49,2208.99,92787.31,mortgage,91,2
53,92787.31,2522.48,306.2,2216.28,90571.03,mortgage,91,2
54,90571.03,2522.48,298.88,2223.6,88347.43,mortgage,91,2
55,88347.43,2522.48,291.55,2230.93,86116.5,mortgage,91,2
56,86116.5,2522.48,284.18,2238.3,83878.2,mortgage,91,2
57,83878.2,2522.48,276.8,2245.68,81632.52,mortgage,91,2
58,81632.52,2522.48,269.39,2253.09,79379.43,mortgage,91,2
59,79379.43,2522.48,261.95,2260.53,77118.9,mortgage,91,2
60,77118.9,2522.48,254.49,2267.99,74850.91,mortgage,91,2
61,74850.91,2522.48,247.01,2275.47,72575.44,mortgage,91,2
62,72575.44,2522.48,239.5,2282.98,70292.46,mortgage,91,2
63,70292.46,2522.48,231.97,2290.51,68001.95,mortgage,91,2
64,68001.95,2522.48,224.41,2298.07,65703.88,mortgage,91,2
65,65703.88,2522.48,216.82,2305.66,63398.22,mortgage,91,2
66,63398.22,2522.48,209.21,2313.27,61084.95,mortgage,91,2
67,61084.95,2522.48,201.58,2320.9,58764.05,mortgage,91,2
68,58764.05,2522.48,193.92,2328.56,56435.49,mortgage,91,2
69,56435.49,2522.48,186.24,2336.24,54099.25,mortgage,91,2
70,54099.25,2522.48,178.53,2343.95,51755.3,mortgage,91,2
71,51755.3,2522.48,170.79,2351.69,49403.61,mortgage,91,2
72,49403.61,2522.48,163.03,2359.45,47044.16,mortgage,91,2
73,47044.16,2522.48,155.25,2367.23,44676.93,mortgage,91,2
74,44676.93,2522.48,147.43,2375.05,42301.88,mortgage,91,2
75,42301.88,2522.48,139.6,2382.88,39919.0,mortgage,91,2
76,39919.0,2522.48,131.73,2390.75,37528.25,mortgage,91,2
77,37528.25,2522.48,123.84,2398.64,35129.61,mortgage,91,2
78,35129.61,2522.48,115.93,2406.55,32723.06,mortgage,91,2
79,32723.06,2522.48,107.99,2414.49,30308.57,mortgage,91,2
80,30308.57,2522.48,100.02,2422.46,27886.11,mortgage,91,2
81,27886.11,2522.48,92.02,2430.46,25455.65,mortgage,91,2
82,25455.65,2522.48,84.0,2438.48,23017.17,mortgage,91,2
83,23017.17,2522.48,75.96,2446.52,20570.65,mortgage,91,2
84,20570.65,2522.48,67.88,2454.6,18116.05,mortgage,91,2
85,18116.05,2522.48,59.78,2462.7,15653.35,mortgage,91,2
86,15653.35,2522.48,51.66,2470.82,13182.53,mortgage,91,2
87,13182.53,2522.48,43.5,2478.98,10703.55,mortgage,91,2
88,10703.55,2522.48,35.32,2487.16,8216.39,mortgage,91,2
89,8216.39,2522.48,27.11,2495.37,5721.02,mortgage,91,2
90,5721.02,2522.48,18.88,2503.6,3217.42,mortgage,91,2
91,3217.42,2522.48,10.62,2511.86,705.56,mortgage,91,2
92,705.56,2522.48,2.33,2520.15,-1814.59,mortgage,91,2
0,4000.0,70.0,16.0,54.0,3946.0,testing,91,3
1,3946.0,70.0,15.78,54.22,3891.78,testing,91,3
2,3891.78,70.0,15.57,54.43,3837.35,testing,91,3
3,3837.35,70.0,15.35,54.65,3782.7,testing,91,3
4,3782.7,70.0,15.13,54.87,3727.83,testing,91,3
5,3727.83,70.0,14.91,55.09,3672.74,testing,91,3
6,3672.74,70.0,14.69,55.31,3617.43,testing,91,3
7,3617.43,70.0,14.47,55.53,3561.9,testing,91,3
8,3561.9,70.0,14.25,55.75,3506.15,testing,91,3
9,3506.15,70.0,14.02,55.98,3450.17,testing,91,3
10,3450.17,70.0,13.8,56.2,3393.97,testing,91,3
11,3393.97,70.0,13.58,56.42,3337.55,testing,91,3
12,3337.55,70.0,13.35,56.65,3280.9,testing,91,3
13,3280.9,70.0,13.12,56.88,3224.02,testing,91,3
14,3224.02,70.0,12.9,57.1,3166.92,testing,91,3
15,3166.92,70.0,12.67,57.33,3109.59,testing,91,3
16,3109.59,70.0,12.44,57.56,3052.03,testing,91,3
17,3052.03,70.0,12.21,57.79,2994.24,testing,91,3
18,2994.24,70.0,11.98,58.02,2936.22,testing,91,3
19,2936.22,70.0,11.74,58.26,2877.96,testing,91,3
20,2877.96,70.0,11.51,58.49,2819.47,testing,91,3
21,2819.47,70.0,11.28,58.72,2760.75,testing,91,3
22,2760.75,70.0,11.04,58.96,2701.79,testing,91,3
23,2701.79,70.0,10.81,59.19,2642.6,testing,91,3
24,2642.6,70.0,10.57,59.43,2583.17,testing,91,3
25,2583.17,70.0,10.33,59.67,2523.5,testing,91,3
26,2523.5,70.0,10.09,59.91,2463.59,testing,91,3
27,2463.59,70.0,9.85,60.15,2403.44,testing,91,3
28,2403.44,70.0,9.61,60.39,2343.05,testing,91,3
29,2343.05,70.0,9.37,60.63,2282.42,testing,91,3
30,2282.42,70.0,9.13,60.87,2221.55,testing,91,3
31,2221.55,70.0,8.89,61.11,2160.44,testing,91,3
32,2160.44,70.0,8.64,61.36,2099.08,testing,91,3
33,2099.08,70.0,8.4,61.6,2037.48,testing,91,3
34,2037.48,70.0,8.15,61.85,1975.63,testing,91,3
35,1975.63,70.0,7.9,62.1,1913.53,testing,91,3
36,1913.53,70.0,7.65,62.35,1851.18,testing,91,3
37,1851.18,70.0,7.4,62.6,1788.58,testing,91,3
38,1788.58,70.0,7.15,62.85,1725.73,testing,91,3
39,1725.73,70.0,6.9,63.1,1662.63,testing,91,3
40,1662.63,70.0,6.65,63.35,1599.28,testing,91,3
41,1599.28,70.0,6.4,63.6,1535.68,testing,91,3
42,1535.68,70.0,6.14,63.86,1471.82,testing,91,3
43,1471.82,70.0,5.89,64.11,1407.71,testing,91,3
44,1407.71,70.0,5.63,64.37,1343.34,testing,91,3
45,1343.34,70.0,5.37,64.63,1278.71,testing,91,3
46,1278.71,70.0,5.11,64.89,1213.82,testing,91,3
47,1213.82,70.0,4.86,65.14,1148.68,testing,91,3
48,1148.68,70.0,4.59,65.41,1083.27,testing,91,3
49,1083.27,70.0,4.33,65.67,1017.6,testing,91,3
50,1017.6,70.0,4.07,65.93,951.67,testing,91,3
51,951.67,70.0,3.81,66.19,885.48,testing,91,3
52,885.48,70.0,3.54,66.46,819.02,testing,91,3
53,819.02,70.0,3.28,66.72,752.3,testing,91,3
54,752.3,70.0,3.01,66.99,685.31,testing,91,3
55,685.31,70.0,2.74,67.26,618.05,testing,91,3
56,618.05,70.0,2.47,67.53,550.52,testing,91,3
57,550.52,70.0,2.2,67.8,482.72,testing,91,3
58,482.72,70.0,1.93,68.07,414.65,testing,91,3
59,414.65,70.0,1.66,68.34,346.31,testing,91,3
60,346.31,70.0,1.39,68.61,277.7,testing,91,3
61,277.7,70.0,1.11,68.89,208.81,testing,91,3
62,208.81,70.0,0.84,69.16,139.65,testing,91,3
63,139.65,70.0,0.56,69.44,70.21,testing,91,3
64,70.21,70.0,0.28,69.72,0.49,testing,91,3
65,0.49,70.0,0.0,70.0,-69.51,testing,91,3
0,5000.0,333.0,36.0,297.0,4703.0,Car,91,4
1,4703.0,333.0,33.86,299.14,4403.86,Car,91,4
2,4403.86,333.0,31.71,301.29,4102.57,Car,91,4
3,4102.57,333.0,29.54,303.46,3799.11,Car,91,4
4,3799.11,333.0,27.35,305.65,3493.46,Car,91,4
5,3493.46,333.0,25.15,307.85,3185.61,Car,91,4
6,3185.61,333.0,22.94,310.06,2875.55,Car,91,4
7,2875.55,333.0,20.7,312.3,2563.25,Car,91,4
8,2563.25,333.0,18.46,314.54,2248.71,Car,91,4
9,2248.71,333.0,16.19,316.81,1931.9,Car,91,4
10,1931.9,333.0,13.91,319.09,1612.81,Car,91,4
11,1612.81,333.0,11.61,321.39,1291.42,Car,91,4
12,1291.42,333.0,9.3,323.7,967.72,Car,91,4
13,967.72,333.0,6.97,326.03,641.69,Car,91,4
14,641.69,333.0,4.62,328.38,313.31,Car,91,4
15,313.31,333.0,2.26,330.74,-17.43,Car,91,4
0,8250.57,84.62,53.63,30.99,8219.58,WellsFargo1,91,5
1,8219.58,84.62,53.43,31.19,8188.39,WellsFargo1,91,5
2,8188.39,84.62,53.22,31.4,8156.99,WellsFargo1,91,5
3,8156.99,84.62,53.02,31.6,8125.39,WellsFargo1,91,5
4,8125.39,84.62,52.82,31.8,8093.59,WellsFargo1,91,5
5,8093.59,84.62,52.61,32.01,8061.58,WellsFargo1,91,5
6,8061.58,84.62,52.4,32.22,8029.36,WellsFargo1,91,5
7,8029.36,84.62,52.19,32.43,7996.93,WellsFargo1,91,5
8,7996.93,84.62,51.98,32.64,7964.29,WellsFargo1,91,5
9,7964.29,84.62,51.77,32.85,7931.44,WellsFargo1,91,5
10,7931.44,84.62,51.55,33.07,7898.37,WellsFargo1,91,5
11,7898.37,84.62,51.34,33.28,7865.09,WellsFargo1,91,5
12,7865.09,84.62,51.12,33.5,7831.59,WellsFargo1,91,5
13,7831.59,84.62,50.91,33.71,7797.88,WellsFargo1,91,5
14,7797.88,84.62,50.69,33.93,7763.95,WellsFargo1,91,5
15,7763.95,102.05,50.47,51.58,7712.37,WellsFargo1,91,5
16,7712.37,3010.1,50.13,2959.97,4752.4,WellsFargo1,91,5
17,4752.4,3010.1,30.89,2979.21,1773.19,WellsFargo1,91,5
18,1773.19,3010.1,11.53,2998.57,-1225.38,WellsFargo1,91,5
0,20000.0,1191.04,108.0,1083.04,18916.96,WellsFargo2,92,1
1,18916.96,1191.04,102.15,1088.89,17828.07,WellsFargo2,92,1
2,17828.07,1191.04,96.27,1094.77,16733.3,WellsFargo2,92,1
3,16733.3,1191.04,90.36,1100.68,15632.62,WellsFargo2,92,1
4,15632.62,1191.04,84.42,1106.62,14526.0,WellsFargo2,92,1
5,14526.0,1191.04,78.44,1112.6,13413.4,WellsFargo2,92,1
6,13413.4,1191.04,72.43,1118.61,12294.79,WellsFargo2,92,1
7,12294.79,1191.04,66.39,1124.65,11170.14,WellsFargo2,92,1
8,11170.14,1191.04,60.32,1130.72,10039.42,WellsFargo2,92,1
9,10039.42,1191.04,54.21,1136.83,8902.59,WellsFargo2,92,1
10,8902.59,1191.04,48.07,1142.97,7759.62,WellsFargo2,92,1
11,7759.62,1191.04,41.9,1149.14,6610.48,WellsFargo2,92,1
12,6610.48,1191.04,35.7,1155.34,5455.14,WellsFargo2,92,1
13,5455.14,1191.04,29.46,1161.58,4293.56,WellsFargo2,92,1
14,4293.56,1191.04,23.19,1167.85,3125.71,WellsFargo2,92,1
15,3125.71,1191.04,16.88,1174.16,1951.55,WellsFargo2,92,1
16,1951.55,1191.04,10.54,1180.5,771.05,WellsFargo2,92,1
17,771.05,1191.04,4.16,1186.88,-415.83,WellsFargo2,92,1
0,180000.0,1331.44,594.0,737.44,179262.56,mortgage,92,2
1,179262.56,1331.44,591.57,739.87,178522.69,mortgage,92,2
2,178522.69,1331.44,589.12,742.32,177780.37,mortgage,92,2
3,177780.37,1331.44,586.68,744.76,177035.61,mortgage,92,2
4,177035.61,1331.44,584.22,747.22,176288.39,mortgage,92,2
5,176288.39,1331.44,581.75,749.69,175538.7,mortgage,92,2
6,175538.7,1331.44,579.28,752.16,174786.54,mortgage,92,2
7,174786.54,1331.44,576.8,754.64,174031.9,mortgage,92,2
8,174031.9,1331.44,574.31,757.13,173274.77,mortgage,92,2
9,173274.77,1331.44,571.81,759.63,172515.14,mortgage,92,2
10,172515.14,1331.44,569.3,762.14,171753.0,mortgage,92,2
11,171753.0,1331.44,566.78,764.66,170988.34,mortgage,92,2
12,170988.34,1331.44,564.26,767.18,170221.16,mortgage,92,2
13,170221.16,1331.44,561.73,769.71,169451.45,mortgage,92,2
14,169451.45,1331.44,559.19,772.25,168679.2,mortgage,92,2
15,168679.2,1331.44,556.64,774.8,167904.4,mortgage,92,2
16,167904.4,1331.44,554.08,777.36,167127.04,mortgage,92,2
17,167127.04,1747.27,551.52,1195.75,165931.29,mortgage,92,2
18,165931.29,2522.48,547.57,1974.91,163956.38,mortgage,92,2
19,163956.38,2522.48,541.06,1981.42,161974.96,mortgage,92,2
20,161974.96,2522.48,534.52,1987.96,159987.0,mortgage,92,2
21,159987.0,2522.48,527.96,1994.52,157992.48,mortgage,92,2
22,157992.48,2522.48,521.38,2001.1,155991.38,mortgage,92,2
23,155991.38,2522.48,514.77,2007.71,153983.67,mortgage,92,2
24,153983.67,2522.48,508.15,2014.33,151969.34,mortgage,92,2
25,151969.34,2522.48,501.5,2020.98,149948.36,mortgage,92,2
26,149948.36,2522.48,494.83,2027.65,147920.71,mortgage,92,2
27,147920.71,2522.48,488.14,2034.34,145886.37,mortgage,92,2
28,145886.37,2522.48,481.43,2041.05,143845.32,mortgage,92,2
29,143845.32,2522.48,474.69,2047.79,141797.53,mortgage,92,2
30,141797.53,2522.48,467.93,2054.55,139742.98,mortgage,92,2
31,139742.98,2522.48,461.15,2061.33,137681.65,mortgage,92,2
32,137681.65,2522.48,454.35,2068.13,135613.52,mortgage,92,2
33,135613.52,2522.48,447.52,2074.96,133538.56,mortgage,92,2
34,133538.56,2522.48,440.68,2081.8,131456.76,mortgage,92,2
35,131456.76,2522.48,433.81,2088.67,129368.09,mortgage,92,2
36,129368.09,2522.48,426.91,2095.57,127272.52,mortgage,92,2
37,127272.52,2522.48,420.0,2102.48,125170.04,mortgage,92,2
38,125170.04,2522.48,413.06,2109.42,123060.62,mortgage,92,2
39,123060.62,2522.48,406.1,2116.38,120944.24,mortgage,92,2
40,120944.24,2522.48,399.12,2123.36,118820.88,mortgage,92,2
41,118820.88,2522.48,392.11,2130.37,116690.51,mortgage,92,2
42,116690.51,2522.48,385.08,2137.4,114553.11,mortgage,92,2
43,114553.11,2522.48,378.03,2144.45,112408.66,mortgage,92,2
44,112408.66,2522.48,370.95,2151.53,110257.13,mortgage,92,2
45,110257.13,2522.48,363.85,2158.63,108098.5,mortgage,92,2
46,108098.5,2522.48,356.73,2165.75,105932.75,mortgage,92,2
47,105932.75,2522.48,349.58,2172.9,103759.85,mortgage,92,2
48,103759.85,2522.48,342.41,2180.07,101579.78,mortgage,92,2
49,101579.78,2522.48,335.21,2187.27,99392.51,mortgage,92,2
50,99392.51,2522.48,328.0,2194.48,97198.03,mortgage,92,2
51,97198.03,2522.48,320.75,2201.73,94996.3,mortgage,92,2
52,94996.3,2522.48,313.49,2208.99,92787.31,mortgage,92,2
53,92787.31,2522.48,306.2,2216.28,90571.03,mortgage,92,2
54,90571.03,2522.48,298.88,2223.6,88347.43,mortgage,92,2
55,88347.43,2522.48,291.55,2230.93,86116.5,mortgage,92,2
56,86116.5,2522.48,284.18,2238.3,83878.2,mortgage,92,2
57,83878.2,2522.48,276.8,2245.68,81632.52,mortgage,92,2
58,81632.52,2522.48,269.39,2253.09,79379.43,mortgage,92,2
59,79379.43,2522.48,261.95,2260.53,77118.9,mortgage,92,2
60,77118.9,2522.48,254.49,2267.99,74850.91,mortgage,92,2
61,74850.91,2522.48,247.01,2275.47,72575.44,mortgage,92,2
62,72575.44,2522.48,239.5,2282.98,70292.46,mortgage,92,2
63,70292.46,2522.48,231.97,2290.51,68001.95,mortgage,92,2
64,68001.95,2522.48,224.41,2298.07,65703.88,mortgage,92,2
65,65703.88,2522.48,216.82,2305.66,63398.22,mortgage,92,2
66,63398.22,2522.48,209.21,2313.27,61084.95,mortgage,92,2
67,61084.95,2522.48,201.58,2320.9,58764.05,mortgage,92,2
68,58764.05,2522.48,193.92,2328.56,56435.49,mortgage,92,2
69,56435.49,2522.48,186.24,2336.24,54099.25,mortgage,92,2
70,54099.25,2522.48,178.53,2343.95,51755.3,mortgage,92,2
71,51755.3,2522.48,170.79,2351.69,49403.61,mortgage,92,2
72,49403.61,2522.48,163.03,2359.45,47044.16,mortgage,92,2
73,47044.16,2522.48,155.25,2367.23,44676.93,mortgage,92,2
74,44676.93,2522.48,147.43,2375.05,42301.88,mortgage,92,2
75,42301.88,2522.48,139.6,2382.88,39919.0,mortgage,92,2
76,39919.0,2522.48,131.73,2390.75,37528.25,mortgage,92,2
77,37528.25,2522.48,123.84,2398.64,35129.61,mortgage,92,2
78,35129.61,2522.48,115.93,2406.55,32723.06,mortgage,92,2
79,32723.06,2522.48,107.99,2414.49,30308.57,mortgage,92,2
80,30308.57,2522.48,100.02,2422.46,27886.11,mortgage,92,2
81,27886.11,2522.48,92.02,2430.46,25455.65,mortgage,92,2
82,25455.65,2522.48,84.0,2438.48,23017.17,mortgage,92,2
83,23017.17,2522.48,75.96,2446.52,20570.65,mortgage,92,2
84,20570.65,2522.48,67.88,2454.6,18116.05,mortgage,92,2
85,18116.05,2522.48,59.78,2462.7,15653.35,mortgage,92,2
86,15653.35,2522.48,51.66,2470.82,13182.53,mortgage,92,2
87,13182.53,2522.48,43.5,2478.98,10703.55,mortgage,92,2
88,10703.55,2522.48,35.32,2487.16,8216.39,mortgage,92,2
89,8216.39,2522.48,27.11,2495.37,5721.02,mortgage,92,2
90,5721.02,2522.48,18.88,2503.6,3217.42,mortgage,92,2
91,3217.42,2522.48,10.62,2511.86,705.56,mortgage,92,2
92,705.56,2522.48,2.33,2520.15,-1814.59,mortgage,92,2
0,4000.0,70.0,16.0,54.0,3946.0,testing,92,3
1,3946.0,70.0,15.78,54.22,3891.78,testing,92,3
2,3891.78,70.0,15.57,54.43,3837.35,testing,92,3
3,3837.35,70.0,15.35,54.65,3782.7,testing,92,3
4,3782.7,70.0,15.13,54.87,3727.83,testing,92,3
5,3727.83,70.0,14.91,55.09,3672.74,testing,92,3
6,3672.74,70.0,14.69,55.31,3617.43,testing,92,3
7,3617.43,70.0,14.47,55.53,3561.9,testing,92,3
8,3561.9,70.0,14.25,55.75,3506.15,testing,92,3
9,3506.15,70.0,14.02,55.98,3450.17,testing,92,3
10,3450.17,70.0,13.8,56.2,3393.97,testing,92,3
11,3393.97,70.0,13.58,56.42,3337.55,testing,92,3
12,3337.55,70.0,13.35,56.65,3280.9,testing,92,3
13,3280.9,70.0,13.12,56.88,3224.02,testing,92,3
14,3224.02,70.0,12.9,57.1,3166.92,testing,92,3
15,3166.92,70.0,12.67,57.33,3109.59,testing,92,3
16,3109.59,70.0,12.44,57.56,3052.03,testing,92,3
17,3052.03,70.0,12.21,57.79,2994.24,testing,92,3
18,2994.24,70.0,11.98,58.02,2936.22,testing,92,3
19,2936.22,70.0,11.74,58.26,2877.96,testing,92,3
20,2877.96,70.0,11.51,58.49,2819.47,testing,92,3
21,2819.47,70.0,11.28,58.72,2760.75,testing,92,3
22,2760.75,70.0,11.04,58.96,2701.79,testing,92,3
23,2701.79,70.0,10.81,59.19,2642.6,testing,92,3
24,2642.6,70.0,10.57,59.43,2583.17,testing,92,3
25,2583.17,70.0,10.33,59.67,2523.5,testing,92,3
26,2523.5,70.0,10.09,59.91,2463.59,testing,92,3
27,2463.59,70.0,9.85,60.15,2403.44,testing,92,3
28,2403.44,70.0,9.61,60.39,2343.05,testing,92,3
29,2343.05,70.0,9.37,60.63,2282.42,testing,92,3
30,2282.42,70.0,9.13,60.87,2221.55,testing,92,3
31,2221.55,70.0,8.89,61.11,2160.44,testing,92,3
32,2160.44,70.0,8.64,61.36,2099.08,testing,92,3
33,2099.08,70.0,8.4,61.6,2037.48,testing,92,3
34,2037.48,70.0,8.15,61.85,1975.63,testing,92,3
35,1975.63,70.0,7.9,62.1,1913.53,testing,92,3
36,1913.53,70.0,7.65,62.35,1851.18,testing,92,3
37,1851.18,70.0,7.4,62.6,1788.58,testing,92,3
38,1788.58,70.0,7.15,62.85,1725.73,testing,92,3
39,1725.73,70.0,6.9,63.1,1662.63,testing,92,3
40,1662.63,70.0,6.65,63.35,1599.28,testing,92,3
41,1599.28,70.0,6.4,63.6,1535.68,testing,92,3
42,1535.68,70.0,6.14,63.86,1471.82,testing,92,3
43,1471.82,70.0,5.89,64.11,1407.71,testing,92,3
44,1407.71,70.0,5.63,64.37,1343.34,testing,92,3
45,1343.34,70.0,5.37,64.63,1278.71,testing,92,3
46,1278.71,70.0,5.11,64.89,1213.82,testing,92,3
47,1213.82,70.0,4.86,65.14,1148.68,testing,92,3
48,1148.68,70.0,4.59,65.41,1083.27,testing,92,3
49,1083.27,70.0,4.33,65.67,1017.6,testing,92,3
50,1017.6,70.0,4.07,65.93,951.67,testing,92,3
51,951.67,70.0,3.81,66.19,885.48,testing,92,3
52,885.48,70.0,3.54,66.46,819.02,testing,92,3
53,819.02,70.0,3.28,66.72,752.3,testing,92,3
54,752.3,70.0,3.01,66.99,685.31,testing,92,3
55,685.31,70.0,2.74,67.26,618.05,testing,92,3
56,618.05,70.0,2.47,67.53,550.52,testing,92,3
57,550.52,70.0,2.2,67.8,482.72,testing,92,3
58,482.72,70.0,1.93,68.07,414.65,testing,92,3
59,414.65,70.0,1.66,68.34,346.31,testing,92,3
60,346.31,70.0,1.39,68.61,277.7,testing,92,3
61,277.7,70.0,1.11,68.89,208.81,testing,92,3
62,208.81,70.0,0.84,69.16,139.65,testing,92,3
63,139.65,70.0,0.56,69.44,70.21,testing,92,3
64,70.21,70.0,0.28,69.72,0.49,testing,92,3
65,0.49,70.0,0.0,70.0,-69.51,testing,92,3
0,8250.57,84.62,53.63,30.99,8219.58,WellsFargo1,92,4
1,8219.58,84.62,53.43,31.19,8188.39,WellsFargo1,92,4
2,8188.39,84.62,53.22,31.4,8156.99,WellsFargo1,92,4
3,8156.99,84.62,53.02,31.6,8125.39,WellsFargo1,92,4
4,8125.39,84.62,52.82,31.8,8093.59,WellsFargo1,92,4
5,8093.59,84.62,52.61,32.01,8061.58,WellsFargo1,92,4
6,8061.58,84.62,52.4,32.22,8029.36,WellsFargo1,92,4
7,8029.36,84.62,52.19,32.43,7996.93,WellsFargo1,92,4
8,7996.93,84.62,51.98,32.64,7964.29,WellsFargo1,92,4
9,7964.29,84.62,51.77,32.85,7931.44,WellsFargo1,92,4
10,7931.44,84.62,51.55,33.07,7898.37,WellsFargo1,92,4
11,7898.37,84.62,51.34,33.28,7865.09,WellsFargo1,92,4
12,7865.09,84.62,51.12,33.5,7831.59,WellsFargo1,92,4
13,7831.59,84.62,50.91,33.71,7797.88,WellsFargo1,92,4
14,7797.88,84.62,50.69,33.93,7763.95,WellsFargo1,92,4
15,7763.95,84.62,50.47,34.15,7729.8,WellsFargo1,92,4
16,7729.8,84.62,50.24,34.38,7695.42,WellsFargo1,92,4
17,7695.42,84.62,50.02,34.6,7660.82,WellsFargo1,92,4
18,7660.82,84.62,49.8,34.82,7626.0,WellsFargo1,92,4
19,7626.0,84.62,49.57,35.05,7590.95,WellsFargo1,92,4
20,7590.95,84.62,49.34,35.28,7555.67,WellsFargo1,92,4
21,7555.67,84.62,49.11,35.51,7520.16,WellsFargo1,92,4
22,7520.16,84.62,48.88,35.74,7484.42,WellsFargo1,92,4
23,7484.42,84.62,48.65,35.97,7448.45,WellsFargo1,92,4
24,7448.45,84.62,48.41,36.21,7412.24,WellsFargo1,92,4
25,7412.24,84.62,48.18,36.44,7375.8,WellsFargo1,92,4
26,7375.8,84.62,47.94,36.68,7339.12,WellsFargo1,92,4
27,7339.12,84.62,47.7,36.92,7302.2,WellsFargo1,92,4
28,7302.2,84.62,47.46,37.16,7265.04,WellsFargo1,92,4
29,7265.04,84.62,47.22,37.4,7227.64,WellsFargo1,92,4
30,7227.64,84.62,46.98,37.64,7190.0,WellsFargo1,92,4
31,7190.0,84.62,46.73,37.89,7152.11,WellsFargo1,92,4
32,7152.11,84.62,46.49,38.13,7113.98,WellsFargo1,92,4
33,7113.98,84.62,46.24,38.38,7075.6,WellsFargo1,92,4
34,7075.6,84.62,45.99,38.63,7036.97,WellsFargo1,92,4
35,7036.97,84.62,45.74,38.88,6998.09,WellsFargo1,92,4
36,6998.09,84.62,45.49,39.13,6958.96,WellsFargo1,92,4
37,6958.96,84.62,45.23,39.39,6919.57,WellsFargo1,92,4
38,6919.57,84.62,44.98,39.64,6879.93,WellsFargo1,92,4
39,6879.93,84.62,44.72,39.9,6840.03,WellsFargo1,92,4
40,6840.03,84.62,44.46,40.16,6799.87,WellsFargo1,92,4
41,6799.87,84.62,44.2,40.42,6759.45,WellsFargo1,92,4
42,6759.45,84.62,43.94,40.68,6718.77,WellsFargo1,92,4
43,6718.77,84.62,43.67,40.95,6677.82,WellsFargo1,92,4
44,6677.82,84.62,43.41,41.21,6636.61,WellsFargo1,92,4
45,6636.61,84.62,43.14,41.48,6595.13,WellsFargo1,92,4
46,6595.13,84.62,42.87,41.75,6553.38,WellsFargo1,92,4
47,6553.38,84.62,42.6,42.02,6511.36,WellsFargo1,92,4
48,6511.36,84.62,42.32,42.3,6469.06,WellsFargo1,92,4
49,6469.06,84.62,42.05,42.57,6426.49,WellsFargo1,92,4
50,6426.49,84.62,41.77,42.85,6383.64,WellsFargo1,92,4
51,6383.64,84.62,41.49,43.13,6340.51,WellsFargo1,92,4
52,6340.51,84.62,41.21,43.41,6297.1,WellsFargo1,92,4
53,6297.1,84.62,40.93,43.69,6253.41,WellsFargo1,92,4
54,6253.41,84.62,40.65,43.97,6209.44,WellsFargo1,92,4
55,6209.44,84.62,40.36,44.26,6165.18,WellsFargo1,92,4
56,6165.18,84.62,40.07,44.55,6120.63,WellsFargo1,92,4
57,6120.63,84.62,39.78,44.84,6075.79,WellsFargo1,92,4
58,6075.79,84.62,39.49,45.13,6030.66,WellsFargo1,92,4
59,6030.66,84.62,39.2,45.42,5985.24,WellsFargo1,92,4
60,5985.24,84.62,38.9,45.72,5939.52,WellsFargo1,92,4
61,5939.52,84.62,38.61,46.01,5893.51,WellsFargo1,92,4
62,5893.51,84.62,38.31,46.31,5847.2,WellsFargo1,92,4
63,5847.2,84.62,38.01,46.61,5800.59,WellsFargo1,92,4
64,5800.59,84.62,37.7,46.92,5753.67,WellsFargo1,92,4
65,5753.67,154.13,37.4,116.73,5636.94,WellsFargo1,92,4
66,5636.94,2677.1,36.64,2640.46,2996.48,WellsFargo1,92,4
67,2996.48,2677.1,19.48,2657.62,338.86,WellsFargo1,92,4
68,338.86,2677.1,2.2,2674.9,-2336.04,WellsFargo1,92,4
0,5000.0,333.0,36.0,297.0,4703.0,Car,92,5
1,4703.0,333.0,33.86,299.14,4403.86,Car,92,5
2,4403.86,333.0,31.71,301.29,4102.57,Car,92,5
3,4102.57,333.0,29.54,303.46,3799.11,Car,92,5
4,3799.11,333.0,27.35,305.65,3493.46,Car,92,5
5,3493.46,333.0,25.15,307.85,3185.61,Car,92,5
6,3185.61,333.0,22.94,310.06,2875.55,Car,92,5
7,2875.55,333.0,20.7,312.3,2563.25,Car,92,5
8,2563.25,333.0,18.46,314.54,2248.71,Car,92,5
9,2248.71,333.0,16.19,316.81,1931.9,Car,92,5
10,1931.9,333.0,13.91,319.09,1612.81,Car,92,5
11,1612.81,333.0,11.61,321.39,1291.42,Car,92,5
12,1291.42,333.0,9.3,323.7,967.72,Car,92,5
13,967.72,333.0,6.97,326.03,641.69,Car,92,5
14,641.69,333.0,4.62,328.38,313.31,Car,92,5
15,313.31,333.0,2.26,330.74,-17.43,Car,92,5
0,20000.0,1191.04,108.0,1083.04,18916.96,WellsFargo2,93,1
1,18916.96,1191.04,102.15,1088.89,17828.07,WellsFargo2,93,1
2,17828.07,1191.04,96.27,1094.77,16733.3,WellsFargo2,93,1
3,16733.3,1191.04,90.36,1100.68,15632.62,WellsFargo2,93,1
4,15632.62,1191.04,84.42,1106.62,14526.0,WellsFargo2,93,1
5,14526.0,1191.04,78.44,1112.6,13413.4,WellsFargo2,93,1
6,13413.4,1191.04,72.43,1118.61,12294.79,WellsFargo2,93,1
7,12294.79,1191.04,66.39,1124.65,11170.14,WellsFargo2,93,1
8,11170.14,1191.04,60.32,1130.72,10039.42,WellsFargo2,93,1
9,10039.42,1191.04,54.21,1136.83,8902.59,WellsFargo2,93,1
10,8902.59,1191.04,48.07,1142.97,7759.62,WellsFargo2,93,1
11,7759.62,1191.04,41.9,1149.14,6610.48,WellsFargo2,93,1
12,6610.48,1191.04,35.7,1155.34,5455.14,WellsFargo2,93,1
13,5455.14,1191.04,29.46,1161.58,4293.56,WellsFargo2,93,1
14,4293.56,1191.04,23.19,1167.85,3125.71,WellsFargo2,93,1
15,3125.71,1191.04,16.88,1174.16,1951.55,WellsFargo2,93,1
16,1951.55,1191.04,10.54,1180.5,771.05,WellsFargo2,93,1
17,771.05,1191.04,4.16,1186.88,-415.83,WellsFargo2,93,1
0,180000.0,1331.44,594.0,737.44,179262.56,mortgage,93,2
1,179262.56,1331.44,591.57,739.87,178522.69,mortgage,93,2
2,178522.69,1331.44,589.12,742.32,177780.37,mortgage,93,2
3,177780.37,1331.44,586.68,744.76,177035.61,mortgage,93,2
4,177035.61,1331.44,584.22,747.22,176288.39,mortgage,93,2
5,176288.39,1331.44,581.75,749.69,175538.7,mortgage,93,2
6,175538.7,1331.44,579.28,752.16,174786.54,mortgage,93,2
7,174786.54,1331.44,576.8,754.64,174031.9,mortgage,93,2
8,174031.9,1331.44,574.31,757.13,173274.77,mortgage,93,2
9,173274.77,1331.44,571.81,759.63,172515.14,mortgage,93,2
10,172515.14,1331.44,569.3,762.14,171753.0,mortgage,93,2
11,171753.0,1331.44,566.78,764.66,170988.34,mortgage,93,2
12,170988.34,1331.44,564.26,767.18,170221.16,mortgage,93,2
13,170221.16,1331.44,561.73,769.71,169451.45,mortgage,93,2
14,169451.45,1331.44,559.19,772.25,168679.2,mortgage,93,2
15,168679.2,1331.44,556.64,774.8,167904.4,mortgage,93,2
16,167904.4,1331.44,554.08,777.36,167127.04,mortgage,93,2
17,167127.04,1747.27,551.52,1195.75,165931.29,mortgage,93,2
18,165931.29,2522.48,547.57,1974.91,163956.38,mortgage,93,2
19,163956.38,2522.48,541.06,1981.42,161974.96,mortgage,93,2
20,161974.96,2522.48,534.52,1987.96,159987.0,mortgage,93,2
21,159987.0,2522.48,527.96,1994.52,157992.48,mortgage,93,2
22,157992.48,2522.48,521.38,2001.1,155991.38,mortgage,93,2
23,155991.38,2522.48,514.77,2007.71,153983.67,mortgage,93,2
24,153983.67,2522.48,508.15,2014.33,151969.34,mortgage,93,2
25,151969.34,2522.48,501.5,2020.98,149948.36,mortgage,93,2
26,149948.36,2522.48,494.83,2027.65,147920.71,mortgage,93,2
27,147920.71,2522.48,488.14,2034.34,145886.37,mortgage,93,2
28,145886.37,2522.48,481.43,2041.05,143845.32,mortgage,93,2
29,143845.32,2522.48,474.69,2047.79,141797.53,mortgage,93,2
30,141797.53,2522.48,467.93,2054.55,139742.98,mortgage,93,2
31,139742.98,2522.48,461.15,2061.33,137681.65,mortgage,93,2
32,137681.65,2522.48,454.35,2068.13,135613.52,mortgage,93,2
33,135613.52,2522.48,447.52,2074.96,133538.56,mortgage,93,2
34,133538.56,2522.48,440.68,2081.8,131456.76,mortgage,93,2
35,131456.76,2522.48,433.81,2088.67,129368.09,mortgage,93,2
36,129368.09,2522.48,426.91,2095.57,127272.52,mortgage,93,2
37,127272.52,2522.48,420.0,2102.48,125170.04,mortgage,93,2
38,125170.04,2522.48,413.06,2109.42,123060.62,mortgage,93,2
39,123060.62,2522.48,406.1,2116.38,120944.24,mortgage,93,2
40,120944.24,2522.48,399.12,2123.36,118820.88,mortgage,93,2
41,118820.88,2522.48,392.11,2130.37,116690.51,mortgage,93,2
42,116690.51,2522.48,385.08,2137.4,114553.11,mortgage,93,2
43,114553.11,2522.48,378.03,2144.45,112408.66,mortgage,93,2
44,112408.66,2522.48,370.95,2151.53,110257.13,mortgage,93,2
45,110257.13,2522.48,363.85,2158.63,108098.5,mortgage,93,2
46,108098.5,2522.48,356.73,2165.75,105932.75,mortgage,93,2
47,105932.75,2522.48,349.58,2172.9,103759.85,mortgage,93,2
48,103759.85,2522.48,342.41,2180.07,101579.78,mortgage,93,2
49,101579.78,2522.48,335.21,2187.27,99392.51,mortgage,93,2
50,99392.51,2522.48,328.0,2194.48,97198.03,mortgage,93,2
51,97198.03,2522.48,320.75,2201.73,94996.3,mortgage,93,2
52,94996.3,2522.48,313.49,2208.99,92787.31,mortgage,93,2
53,92787.31,2522.48,306.2,2216.28,90571.03,mortgage,93,2
54,90571.03,2522.48,298.88,2223.6,88347.43,mortgage,93,2
55,88347.43,2522.48,291.55,2230.93,86116.5,mortgage,93,2
56,86116.5,2522.48,284.18,2238.3,83878.2,mortgage,93,2
57,83878.2,2522.48,276.8,2245.68,81632.52,mortgage,93,2
58,81632.52,2522.48,269.39,2253.09,79379.43,mortgage,93,2
59,79379.43,2522.48,261.95,2260.53,77118.9,mortgage,93,2
60,77118.9,2522.48,254.49,2267.99,74850.91,mortgage,93,2
61,74850.91,2522.48,247.01,2275.47,72575.44,mortgage,93,2
62,72575.44,2522.48,239.5,2282.98,70292.46,mortgage,93,2
63,70292.46,2522.48,231.97,2290.51,68001.95,mortgage,93,2
64,68001.95,2522.48,224.41,2298.07,65703.88,mortgage,93,2
65,65703.88,2522.48,216.82,2305.66,63398.22,mortgage,93,2
66,63398.22,2522.48,209.21,2313.27,61084.95,mortgage,93,2
67,61084.95,2522.48,201.58,2320.9,58764.05,mortgage,93,2
68,58764.05,2522.48,193.92,2328.56,56435.49,mortgage,93,2
69,56435.49,2522.48,186.24,2336.24,54099.25,mortgage,93,2
70,54099.25,2522.48,178.53,2343.95,51755.3,mortgage,93,2
71,51755.3,2522.48,170.79,2351.69,49403.61,mortgage,93,2
72,49403.61,2522.48,163.03,2359.45,47044.16,mortgage,93,2
73,47044.16,2522.48,155.25,2367.23,44676.93,mortgage,93,2
74,44676.93,2522.48,147.43,2375.05,42301.88,mortgage,93,2
75,42301.88,2522.48,139.6,2382.88,39919.0,mortgage,93,2
76,39919.0,2522.48,131.73,2390.75,37528.25,mortgage,93,2
77,37528.25,2522.48,123.84,2398.64,35129.61,mortgage,93,2
78,35129.61,2522.48,115.93,2406.55,32723.06,mortgage,93,2
79,32723.06,2522.48,107.99,2414.49,30308.57,mortgage,93,2
80,30308.57,2522.48,100.02,2422.46,27886.11,mortgage,93,2
81,27886.11,2522.48,92.02,2430.46,25455.65,mortgage,93,2
82,25455.65,2522.48,84.0,2438.48,23017.17,mortgage,93,2
83,23017.17,2522.48,75.96,2446.52,20570.65,mortgage,93,2
84,20570.65,2522.48,67.88,2454.6,18116.05,mortgage,93,2
85,18116.05,2522.48,59.78,2462.7,15653.35,mortgage,93,2
86,15653.35,2522.48,51.66,2470.82,13182.53,mortgage,93,2
87,13182.53,2522.48,43.5,2478.98,10703.55,mortgage,93,2
88,10703.55,2522.48,35.32,2487.16,8216.39,mortgage,93,2
89,8216.39,2522.48,27.11,2495.37,5721.02,mortgage,93,2
90,5721.02,2522.48,18.88,2503.6,3217.42,mortgage,93,2
91,3217.42,2522.48,10.62,2511.86,705.56,mortgage,93,2
92,705.56,2522.48,2.33,2520.15,-1814.59,mortgage,93,2
0,5000.0,333.0,36.0,297.0,4703.0,Car,93,3
1,4703.0,333.0,33.86,299.14,4403.86,Car,93,3
2,4403.86,333.0,31.71,301.29,4102.57,Car,93,3
3,4102.57,333.0,29.54,303.46,3799.11,Car,93,3
4,3799.11,333.0,27.35,305.65,3493.46,Car,93,3
5,3493.46,333.0,25.15,307.85,3185.61,Car,93,3
6,3185.61,333.0,22.94,310.06,2875.55,Car,93,3
7,2875.55,333.0,20.7,312.3,2563.25,Car,93,3
8,2563.25,333.0,18.46,314.54,2248.71,Car,93,3
9,2248.71,333.0,16.19,316.81,1931.9,Car,93,3
10,1931.9,333.0,13.91,319.09,1612.81,Car,93,3
11,1612.81,333.0,11.61,321.39,1291.42,Car,93,3
12,1291.42,333.0,9.3,323.7,967.72,Car,93,3
13,967.72,333.0,6.97,326.03,641.69,Car,93,3
14,641.69,333.0,4.62,328.38,313.31,Car,93,3
15,313.31,333.0,2.26,330.74,-17.43,Car,93,3
0,4000.0,70.0,16.0,54.0,3946.0,testing,93,4
1,3946.0,70.0,15.78,54.22,3891.78,testing,93,4
2,3891.78,70.0,15.57,54.43,3837.35,testing,93,4
3,3837.35,70.0,15.35,54.65,3782.7,testing,93,4
4,3782.7,70.0,15.13,54.87,3727.83,testing,93,4
5,3727.83,70.0,14.91,55.09,3672.74,testing,93,4
6,3672.74,70.0,14.69,55.31,3617.43,testing,93,4
7,3617.43,70.0,14.47,55.53,3561.9,testing,93,4
8,3561.9,70.0,14.25,55.75,3506.15,testing,93,4
9,3506.15,70.0,14.02,55.98,3450.17,testing,93,4
10,3450.17,70.0,13.8,56.2,3393.97,testing,93,4
11,3393.97,70.0,13.58,56.42,3337.55,testing,93,4
12,3337.55,70.0,13.35,56.65,3280.9,testing,93,4
13,3280.9,70.0,13.12,56.88,3224.02,testing,93,4
14,3224.02,70.0,12.9,57.1,3166.92,testing,93,4
15,3166.92,87.43,12.67,74.76,3092.16,testing,93,4
16,3092.16,2925.48,12.37,2913.11,179.05,testing,93,4
17,179.05,2925.48,0.72,2924.76,-2745.71,testing,93,4
0,8250.57,84.62,53.63,30.99,8219.58,WellsFargo1,93,5
1,8219.58,84.62,53.43,31.19,8188.39,WellsFargo1,93,5
2,8188.39,84.62,53.22,31.4,8156.99,WellsFargo1,93,5
3,8156.99,84.62,53.02,31.6,8125.39,WellsFargo1,93,5
4,8125.39,84.62,52.82,31.8,8093.59,WellsFargo1,93,5
5,8093.59,84.62,52.61,32.01,8061.58,WellsFargo1,93,5
6,8061.58,84.62,52.4,32.22,8029.36,WellsFargo1,93,5
7,8029.36,84.62,52.19,32.43,7996.93,WellsFargo1,93,5
8,7996.93,84.62,51.98,32.64,7964.29,WellsFargo1,93,5
9,7964.29,84.62,51.77,32.85,7931.44,WellsFargo1,93,5
10,7931.44,84.62,51.55,33.07,7898.37,WellsFargo1,93,5
11,7898.37,84.62,51.34,33.28,7865.09,WellsFargo1,93,5
12,7865.09,84.62,51.12,33.5,7831.59,WellsFargo1,93,5
13,7831.59,84.62,50.91,33.71,7797.88,WellsFargo1,93,5
14,7797.88,84.62,50.69,33.93,7763.95,WellsFargo1,93,5
15,7763.95,84.62,50.47,34.15,7729.8,WellsFargo1,93,5
16,7729.8,84.62,50.24,34.38,7695.42,WellsFargo1,93,5
17,7695.42,2830.33,50.02,2780.31,4915.11,WellsFargo1,93,5
18,4915.11,3010.1,31.95,2978.15,1936.96,WellsFargo1,93,5
19,1936.96,3010.1,12.59,2997.51,-1060.55,WellsFargo1,93,5
0,20000.0,1191.04,108.0,1083.04,18916.96,WellsFargo2,94,1
1,18916.96,1191.04,102.15,1088.89,17828.07,WellsFargo2,94,1
2,17828.07,1191.04,96.27,1094.77,16733.3,WellsFargo2,94,1
3,16733.3,1191.04,90.36,1100.68,15632.62,WellsFargo2,94,1
4,15632.62,1191.04,84.42,1106.62,14526.0,WellsFargo2,94,1
5,14526.0,1191.04,78.44,1112.6,13413.4,WellsFargo2,94,1
6,13413.4,1191.04,72.43,1118.61,12294.79,WellsFargo2,94,1
7,12294.79,1191.04,66.39,1124.65,11170.14,WellsFargo2,94,1
8,11170.14,1191.04,60.32,1130.72,10039.42,WellsFargo2,94,1
9,10039.42,1191.04,54.21,1136.83,8902.59,WellsFargo2,94,1
10,8902.59,1191.04,48.07,1142.97,7759.62,WellsFargo2,94,1
11,7759.62,1191.04,41.9,1149.14,6610.48,WellsFargo2,94,1
12,6610.48,1191.04,35.7,1155.34,5455.14,WellsFargo2,94,1
13,5455.14,1191.04,29.46,1161.58,4293.56,WellsFargo2,94,1
14,4293.56,1191.04,23.19,1167.85,3125.71,WellsFargo2,94,1
15,3125.71,1191.04,16.88,1174.16,1951.55,WellsFargo2,94,1
16,1951.55,1191.04,10.54,1180.5,771.05,WellsFargo2,94,1
17,771.05,1191.04,4.16,1186.88,-415.83,WellsFargo2,94,1
0,180000.0,1331.44,594.0,737.44,179262.56,mortgage,94,2
1,179262.56,1331.44,591.57,739.87,178522.69,mortgage,94,2
2,178522.69,1331.44,589.12,742.32,177780.37,mortgage,94,2
3,177780.37,1331.44,586.68,744.76,177035.61,mortgage,94,2
4,177035.61,1331.44,584.22,747.22,176288.39,mortgage,94,2
5,176288.39,1331.44,581.75,749.69,175538.7,mortgage,94,2
6,175538.7,1331.44,579.28,752.16,174786.54,mortgage,94,2
7,174786.54,1331.44,576.8,754.64,174031.9,mortgage,94,2
8,174031.9,1331.44,574.31,757.13,173274.77,mortgage,94,2
9,173274.77,1331.44,571.81,759.63,172515.14,mortgage,94,2
10,172515.14,1331.44,569.3,762.14,171753.0,mortgage,94,2
11,171753.0,1331.44,566.78,764.66,170988.34,mortgage,94,2
12,170988.34,1331.44,564.26,767.18,170221.16,mortgage,94,2
13,170221.16,1331.44,561.73,769.71,169451.45,mortgage,94,2
14,169451.45,1331.44,559.19,772.25,168679.2,mortgage,94,2
15,168679.2,1331.44,556.64,774.8,167904.4,mortgage,94,2
16,167904.4,1331.44,554.08,777.36,167127.04,mortgage,94,2
17,167127.04,1747.27,551.52,1195.75,165931.29,mortgage,94,2
18,165931.29,2522.48,547.57,1974.91,163956.38,mortgage,94,2
19,163956.38,2522.48,541.06,1981.42,161974.96,mortgage,94,2
20,161974.96,2522.48,534.52,1987.96,159987.0,mortgage,94,2
21,159987.0,2522.48,527.96,1994.52,157992.48,mortgage,94,2
22,157992.48,2522.48,521.38,2001.1,155991.38,mortgage,94,2
23,155991.38,2522.48,514.77,2007.71,153983.67,mortgage,94,2
24,153983.67,2522.48,508.15,2014.33,151969.34,mortgage,94,2
25,151969.34,2522.48,501.5,2020.98,149948.36,mortgage,94,2
26,149948.36,2522.48,494.83,2027.65,147920.71,mortgage,94,2
27,147920.71,2522.48,488.14,2034.34,145886.37,mortgage,94,2
28,145886.37,2522.48,481.43,2041.05,143845.32,mortgage,94,2
29,143845.32,2522.48,474.69,2047.79,141797.53,mortgage,94,2
30,141797.53,2522.48,467.93,2054.55,139742.98,mortgage,94,2
31,139742.98,2522.48,461.15,2061.33,137681.65,mortgage,94,2
32,137681.65,2522.48,454.35,2068.13,135613.52,mortgage,94,2
33,135613.52,2522.48,447.52,2074.96,133538.56,mortgage,94,2
34,133538.56,2522.48,440.68,2081.8,131456.76,mortgage,94,2
35,131456.76,2522.48,433.81,2088.67,129368.09,mortgage,94,2
36,129368.09,2522.48,426.91,2095.57,127272.52,mortgage,94,2
37,127272.52,2522.48,420.0,2102.48,125170.04,mortgage,94,2
38,125170.04,2522.48,413.06,2109.42,123060.62,mortgage,94,2
39,123060.62,2522.48,406.1,2116.38,120944.24,mortgage,94,2
40,120944.24,2522.48,399.12,2123.36,118820.88,mortgage,94,2
41,118820.88,2522.48,392.11,2130.37,116690.51,mortgage,94,2
42,116690.51,2522.48,385.08,2137.4,114553.11,mortgage,94,2
43,114553.11,2522.48,378.03,2144.45,112408.66,mortgage,94,2
44,112408.66,2522.48,370.95,2151.53,110257.13,mortgage,94,2
45,110257.13,2522.48,363.85,2158.63,108098.5,mortgage,94,2
46,108098.5,2522.48,356.73,2165.75,105932.75,mortgage,94,2
47,105932.75,2522.48,349.58,2172.9,103759.85,mortgage,94,2
48,103759.85,2522.48,342.41,2180.07,101579.78,mortgage,94,2
49,101579.78,2522.48,335.21,2187.27,99392.51,mortgage,94,2
50,99392.51,2522.48,328.0,2194.48,97198.03,mortgage,94,2
51,97198.03,2522.48,320.75,2201.73,94996.3,mortgage,94,2
52,94996.3,2522.48,313.49,2208.99,92787.31,mortgage,94,2
53,92787.31,2522.48,306.2,2216.28,90571.03,mortgage,94,2
54,90571.03,2522.48,298.88,2223.6,88347.43,mortgage,94,2
55,88347.43,2522.48,291.55,2230.93,86116.5,mortgage,94,2
56,86116.5,2522.48,284.18,2238.3,83878.2,mortgage,94,2
57,83878.2,2522.48,276.8,2245.68,81632.52,mortgage,94,2
58,81632.52,2522.48,269.39,2253.09,79379.43,mortgage,94,2
59,79379.43,2522.48,261.95,2260.53,77118.9,mortgage,94,2
60,77118.9,2522.48,254.49,2267.99,74850.91,mortgage,94,2
61,74850.91,2522.48,247.01,2275.47,72575.44,mortgage,94,2
62,72575.44,2522.48,239.5,2282.98,70292.46,mortgage,94,2
63,70292.46,2522.48,231.97,2290.51,68001.95,mortgage,94,2
64,68001.95,2522.48,224.41,2298.07,65703.88,mortgage,94,2
65,65703.88,2522.48,216.82,2305.66,63398.22,mortgage,94,2
66,63398.22,2522.48,209.21,2313.27,61084.95,mortgage,94,2
67,61084.95,2522.48,201.58,2320.9,58764.05,mortgage,94,2
68,58764.05,2522.48,193.92,2328.56,56435.49,mortgage,94,2
69,56435.49,2522.48,186.24,2336.24,54099.25,mortgage,94,2
70,54099.25,2522.48,178.53,2343.95,51755.3,mortgage,94,2
71,51755.3,2522.48,170.79,2351.69,49403.61,mortgage,94,2
72,49403.61,2522.48,163.03,2359.45,47044.16,mortgage,94,2
73,47044.16,2522.48,155.25,2367.23,44676.93,mortgage,94,2
74,44676.93,2522.48,147.43,2375.05,42301.88,mortgage,94,2
75,42301.88,2522.48,139.6,2382.88,39919.0,mortgage,94,2
76,39919.0,2522.48,131.73,2390.75,37528.25,mortgage,94,2
77,37528.25,2522.48,123.84,2398.64,35129.61,mortgage,94,2
78,35129.61,2522.48,115.93,2406.55,32723.06,mortgage,94,2
79,32723.06,2522.48,107.99,2414.49,30308.57,mortgage,94,2
80,30308.57,2522.48,100.02,2422.46,27886.11,mortgage,94,2
81,27886.11,2522.48,92.02,2430.46,25455.65,mortgage,94,2
82,25455.65,2522.48,84.0,2438.48,23017.17,mortgage,94,2
83,23017.17,2522.48,75.96,2446.52,20570.65,mortgage,94,2
84,20570.65,2522.48,67.88,2454.6,18116.05,mortgage,94,2
85,18116.05,2522.48,59.78,2462.7,15653.35,mortgage,94,2
86,15653.35,2522.48,51.66,2470.82,13182.53,mortgage,94,2
87,13182.53,2522.48,43.5,2478.98,10703.55,mortgage,94,2
88,10703.55,2522.48,35.32,2487.16,8216.39,mortgage,94,2
89,8216.39,2522.48,27.11,2495.37,5721.02,mortgage,94,2
90,5721.02,2522.48,18.88,2503.6,3217.42,mortgage,94,2
91,3217.42,2522.48,10.62,2511.86,705.56,mortgage,94,2
92,705.56,2522.48,2.33,2520.15,-1814.59,mortgage,94,2
0,5000.0,333.0,36.0,297.0,4703.0,Car,94,3
1,4703.0,333.0,33.86,299.14,4403.86,Car,94,3
2,4403.86,333.0,31.71,301.29,4102.57,Car,94,3
3,4102.57,333.0,29.54,303.46,3799.11,Car,94,3
4,3799.11,333.0,27.35,305.65,3493.46,Car,94,3
5,3493.46,333.0,25.15,307.85,3185.61,Car,94,3
6,3185.61,333.0,22.94,310.06,2875.55,Car,94,3
7,2875.55,333.0,20.7,312.3,2563.25,Car,94,3
8,2563.25,333.0,18.46,314.54,2248.71,Car,94,3
9,2248.71,333.0,16.19,316.81,1931.9,Car,94,3
10,1931.9,333.0,13.91,319.09,1612.81,Car,94,3
11,1612.81,333.0,11.61,321.39,1291.42,Car,94,3
12,1291.42,333.0,9.3,323.7,967.72,Car,94,3
13,967.72,333.0,6.97,326.03,641.69,Car,94,3
14,641.69,333.0,4.62,328.38,313.31,Car,94,3
15,313.31,333.0,2.26,330.74,-17.43,Car,94,3
0,8250.57,84.62,53.63,30.99,8219.58,WellsFargo1,94,4
1,8219.58,84.62,53.43,31.19,8188.39,WellsFargo1,94,4
2,8188.39,84.62,53.22,31.4,8156.99,WellsFargo1,94,4
3,8156.99,84.62,53.02,31.6,8125.39,WellsFargo1,94,4
4,8125.39,84.62,52.82,31.8,8093.59,WellsFargo1,94,4
5,8093.59,84.62,52.61,32.01,8061.58,WellsFargo1,94,4
6,8061.58,84.62,52.4,32.22,8029.36,WellsFargo1,94,4
7,8029.36,84.62,52.19,32.43,7996.93,WellsFargo1,94,4
8,7996.93,84.62,51.98,32.64,7964.29,WellsFargo1,94,4
9,7964.29,84.62,51.77,32.85,7931.44,WellsFargo1,94,4
10,7931.44,84.62,51.55,33.07,7898.37,WellsFargo1,94,4
11,7898.37,84.62,51.34,33.28,7865.09,WellsFargo1,94,4
12,7865.09,84.62,51.12,33.5,7831.59,WellsFargo1,94,4
13,7831.59,84.62,50.91,33.71,7797.88,WellsFargo1,94,4
14,7797.88,84.62,50.69,33.93,7763.95,WellsFargo1,94,4
15,7763.95,102.05,50.47,51.58,7712.37,WellsFargo1,94,4
16,7712.37,2940.1,50.13,2889.97,4822.4,WellsFargo1,94,4
17,4822.4,2940.1,31.35,2908.75,1913.65,WellsFargo1,94,4
18,1913.65,2940.1,12.44,2927.66,-1014.01,WellsFargo1,94,4
0,4000.0,70.0,16.0,54.0,3946.0,testing,94,5
1,3946.0,70.0,15.78,54.22,3891.78,testing,94,5
2,3891.78,70.0,15.57,54.43,3837.35,testing,94,5
3,3837.35,70.0,15.35,54.65,3782.7,testing,94,5
4,3782.7,70.0,15.13,54.87,3727.83,testing,94,5
5,3727.83,70.0,14.91,55.09,3672.74,testing,94,5
6,3672.74,70.0,14.69,55.31,3617.43,testing,94,5
7,3617.43,70.0,14.47,55.53,3561.9,testing,94,5
8,3561.9,70.0,14.25,55.75,3506.15,testing,94,5
9,3506.15,70.0,14.02,55.98,3450.17,testing,94,5
10,3450.17,70.0,13.8,56.2,3393.97,testing,94,5
11,3393.97,70.0,13.58,56.42,3337.55,testing,94,5
12,3337.55,70.0,13.35,56.65,3280.9,testing,94,5
13,3280.9,70.0,13.12,56.88,3224.02,testing,94,5
14,3224.02,70.0,12.9,57.1,3166.92,testing,94,5
15,3166.92,70.0,12.67,57.33,3109.59,testing,94,5
16,3109.59,70.0,12.44,57.56,3052.03,testing,94,5
17,3052.03,70.0,12.21,57.79,2994.24,testing,94,5
18,2994.24,1084.01,11.98,1072.03,1922.21,testing,94,5
19,1922.21,3010.1,7.69,3002.41,-1080.2,testing,94,5
0,20000.0,1191.04,108.0,1083.04,18916.96,WellsFargo2,95,1
1,18916.96,1191.04,102.15,1088.89,17828.07,WellsFargo2,95,1
2,17828.07,1191.04,96.27,1094.77,16733.3,WellsFargo2,95,1
3,16733.3,1191.04,90.36,1100.68,15632.62,WellsFargo2,95,1
4,15632.62,1191.04,84.42,1106.62,14526.0,WellsFargo2,95,1
5,14526.0,1191.04,78.44,1112.6,13413.4,WellsFargo2,95,1
6,13413.4,1191.04,72.43,1118.61,12294.79,WellsFargo2,95,1
7,12294.79,1191.04,66.39,1124.65,11170.14,WellsFargo2,95,1
8,11170.14,1191.04,60.32,1130.72,10039.42,WellsFargo2,95,1
9,10039.42,1191.04,54.21,1136.83,8902.59,WellsFargo2,95,1
10,8902.59,1191.04,48.07,1142.97,7759.62,WellsFargo2,95,1
11,7759.62,1191.04,41.9,1149.14,6610.48,WellsFargo2,95,1
12,6610.48,1191.04,35.7,1155.34,5455.14,WellsFargo2,95,1
13,5455.14,1191.04,29.46,1161.58,4293.56,WellsFargo2,95,1
14,4293.56,1191.04,23.19,1167.85,3125.71,WellsFargo2,95,1
15,3125.71,1191.04,16.88,1174.16,1951.55,WellsFargo2,95,1
16,1951.55,1191.04,10.54,1180.5,771.05,WellsFargo2,95,1
17,771.05,1191.04,4.16,1186.88,-415.83,WellsFargo2,95,1
0,180000.0,1331.44,594.0,737.44,179262.56,mortgage,95,2
1,179262.56,1331.44,591.57,739.87,178522.69,mortgage,95,2
2,178522.69,1331.44,589.12,742.32,177780.37,mortgage,95,2
3,177780.37,1331.44,586.68,744.76,177035.61,mortgage,95,2
4,177035.61,1331.44,584.22,747.22,176288.39,mortgage,95,2
5,176288.39,1331.44,581.75,749.69,175538.7,mortgage,95,2
6,175538.7,1331.44,579.28,752.16,174786.54,mortgage,95,2
7,174786.54,1331.44,576.8,754.64,174031.9,mortgage,95,2
8,174031.9,1331.44,574.31,757.13,173274.77,mortgage,95,2
9,173274.77,1331.44,571.81,759.63,172515.14,mortgage,95,2
10,172515.14,1331.44,569.3,762.14,171753.0,mortgage,95,2
11,171753.0,1331.44,566.78,764.66,170988.34,mortgage,95,2
12,170988.34,1331.44,564.26,767.18,170221.16,mortgage,95,2
13,170221.16,1331.44,561.73,769.71,169451.45,mortgage,95,2
14,169451.45,1331.44,559.19,772.25,168679.2,mortgage,95,2
15,168679.2,1331.44,556.64,774.8,167904.4,mortgage,95,2
16,167904.4,1331.44,554.08,777.36,167127.04,mortgage,95,2
17,167127.04,1747.27,551.52,1195.75,165931.29,mortgage,95,2
18,165931.29,2522.48,547.57,1974.91,163956.38,mortgage,95,2
19,163956.38,2522.48,541.06,1981.42,161974.96,mortgage,95,2
20,161974.96,2522.48,534.52,1987.96,159987.0,mortgage,95,2
21,159987.0,2522.48,527.96,1994.52,157992.48,mortgage,95,2
22,157992.48,2522.48,521.38,2001.1,155991.38,mortgage,95,2
23,155991.38,2522.48,514.77,2007.71,153983.67,mortgage,95,2
24,153983.67,2522.48,508.15,2014.33,151969.34,mortgage,95,2
25,151969.34,2522.48,501.5,2020.98,149948.36,mortgage,95,2
26,149948.36,2522.48,494.83,2027.65,147920.71,mortgage,95,2
27,147920.71,2522.48,488.14,2034.34,145886.37,mortgage,95,2
28,145886.37,2522.48,481.43,2041.05,143845.32,mortgage,95,2
29,143845.32,2522.48,474.69,2047.79,141797.53,mortgage,95,2
30,141797.53,2522.48,467.93,2054.55,139742.98,mortgage,95,2
31,139742.98,2522.48,461.15,2061.33,137681.65,mortgage,95,2
32,137681.65,2522.48,454.35,2068.13,135613.52,mortgage,95,2
33,135613.52,2522.48,447.52,2074.96,133538.56,mortgage,95,2
34,133538.56,2522.48,440.68,2081.8,131456.76,mortgage,95,2
35,131456.76,2522.48,433.81,2088.67,129368.09,mortgage,95,2
36,129368.09,2522.48,426.91,2095.57,127272.52,mortgage,95,2
37,127272.52,2522.48,420.0,2102.48,125170.04,mortgage,95,2
38,125170.04,2522.48,413.06,2109.42,123060.62,mortgage,95,2
39,123060.62,2522.48,406.1,2116.38,120944.24,mortgage,95,2
40,120944.24,2522.48,399.12,2123.36,118820.88,mortgage,95,2
41,118820.88,2522.48,392.11,2130.37,116690.51,mortgage,95,2
42,116690.51,2522.48,385.08,2137.4,114553.11,mortgage,95,2
43,114553.11,2522.48,378.03,2144.45,112408.66,mortgage,95,2
44,112408.66,2522.48,370.95,2151.53,110257.13,mortgage,95,2
45,110257.13,2522.48,363.85,2158.63,108098.5,mortgage,95,2
46,108098.5,2522.48,356.73,2165.75,105932.75,mortgage,95,2
47,105932.75,2522.48,349.58,2172.9,103759.85,mortgage,95,2
48,103759.85,2522.48,342.41,2180.07,101579.78,mortgage,95,2
49,101579.78,2522.48,335.21,2187.27,99392.51,mortgage,95,2
50,99392.51,2522.48,328.0,2194.48,97198.03,mortgage,95,2
51,97198.03,2522.48,320.75,2201.73,94996.3,mortgage,95,2
52,94996.3,2522.48,313.49,2208.99,92787.31,mortgage,95,2
53,92787.31,2522.48,306.2,2216.28,90571.03,mortgage,95,2
54,90571.03,2522.48,298.88,2223.6,88347.43,mortgage,95,2
55,88347.43,2522.48,291.55,2230.93,86116.5,mortgage,95,2
56,86116.5,2522.48,284.18,2238.3,83878.2,mortgage,95,2
57,83878.2,2522.48,276.8,2245.68,81632.52,mortgage,95,2
58,81632.52,2522.48,269.39,2253.09,79379.43,mortgage,95,2
59,79379.43,2522.48,261.95,2260.53,77118.9,mortgage,95,2
60,77118.9,2522.48,254.49,2267.99,74850.91,mortgage,95,2
61,74850.91,2522.48,247.01,2275.47,72575.44,mortgage,95,2
62,72575.44,2522.48,239.5,2282.98,70292.46,mortgage,95,2
63,70292.46,2522.48,231.97,2290.51,68001.95,mortgage,95,2
64,68001.95,2522.48,224.41,2298.07,65703.88,mortgage,95,2
65,65703.88,2522.48,216.82,2305.66,63398.22,mortgage,95,2
66,63398.22,2522.48,209.21,2313.27,61084.95,mortgage,95,2
67,61084.95,2522.48,201.58,2320.9,58764.05,mortgage,95,2
68,58764.05,2522.48,193.92,2328.56,56435.49,mortgage,95,2
69,56435.49,2522.48,186.24,2336.24,54099.25,mortgage,95,2
70,54099.25,2522.48,178.53,2343.95,51755.3,mortgage,95,2
71,51755.3,2522.48,170.79,2351.69,49403.61,mortgage,95,2
72,49403.61,2522.48,163.03,2359.45,47044.16,mortgage,95,2
73,47044.16,2522.48,155.25,2367.23,44676.93,mortgage,95,2
74,44676.93,2522.48,147.43,2375.05,42301.88,mortgage,95,2
75,42301.88,2522.48,139.6,2382.88,39919.0,mortgage,95,2
76,39919.0,2522.48,131.73,2390.75,37528.25,mortgage,95,2
77,37528.25,2522.48,123.84,2398.64,35129.61,mortgage,95,2
78,35129.61,2522.48,115.93,2406.55,32723.06,mortgage,95,2
79,32723.06,2522.48,107.99,2414.49,30308.57,mortgage,95,2
80,30308.57,2522.48,100.02,2422.46,27886.11,mortgage,95,2
81,27886.11,2522.48,92.02,2430.46,25455.65,mortgage,95,2
82,25455.65,2522.48,84.0,2438.48,23017.17,mortgage,95,2
83,23017.17,2522.48,75.96,2446.52,20570.65,mortgage,95,2
84,20570.65,2522.48,67.88,2454.6,18116.05,mortgage,95,2
85,18116.05,2522.48,59.78,2462.7,15653.35,mortgage,95,2
86,15653.35,2522.48,51.66,2470.82,13182.53,mortgage,95,2
87,13182.53,2522.48,43.5,2478.98,10703.55,mortgage,95,2
88,10703.55,2522.48,35.32,2487.16,8216.39,mortgage,95,2
89,8216.39,2522.48,27.11,2495.37,5721.02,mortgage,95,2
90,5721.02,2522.48,18.88,2503.6,3217.42,mortgage,95,2
91,3217.42,2522.48,10.62,2511.86,705.56,mortgage,95,2
92,705.56,2522.48,2.33,2520.15,-1814.59,mortgage,95,2
0,8250.57,84.62,53.63,30.99,8219.58,WellsFargo1,95,3
1,8219.58,84.62,53.43,31.19,8188.39,WellsFargo1,95,3
2,8188.39,84.62,53.22,31.4,8156.99,WellsFargo1,95,3
3,8156.99,84.62,53.02,31.6,8125.39,WellsFargo1,95,3
4,8125.39,84.62,52.82,31.8,8093.59,WellsFargo1,95,3
5,8093.59,84.62,52.61,32.01,8061.58,WellsFargo1,95,3
6,8061.58,84.62,52.4,32.22,8029.36,WellsFargo1,95,3
7,8029.36,84.62,52.19,32.43,7996.93,WellsFargo1,95,3
8,7996.93,84.62,51.98,32.64,7964.29,WellsFargo1,95,3
9,7964.29,84.62,51.77,32.85,7931.44,WellsFargo1,95,3
10,7931.44,84.62,51.55,33.07,7898.37,WellsFargo1,95,3
11,7898.37,84.62,51.34,33.28,7865.09,WellsFargo1,95,3
12,7865.09,84.62,51.12,33.5,7831.59,WellsFargo1,95,3
13,7831.59,84.62,50.91,33.71,7797.88,WellsFargo1,95,3
14,7797.88,84.62,50.69,33.93,7763.95,WellsFargo1,95,3
15,7763.95,84.62,50.47,34.15,7729.8,WellsFargo1,95,3
16,7729.8,84.62,50.24,34.38,7695.42,WellsFargo1,95,3
17,7695.42,84.62,50.02,34.6,7660.82,WellsFargo1,95,3
18,7660.82,84.62,49.8,34.82,7626.0,WellsFargo1,95,3
19,7626.0,84.62,49.57,35.05,7590.95,WellsFargo1,95,3
20,7590.95,84.62,49.34,35.28,7555.67,WellsFargo1,95,3
21,7555.67,84.62,49.11,35.51,7520.16,WellsFargo1,95,3
22,7520.16,84.62,48.88,35.74,7484.42,WellsFargo1,95,3
23,7484.42,84.62,48.65,35.97,7448.45,WellsFargo1,95,3
24,7448.45,84.62,48.41,36.21,7412.24,WellsFargo1,95,3
25,7412.24,84.62,48.18,36.44,7375.8,WellsFargo1,95,3
26,7375.8,84.62,47.94,36.68,7339.12,WellsFargo1,95,3
27,7339.12,84.62,47.7,36.92,7302.2,WellsFargo1,95,3
28,7302.2,84.62,47.46,37.16,7265.04,WellsFargo1,95,3
29,7265.04,84.62,47.22,37.4,7227.64,WellsFargo1,95,3
30,7227.64,84.62,46.98,37.64,7190.0,WellsFargo1,95,3
31,7190.0,84.62,46.73,37.89,7152.11,WellsFargo1,95,3
32,7152.11,84.62,46.49,38.13,7113.98,WellsFargo1,95,3
33,7113.98,84.62,46.24,38.38,7075.6,WellsFargo1,95,3
34,7075.6,84.62,45.99,38.63,7036.97,WellsFargo1,95,3
35,7036.97,84.62,45.74,38.88,6998.09,WellsFargo1,95,3
36,6998.09,84.62,45.49,39.13,6958.96,WellsFargo1,95,3
37,6958.96,84.62,45.23,39.39,6919.57,WellsFargo1,95,3
38,6919.57,84.62,44.98,39.64,6879.93,WellsFargo1,95,3
39,6879.93,84.62,44.72,39.9,6840.03,WellsFargo1,95,3
40,6840.03,84.62,44.46,40.16,6799.87,WellsFargo1,95,3
41,6799.87,84.62,44.2,40.42,6759.45,WellsFargo1,95,3
42,6759.45,84.62,43.94,40.68,6718.77,WellsFargo1,95,3
43,6718.77,84.62,43.67,40.95,6677.82,WellsFargo1,95,3
44,6677.82,84.62,43.41,41.21,6636.61,WellsFargo1,95,3
45,6636.61,84.62,43.14,41.48,6595.13,WellsFargo1,95,3
46,6595.13,84.62,42.87,41.75,6553.38,WellsFargo1,95,3
47,6553.38,84.62,42.6,42.02,6511.36,WellsFargo1,95,3
48,6511.36,84.62,42.32,42.3,6469.06,WellsFargo1,95,3
49,6469.06,84.62,42.05,42.57,6426.49,WellsFargo1,95,3
50,6426.49,84.62,41.77,42.85,6383.64,WellsFargo1,95,3
51,6383.64,84.62,41.49,43.13,6340.51,WellsFargo1,95,3
52,6340.51,84.62,41.21,43.41,6297.1,WellsFargo1,95,3
53,6297.1,84.62,40.93,43.69,6253.41,WellsFargo1,95,3
54,6253.41,84.62,40.65,43.97,6209.44,WellsFargo1,95,3
55,6209.44,84.62,40.36,44.26,6165.18,WellsFargo1,95,3
56,6165.18,84.62,40.07,44.55,6120.63,WellsFargo1,95,3
57,6120.63,84.62,39.78,44.84,6075.79,WellsFargo1,95,3
58,6075.79,84.62,39.49,45.13,6030.66,WellsFargo1,95,3
59,6030.66,84.62,39.2,45.42,5985.24,WellsFargo1,95,3
60,5985.24,84.62,38.9,45.72,5939.52,WellsFargo1,95,3
61,5939.52,84.62,38.61,46.01,5893.51,WellsFargo1,95,3
62,5893.51,84.62,38.31,46.31,5847.2,WellsFargo1,95,3
63,5847.2,84.62,38.01,46.61,5800.59,WellsFargo1,95,3
64,5800.59,84.62,37.7,46.92,5753.67,WellsFargo1,95,3
65,5753.67,84.62,37.4,47.22,5706.45,WellsFargo1,95,3
66,5706.45,84.62,37.09,47.53,5658.92,WellsFargo1,95,3
67,5658.92,84.62,36.78,47.84,5611.08,WellsFargo1,95,3
68,5611.08,84.62,36.47,48.15,5562.93,WellsFargo1,95,3
69,5562.93,84.62,36.16,48.46,5514.47,WellsFargo1,95,3
70,5514.47,84.62,35.84,48.78,5465.69,WellsFargo1,95,3
71,5465.69,84.62,35.53,49.09,5416.6,WellsFargo1,95,3
72,5416.6,84.62,35.21,49.41,5367.19,WellsFargo1,95,3
73,5367.19,84.62,34.89,49.73,5317.46,WellsFargo1,95,3
74,5317.46,84.62,34.56,50.06,5267.4,WellsFargo1,95,3
75,5267.4,84.62,34.24,50.38,5217.02,WellsFargo1,95,3
76,5217.02,84.62,33.91,50.71,5166.31,WellsFargo1,95,3
77,5166.31,84.62,33.58,51.04,5115.27,WellsFargo1,95,3
78,5115.27,84.62,33.25,51.37,5063.9,WellsFargo1,95,3
79,5063.9,84.62,32.92,51.7,5012.2,WellsFargo1,95,3
80,5012.2,84.62,32.58,52.04,4960.16,WellsFargo1,95,3
81,4960.16,84.62,32.24,52.38,4907.78,WellsFargo1,95,3
82,4907.78,84.62,31.9,52.72,4855.06,WellsFargo1,95,3
83,4855.06,84.62,31.56,53.06,4802.0,WellsFargo1,95,3
84,4802.0,84.62,31.21,53.41,4748.59,WellsFargo1,95,3
85,4748.59,84.62,30.87,53.75,4694.84,WellsFargo1,95,3
86,4694.84,84.62,30.52,54.1,4640.74,WellsFargo1,95,3
87,4640.74,84.62,30.16,54.46,4586.28,WellsFargo1,95,3
88,4586.28,84.62,29.81,54.81,4531.47,WellsFargo1,95,3
89,4531.47,84.62,29.45,55.17,4476.3,WellsFargo1,95,3
90,4476.3,84.62,29.1,55.52,4420.78,WellsFargo1,95,3
91,4420.78,84.62,28.74,55.88,4364.9,WellsFargo1,95,3
92,4364.9,1899.21,28.37,1870.84,2494.06,WellsFargo1,95,3
93,2494.06,2607.1,16.21,2590.89,-96.83,WellsFargo1,95,3
0,4000.0,70.0,16.0,54.0,3946.0,testing,95,4
1,3946.0,70.0,15.78,54.22,3891.78,testing,95,4
2,3891.78,70.0,15.57,54.43,3837.35,testing,95,4
3,3837.35,70.0,15.35,54.65,3782.7,testing,95,4
4,3782.7,70.0,15.13,54.87,3727.83,testing,95,4
5,3727.83,70.0,14.91,55.09,3672.74,testing,95,4
6,3672.74,70.0,14.69,55.31,3617.43,testing,95,4
7,3617.43,70.0,14.47,55.53,3561.9,testing,95,4
8,3561.9,70.0,14.25,55.75,3506.15,testing,95,4
9,3506.15,70.0,14.02,55.98,3450.17,testing,95,4
10,3450.17,70.0,13.8,56.2,3393.97,testing,95,4
11,3393.97,70.0,13.58,56.42,3337.55,testing,95,4
12,3337.55,70.0,13.35,56.65,3280.9,testing,95,4
13,3280.9,70.0,13.12,56.88,3224.02,testing,95,4
14,3224.02,70.0,12.9,57.1,3166.92,testing,95,4
15,3166.92,70.0,12.67,57.33,3109.59,testing,95,4
16,3109.59,70.0,12.44,57.56,3052.03,testing,95,4
17,3052.03,70.0,12.21,57.79,2994.24,testing,95,4
18,2994.24,70.0,11.98,58.02,2936.22,testing,95,4
19,2936.22,70.0,11.74,58.26,2877.96,testing,95,4
20,2877.96,70.0,11.51,58.49,2819.47,testing,95,4
21,2819.47,70.0,11.28,58.72,2760.75,testing,95,4
22,2760.75,70.0,11.04,58.96,2701.79,testing,95,4
23,2701.79,70.0,10.81,59.19,2642.6,testing,95,4
24,2642.6,70.0,10.57,59.43,2583.17,testing,95,4
25,2583.17,70.0,10.33,59.67,2523.5,testing,95,4
26,2523.5,70.0,10.09,59.91,2463.59,testing,95,4
27,2463.59,70.0,9.85,60.15,2403.44,testing,95,4
28,2403.44,70.0,9.61,60.39,2343.05,testing,95,4
29,2343.05,70.0,9.37,60.63,2282.42,testing,95,4
30,2282.42,70.0,9.13,60.87,2221.55,testing,95,4
31,2221.55,70.0,8.89,61.11,2160.44,testing,95,4
32,2160.44,70.0,8.64,61.36,2099.08,testing,95,4
33,2099.08,70.0,8.4,61.6,2037.48,testing,95,4
34,2037.48,70.0,8.15,61.85,1975.63,testing,95,4
35,1975.63,70.0,7.9,62.1,1913.53,testing,95,4
36,1913.53,70.0,7.65,62.35,1851.18,testing,95,4
37,1851.18,70.0,7.4,62.6,1788.58,testing,95,4
38,1788.58,70.0,7.15,62.85,1725.73,testing,95,4
39,1725.73,70.0,6.9,63.1,1662.63,testing,95,4
40,1662.63,70.0,6.65,63.35,1599.28,testing,95,4
41,1599.28,70.0,6.4,63.6,1535.68,testing,95,4
42,1535.68,70.0,6.14,63.86,1471.82,testing,95,4
43,1471.82,70.0,5.89,64.11,1407.71,testing,95,4
44,1407.71,70.0,5.63,64.37,1343.34,testing,95,4
45,1343.34,70.0,5.37,64.63,1278.71,testing,95,4
46,1278.71,70.0,5.11,64.89,1213.82,testing,95,4
47,1213.82,70.0,4.86,65.14,1148.68,testing,95,4
48,1148.68,70.0,4.59,65.41,1083.27,testing,95,4
49,1083.27,70.0,4.33,65.67,1017.6,testing,95,4
50,1017.6,70.0,4.07,65.93,951.67,testing,95,4
51,951.67,70.0,3.81,66.19,885.48,testing,95,4
52,885.48,70.0,3.54,66.46,819.02,testing,95,4
53,819.02,70.0,3.28,66.72,752.3,testing,95,4
54,752.3,70.0,3.01,66.99,685.31,testing,95,4
55,685.31,70.0,2.74,67.26,618.05,testing,95,4
56,618.05,70.0,2.47,67.53,550.52,testing,95,4
57,550.52,70.0,2.2,67.8,482.72,testing,95,4
58,482.72,70.0,1.93,68.07,414.65,testing,95,4
59,414.65,70.0,1.66,68.34,346.31,testing,95,4
60,346.31,70.0,1.39,68.61,277.7,testing,95,4
61,277.7,70.0,1.11,68.89,208.81,testing,95,4
62,208.81,70.0,0.84,69.16,139.65,testing,95,4
63,139.65,70.0,0.56,69.44,70.21,testing,95,4
64,70.21,70.0,0.28,69.72,0.49,testing,95,4
65,0.49,70.0,0.0,70.0,-69.51,testing,95,4
0,5000.0,333.0,36.0,297.0,4703.0,Car,95,5
1,4703.0,333.0,33.86,299.14,4403.86,Car,95,5
2,4403.86,333.0,31.71,301.29,4102.57,Car,95,5
3,4102.57,333.0,29.54,303.46,3799.11,Car,95,5
4,3799.11,333.0,27.35,305.65,3493.46,Car,95,5
5,3493.46,333.0,25.15,307.85,3185.61,Car,95,5
6,3185.61,333.0,22.94,310.06,2875.55,Car,95,5
7,2875.55,333.0,20.7,312.3,2563.25,Car,95,5
8,2563.25,333.0,18.46,314.54,2248.71,Car,95,5
9,2248.71,333.0,16.19,316.81,1931.9,Car,95,5
10,1931.9,333.0,13.91,319.09,1612.81,Car,95,5
11,1612.81,333.0,11.61,321.39,1291.42,Car,95,5
12,1291.42,333.0,9.3,323.7,967.72,Car,95,5
13,967.72,333.0,6.97,326.03,641.69,Car,95,5
14,641.69,333.0,4.62,328.38,313.31,Car,95,5
15,313.31,333.0,2.26,330.74,-17.43,Car,95,5
0,20000.0,1191.04,108.0,1083.04,18916.96,WellsFargo2,96,1
1,18916.96,1191.04,102.15,1088.89,17828.07,WellsFargo2,96,1
2,17828.07,1191.04,96.27,1094.77,16733.3,WellsFargo2,96,1
3,16733.3,1191.04,90.36,1100.68,15632.62,WellsFargo2,96,1
4,15632.62,1191.04,84.42,1106.62,14526.0,WellsFargo2,96,1
5,14526.0,1191.04,78.44,1112.6,13413.4,WellsFargo2,96,1
6,13413.4,1191.04,72.43,1118.61,12294.79,WellsFargo2,96,1
7,12294.79,1191.04,66.39,1124.65,11170.14,WellsFargo2,96,1
8,11170.14,1191.04,60.32,1130.72,10039.42,WellsFargo2,96,1
9,10039.42,1191.04,54.21,1136.83,8902.59,WellsFargo2,96,1
10,8902.59,1191.04,48.07,1142.97,7759.62,WellsFargo2,96,1
11,7759.62,1191.04,41.9,1149.14,6610.48,WellsFargo2,96,1
12,6610.48,1191.04,35.7,1155.34,5455.14,WellsFargo2,96,1
13,5455.14,1191.04,29.46,1161.58,4293.56,WellsFargo2,96,1
14,4293.56,1191.04,23.19,1167.85,3125.71,WellsFargo2,96,1
15,3125.71,1191.04,16.88,1174.16,1951.55,WellsFargo2,96,1
16,1951.55,1191.04,10.54,1180.5,771.05,WellsFargo2,96,1
17,771.05,1191.04,4.16,1186.88,-415.83,WellsFargo2,96,1
0,180000.0,1331.44,594.0,737.44,179262.56,mortgage,96,2
1,179262.56,1331.44,591.57,739.87,178522.69,mortgage,96,2
2,178522.69,1331.44,589.12,742.32,177780.37,mortgage,96,2
3,177780.37,1331.44,586.68,744.76,177035.61,mortgage,96,2
4,177035.61,1331.44,584.22,747.22,176288.39,mortgage,96,2
5,176288.39,1331.44,581.75,749.69,175538.7,mortgage,96,2
6,175538.7,1331.44,579.28,752.16,174786.54,mortgage,96,2
7,174786.54,1331.44,576.8,754.64,174031.9,mortgage,96,2
8,174031.9,1331.44,574.31,757.13,173274.77,mortgage,96,2
9,173274.77,1331.44,571.81,759.63,172515.14,mortgage,96,2
10,172515.14,1331.44,569.3,762.14,171753.0,mortgage,96,2
11,171753.0,1331.44,566.78,764.66,170988.34,mortgage,96,2
12,170988.34,1331.44,564.26,767.18,170221.16,mortgage,96,2
13,170221.16,1331.44,561.73,769.71,169451.45,mortgage,96,2
14,169451.45,1331.44,559.19,772.25,168679.2,mortgage,96,2
15,168679.2,1331.44,556.64,774.8,167904.4,mortgage,96,2
16,167904.4,1331.44,554.08,777.36,167127.04,mortgage,96,2
17,167127.04,1747.27,551.52,1195.75,165931.29,mortgage,96,2
18,165931.29,2522.48,547.57,1974.91,163956.38,mortgage,96,2
19,163956.38,2522.48,541.06,1981.42,161974.96,mortgage,96,2
20,161974.96,2522.48,534.52,1987.96,159987.0,mortgage,96,2
21,159987.0,2522.48,527.96,1994.52,157992.48,mortgage,96,2
22,157992.48,2522.48,521.38,2001.1,155991.38,mortgage,96,2
23,155991.38,2522.48,514.77,2007.71,153983.67,mortgage,96,2
24,153983.67,2522.48,508.15,2014.33,151969.34,mortgage,96,2
25,151969.34,2522.48,501.5,2020.98,149948.36,mortgage,96,2
26,149948.36,2522.48,494.83,2027.65,147920.71,mortgage,96,2
27,147920.71,2522.48,488.14,2034.34,145886.37,mortgage,96,2
28,145886.37,2522.48,481.43,2041.05,143845.32,mortgage,96,2
29,143845.32,2522.48,474.69,2047.79,141797.53,mortgage,96,2
30,141797.53,2522.48,467.93,2054.55,139742.98,mortgage,96,2
31,139742.98,2522.48,461.15,2061.33,137681.65,mortgage,96,2
32,137681.65,2522.48,454.35,2068.13,135613.52,mortgage,96,2
33,135613.52,2522.48,447.52,2074.96,133538.56,mortgage,96,2
34,133538.56,2522.48,440.68,2081.8,131456.76,mortgage,96,2
35,131456.76,2522.48,433.81,2088.67,129368.09,mortgage,96,2
36,129368.09,2522.48,426.91,2095.57,127272.52,mortgage,96,2
37,127272.52,2522.48,420.0,2102.48,125170.04,mortgage,96,2
38,125170.04,2522.48,413.06,2109.42,123060.62,mortgage,96,2
39,123060.62,2522.48,406.1,2116.38,120944.24,mortgage,96,2
40,120944.24,2522.48,399.12,2123.36,118820.88,mortgage,96,2
41,118820.88,2522.48,392.11,2130.37,116690.51,mortgage,96,2
42,116690.51,2522.48,385.08,2137.4,114553.11,mortgage,96,2
43,114553.11,2522.48,378.03,2144.45,112408.66,mortgage,96,2
44,112408.66,2522.48,370.95,2151.53,110257.13,mortgage,96,2
45,110257.13,2522.48,363.85,2158.63,108098.5,mortgage,96,2
46,108098.5,2522.48,356.73,2165.75,105932.75,mortgage,96,2
47,105932.75,2522.48,349.58,2172.9,103759.85,mortgage,96,2
48,103759.85,2522.48,342.41,2180.07,101579.78,mortgage,96,2
49,101579.78,2522.48,335.21,2187.27,99392.51,mortgage,96,2
50,99392.51,2522.48,328.0,2194.48,97198.03,mortgage,96,2
51,97198.03,2522.48,320.75,2201.73,94996.3,mortgage,96,2
52,94996.3,2522.48,313.49,2208.99,92787.31,mortgage,96,2
53,92787.31,2522.48,306.2,2216.28,90571.03,mortgage,96,2
54,90571.03,2522.48,298.88,2223.6,88347.43,mortgage,96,2
55,88347.43,2522.48,291.55,2230.93,86116.5,mortgage,96,2
56,86116.5,2522.48,284.18,2238.3,83878.2,mortgage,96,2
57,83878.2,2522.48,276.8,2245.68,81632.52,mortgage,96,2
58,81632.52,2522.48,269.39,2253.09,79379.43,mortgage,96,2
59,79379.43,2522.48,261.95,2260.53,77118.9,mortgage,96,2
60,77118.9,2522.48,254.49,2267.99,74850.91,mortgage,96,2
61,74850.91,2522.48,247.01,2275.47,72575.44,mortgage,96,2
62,72575.44,2522.48,239.5,2282.98,70292.46,mortgage,96,2
63,70292.46,2522.48,231.97,2290.51,68001.95,mortgage,96,2
64,68001.95,2522.48,224.41,2298.07,65703.88,mortgage,96,2
65,65703.88,2522.48,216.82,2305.66,63398.22,mortgage,96,2
66,63398.22,2522.48,209.21,2313.27,61084.95,mortgage,96,2
67,61084.95,2522.48,201.58,2320.9,58764.05,mortgage,96,2
68,58764.05,2522.48,193.92,2328.56,56435.49,mortgage,96,2
69,56435.49,2522.48,186.24,2336.24,54099.25,mortgage,96,2
70,54099.25,2522.48,178.53,2343.95,51755.3,mortgage,96,2
71,51755.3,2522.48,170.79,2351.69,49403.61,mortgage,96,2
72,49403.61,2522.48,163.03,2359.45,47044.16,mortgage,96,2
73,47044.16,2522.48,155.25,2367.23,44676.93,mortgage,96,2
74,44676.93,2522.48,147.43,2375.05,42301.88,mortgage,96,2
75,42301.88,2522.48,139.6,2382.88,39919.0,mortgage,96,2
76,39919.0,2522.48,131.73,2390.75,37528.25,mortgage,96,2
77,37528.25,2522.48,123.84,2398.64,35129.61,mortgage,96,2
78,35129.61,2522.48,115.93,2406.55,32723.06,mortgage,96,2
79,32723.06,2522.48,107.99,2414.49,30308.57,mortgage,96,2
80,30308.57,2522.48,100.02,2422.46,27886.11,mortgage,96,2
81,27886.11,2522.48,92.02,2430.46,25455.65,mortgage,96,2
82,25455.65,2522.48,84.0,2438.48,23017.17,mortgage,96,2
83,23017.17,2522.48,75.96,2446.52,20570.65,mortgage,96,2
84,20570.65,2522.48,67.88,2454.6,18116.05,mortgage,96,2
85,18116.05,2522.48,59.78,2462.7,15653.35,mortgage,96,2
86,15653.35,2522.48,51.66,2470.82,13182.53,mortgage,96,2
87,13182.53,2522.48,43.5,2478.98,10703.55,mortgage,96,2
88,10703.55,2522.48,35.32,2487.16,8216.39,mortgage,96,2
89,8216.39,2522.48,27.11,2495.37,5721.02,mortgage,96,2
90,5721.02,2522.48,18.88,2503.6,3217.42,mortgage,96,2
91,3217.42,2522.48,10.62,2511.86,705.56,mortgage,96,2
92,705.56,2522.48,2.33,2520.15,-1814.59,mortgage,96,2
0,8250.57,84.62,53.63,30.99,8219.58,WellsFargo1,96,3
1,8219.58,84.62,53.43,31.19,8188.39,WellsFargo1,96,3
2,8188.39,84.62,53.22,31.4,8156.99,WellsFargo1,96,3
3,8156.99,84.62,53.02,31.6,8125.39,WellsFargo1,96,3
4,8125.39,84.62,52.82,31.8,8093.59,WellsFargo1,96,3
5,8093.59,84.62,52.61,32.01,8061.58,WellsFargo1,96,3
6,8061.58,84.62,52.4,32.22,8029.36,WellsFargo1,96,3
7,8029.36,84.62,52.19,32.43,7996.93,WellsFargo1,96,3
8,7996.93,84.62,51.98,32.64,7964.29,WellsFargo1,96,3
9,7964.29,84.62,51.77,32.85,7931.44,WellsFargo1,96,3
10,7931.44,84.62,51.55,33.07,7898.37,WellsFargo1,96,3
11,7898.37,84.62,51.34,33.28,7865.09,WellsFargo1,96,3
12,7865.09,84.62,51.12,33.5,7831.59,WellsFargo1,96,3
13,7831.59,84.62,50.91,33.71,7797.88,WellsFargo1,96,3
14,7797.88,84.62,50.69,33.93,7763.95,WellsFargo1,96,3
15,7763.95,84.62,50.47,34.15,7729.8,WellsFargo1,96,3
16,7729.8,84.62,50.24,34.38,7695.42,WellsFargo1,96,3
17,7695.42,84.62,50.02,34.6,7660.82,WellsFargo1,96,3
18,7660.82,84.62,49.8,34.82,7626.0,WellsFargo1,96,3
19,7626.0,84.62,49.57,35.05,7590.95,WellsFargo1,96,3
20,7590.95,84.62,49.34,35.28,7555.67,WellsFargo1,96,3
21,7555.67,84.62,49.11,35.51,7520.16,WellsFargo1,96,3
22,7520.16,84.62,48.88,35.74,7484.42,WellsFargo1,96,3
23,7484.42,84.62,48.65,35.97,7448.45,WellsFargo1,96,3
24,7448.45,84.62,48.41,36.21,7412.24,WellsFargo1,96,3
25,7412.24,84.62,48.18,36.44,7375.8,WellsFargo1,96,3
26,7375.8,84.62,47.94,36.68,7339.12,WellsFargo1,96,3
27,7339.12,84.62,47.7,36.92,7302.2,WellsFargo1,96,3
28,7302.2,84.62,47.46,37.16,7265.04,WellsFargo1,96,3
29,7265.04,84.62,47.22,37.4,7227.64,WellsFargo1,96,3
30,7227.64,84.62,46.98,37.64,7190.0,WellsFargo1,96,3
31,7190.0,84.62,46.73,37.89,7152.11,WellsFargo1,96,3
32,7152.11,84.62,46.49,38.13,7113.98,WellsFargo1,96,3
33,7113.98,84.62,46.24,38.38,7075.6,WellsFargo1,96,3
34,7075.6,84.62,45.99,38.63,7036.97,WellsFargo1,96,3
35,7036.97,84.62,45.74,38.88,6998.09,WellsFargo1,96,3
36,6998.09,84.62,45.49,39.13,6958.96,WellsFargo1,96,3
37,6958.96,84.62,45.23,39.39,6919.57,WellsFargo1,96,3
38,6919.57,84.62,44.98,39.64,6879.93,WellsFargo1,96,3
39,6879.93,84.62,44.72,39.9,6840.03,WellsFargo1,96,3
40,6840.03,84.62,44.46,40.16,6799.87,WellsFargo1,96,3
41,6799.87,84.62,44.2,40.42,6759.45,WellsFargo1,96,3
42,6759.45,84.62,43.94,40.68,6718.77,WellsFargo1,96,3
43,6718.77,84.62,43.67,40.95,6677.82,WellsFargo1,96,3
44,6677.82,84.62,43.41,41.21,6636.61,WellsFargo1,96,3
45,6636.61,84.62,43.14,41.48,6595.13,WellsFargo1,96,3
46,6595.13,84.62,42.87,41.75,6553.38,WellsFargo1,96,3
47,6553.38,84.62,42.6,42.02,6511.36,WellsFargo1,96,3
48,6511.36,84.62,42.32,42.3,6469.06,WellsFargo1,96,3
49,6469.06,84.62,42.05,42.57,6426.49,WellsFargo1,96,3
50,6426.49,84.62,41.77,42.85,6383.64,WellsFargo1,96,3
51,6383.64,84.62,41.49,43.13,6340.51,WellsFargo1,96,3
52,6340.51,84.62,41.21,43.41,6297.1,WellsFargo1,96,3
53,6297.1,84.62,40.93,43.69,6253.41,WellsFargo1,96,3
54,6253.41,84.62,40.65,43.97,6209.44,WellsFargo1,96,3
55,6209.44,84.62,40.36,44.26,6165.18,WellsFargo1,96,3
56,6165.18,84.62,40.07,44.55,6120.63,WellsFargo1,96,3
57,6120.63,84.62,39.78,44.84,6075.79,WellsFargo1,96,3
58,6075.79,84.62,39.49,45.13,6030.66,WellsFargo1,96,3
59,6030.66,84.62,39.2,45.42,5985.24,WellsFargo1,96,3
60,5985.24,84.62,38.9,45.72,5939.52,WellsFargo1,96,3
61,5939.52,84.62,38.61,46.01,5893.51,WellsFargo1,96,3
62,5893.51,84.62,38.31,46.31,5847.2,WellsFargo1,96,3
63,5847.2,84.62,38.01,46.61,5800.59,WellsFargo1,96,3
64,5800.59,84.62,37.7,46.92,5753.67,WellsFargo1,96,3
65,5753.67,84.62,37.4,47.22,5706.45,WellsFargo1,96,3
66,5706.45,84.62,37.09,47.53,5658.92,WellsFargo1,96,3
67,5658.92,84.62,36.78,47.84,5611.08,WellsFargo1,96,3
68,5611.08,84.62,36.47,48.15,5562.93,WellsFargo1,96,3
69,5562.93,84.62,36.16,48.46,5514.47,WellsFargo1,96,3
70,5514.47,84.62,35.84,48.78,5465.69,WellsFargo1,96,3
71,5465.69,84.62,35.53,49.09,5416.6,WellsFargo1,96,3
72,5416.6,84.62,35.21,49.41,5367.19,WellsFargo1,96,3
73,5367.19,84.62,34.89,49.73,5317.46,WellsFargo1,96,3
74,5317.46,84.62,34.56,50.06,5267.4,WellsFargo1,96,3
75,5267.4,84.62,34.24,50.38,5217.02,WellsFargo1,96,3
76,5217.02,84.62,33.91,50.71,5166.31,WellsFargo1,96,3
77,5166.31,84.62,33.58,51.04,5115.27,WellsFargo1,96,3
78,5115.27,84.62,33.25,51.37,5063.9,WellsFargo1,96,3
79,5063.9,84.62,32.92,51.7,5012.2,WellsFargo1,96,3
80,5012.2,84.62,32.58,52.04,4960.16,WellsFargo1,96,3
81,4960.16,84.62,32.24,52.38,4907.78,WellsFargo1,96,3
82,4907.78,84.62,31.9,52.72,4855.06,WellsFargo1,96,3
83,4855.06,84.62,31.56,53.06,4802.0,WellsFargo1,96,3
84,4802.0,84.62,31.21,53.41,4748.59,WellsFargo1,96,3
85,4748.59,84.62,30.87,53.75,4694.84,WellsFargo1,96,3
86,4694.84,84.62,30.52,54.1,4640.74,WellsFargo1,96,3
87,4640.74,84.62,30.16,54.46,4586.28,WellsFargo1,96,3
88,4586.28,84.62,29.81,54.81,4531.47,WellsFargo1,96,3
89,4531.47,84.62,29.45,55.17,4476.3,WellsFargo1,96,3
90,4476.3,84.62,29.1,55.52,4420.78,WellsFargo1,96,3
91,4420.78,84.62,28.74,55.88,4364.9,WellsFargo1,96,3
92,4364.9,1899.21,28.37,1870.84,2494.06,WellsFargo1,96,3
93,2494.06,2607.1,16.21,2590.89,-96.83,WellsFargo1,96,3
0,5000.0,333.0,36.0,297.0,4703.0,Car,96,4
1,4703.0,333.0,33.86,299.14,4403.86,Car,96,4
2,4403.86,333.0,31.71,301.29,4102.57,Car,96,4
3,4102.57,333.0,29.54,303.46,3799.11,Car,96,4
4,3799.11,333.0,27.35,305.65,3493.46,Car,96,4
5,3493.46,333.0,25.15,307.85,3185.61,Car,96,4
6,3185.61,333.0,22.94,310.06,2875.55,Car,96,4
7,2875.55,333.0,20.7,312.3,2563.25,Car,96,4
8,2563.25,333.0,18.46,314.54,2248.71,Car,96,4
9,2248.71,333.0,16.19,316.81,1931.9,Car,96,4
10,1931.9,333.0,13.91,319.09,1612.81,Car,96,4
11,1612.81,333.0,11.61,321.39,1291.42,Car,96,4
12,1291.42,333.0,9.3,323.7,967.72,Car,96,4
13,967.72,333.0,6.97,326.03,641.69,Car,96,4
14,641.69,333.0,4.62,328.38,313.31,Car,96,4
15,313.31,333.0,2.26,330.74,-17.43,Car,96,4
0,4000.0,70.0,16.0,54.0,3946.0,testing,96,5
1,3946.0,70.0,15.78,54.22,3891.78,testing,96,5
2,3891.78,70.0,15.57,54.43,3837.35,testing,96,5
3,3837.35,70.0,15.35,54.65,3782.7,testing,96,5
4,3782.7,70.0,15.13,54.87,3727.83,testing,96,5
5,3727.83,70.0,14.91,55.09,3672.74,testing,96,5
6,3672.74,70.0,14.69,55.31,3617.43,testing,96,5
7,3617.43,70.0,14.47,55.53,3561.9,testing,96,5
8,3561.9,70.0,14.25,55.75,3506.15,testing,96,5
9,3506.15,70.0,14.02,55.98,3450.17,testing,96,5
10,3450.17,70.0,13.8,56.2,3393.97,testing,96,5
11,3393.97,70.0,13.58,56.42,3337.55,testing,96,5
12,3337.55,70.0,13.35,56.65,3280.9,testing,96,5
13,3280.9,70.0,13.12,56.88,3224.02,testing,96,5
14,3224.02,70.0,12.9,57.1,3166.92,testing,96,5
15,3166.92,87.43,12.67,74.76,3092.16,testing,96,5
16,3092.16,3010.1,12.37,2997.73,94.43,testing,96,5
17,94.43,3010.1,0.38,3009.72,-2915.29,testing,96,5
0,180000.0,2331.44,594.0,1737.44,178262.56,mortgage,97,1
1,178262.56,2331.44,588.27,1743.17,176519.39,mortgage,97,1
2,176519.39,2331.44,582.51,1748.93,174770.46,mortgage,97,1
3,174770.46,2331.44,576.74,1754.7,173015.76,mortgage,97,1
4,173015.76,2331.44,570.95,1760.49,171255.27,mortgage,97,1
5,171255.27,2331.44,565.14,1766.3,169488.97,mortgage,97,1
6,169488.97,2331.44,559.31,1772.13,167716.84,mortgage,97,1
7,167716.84,2331.44,553.47,1777.97,165938.87,mortgage,97,1
8,165938.87,2331.44,547.6,1783.84,164155.03,mortgage,97,1
9,164155.03,2331.44,541.71,1789.73,162365.3,mortgage,97,1
10,162365.3,2331.44,535.81,1795.63,160569.67,mortgage,97,1
11,160569.67,2331.44,529.88,1801.56,158768.11,mortgage,97,1
12,158768.11,2331.44,523.93,1807.51,156960.6,mortgage,97,1
13,156960.6,2331.44,517.97,1813.47,155147.13,mortgage,97,1
14,155147.13,2331.44,511.99,1819.45,153327.68,mortgage,97,1
15,153327.68,2331.44,505.98,1825.46,151502.22,mortgage,97,1
16,151502.22,2331.44,499.96,1831.48,149670.74,mortgage,97,1
17,149670.74,2331.44,493.91,1837.53,147833.21,mortgage,97,1
18,147833.21,2331.44,487.85,1843.59,145989.62,mortgage,97,1
19,145989.62,2331.44,481.77,1849.67,144139.95,mortgage,97,1
20,144139.95,2331.44,475.66,1855.78,142284.17,mortgage,97,1
21,142284.17,2331.44,469.54,1861.9,140422.27,mortgage,97,1
22,140422.27,2331.44,463.39,1868.05,138554.22,mortgage,97,1
23,138554.22,2331.44,457.23,1874.21,136680.01,mortgage,97,1
24,136680.01,2331.44,451.04,1880.4,134799.61,mortgage,97,1
25,134799.61,2331.44,444.84,1886.6,132913.01,mortgage,97,1
26,132913.01,2331.44,438.61,1892.83,131020.18,mortgage,97,1
27,131020.18,2331.44,432.37,1899.07,129121.11,mortgage,97,1
28,129121.11,2331.44,426.1,1905.34,127215.77,mortgage,97,1
29,127215.77,2331.44,419.81,1911.63,125304.14,mortgage,97,1
30,125304.14,2331.44,413.5,1917.94,123386.2,mortgage,97,1
31,123386.2,2331.44,407.17,1924.27,121461.93,mortgage,97,1
32,121461.93,2331.44,400.82,1930.62,119531.31,mortgage,97,1
33,119531.31,2331.44,394.45,1936.99,117594.32,mortgage,97,1
34,117594.32,2331.44,388.06,1943.38,115650.94,mortgage,97,1
35,115650.94,2331.44,381.65,1949.79,113701.15,mortgage,97,1
36,113701.15,2331.44,375.21,1956.23,111744.92,mortgage,97,1
37,111744.92,2331.44,368.76,1962.68,109782.24,mortgage,97,1
38,109782.24,2331.44,362.28,1969.16,107813.08,mortgage,97,1
39,107813.08,2331.44,355.78,1975.66,105837.42,mortgage,97,1
40,105837.42,2331.44,349.26,1982.18,103855.24,mortgage,97,1
41,103855.24,2331.44,342.72,1988.72,101866.52,mortgage,97,1
42,101866.52,2331.44,336.16,1995.28,99871.24,mortgage,97,1
43,99871.24,2331.44,329.58,2001.86,97869.38,mortgage,97,1
44,97869.38,2331.44,322.97,2008.47,95860.91,mortgage,97,1
45,95860.91,2331.44,316.34,2015.1,93845.81,mortgage,97,1
46,93845.81,2331.44,309.69,2021.75,91824.06,mortgage,97,1
47,91824.06,2331.44,303.02,2028.42,89795.64,mortgage,97,1
48,89795.64,2331.44,296.33,2035.11,87760.53,mortgage,97,1
49,87760.53,2331.44,289.61,2041.83,85718.7,mortgage,97,1
50,85718.7,2331.44,282.87,2048.57,83670.13,mortgage,97,1
51,83670.13,2331.44,276.11,2055.33,81614.8,mortgage,97,1
52,81614.8,2331.44,269.33,2062.11,79552.69,mortgage,97,1
53,79552.69,2331.44,262.52,2068.92,77483.77,mortgage,97,1
54,77483.77,2331.44,255.7,2075.74,75408.03,mortgage,97,1
55,75408.03,2331.44,248.85,2082.59,73325.44,mortgage,97,1
56,73325.44,2331.44,241.97,2089.47,71235.97,mortgage,97,1
57,71235.97,2331.44,235.08,2096.36,69139.61,mortgage,97,1
58,69139.61,2331.44,228.16,2103.28,67036.33,mortgage,97,1
59,67036.33,2331.44,221.22,2110.22,64926.11,mortgage,97,1
60,64926.11,2331.44,214.26,2117.18,62808.93,mortgage,97,1
61,62808.93,2331.44,207.27,2124.17,60684.76,mortgage,97,1
62,60684.76,2331.44,200.26,2131.18,58553.58,mortgage,97,1
63,58553.58,2331.44,193.23,2138.21,56415.37,mortgage,97,1
64,56415.37,2331.44,186.17,2145.27,54270.1,mortgage,97,1
65,54270.1,2331.44,179.09,2152.35,52117.75,mortgage,97,1
66,52117.75,2331.44,171.99,2159.45,49958.3,mortgage,97,1
67,49958.3,2331.44,164.86,2166.58,47791.72,mortgage,97,1
68,47791.72,2331.44,157.71,2173.73,45617.99,mortgage,97,1
69,45617.99,2331.44,150.54,2180.9,43437.09,mortgage,97,1
70,43437.09,2331.44,143.34,2188.1,41248.99,mortgage,97,1
71,41248.99,2331.44,136.12,2195.32,39053.67,mortgage,97,1
72,39053.67,2331.44,128.88,2202.56,36851.11,mortgage,97,1
73,36851.11,2331.44,121.61,2209.83,34641.28,mortgage,97,1
74,34641.28,2331.44,114.32,2217.12,32424.16,mortgage,97,1
75,32424.16,2331.44,107.0,2224.44,30199.72,mortgage,97,1
76,30199.72,2331.44,99.66,2231.78,27967.94,mortgage,97,1
77,27967.94,2331.44,92.29,2239.15,25728.79,mortgage,97,1
78,25728.79,2331.44,84.91,2246.53,23482.26,mortgage,97,1
79,23482.26,2331.44,77.49,2253.95,21228.31,mortgage,97,1
80,21228.31,2331.44,70.05,2261.39,18966.92,mortgage,97,1
81,18966.92,2331.44,62.59,2268.85,16698.07,mortgage,97,1
82,16698.07,2331.44,55.1,2276.34,14421.73,mortgage,97,1
83,14421.73,2331.44,47.59,2283.85,12137.88,mortgage,97,1
84,12137.88,2331.44,40.06,2291.38,9846.5,mortgage,97,1
85,9846.5,2331.44,32.49,2298.95,7547.55,mortgage,97,1
86,7547.55,2331.44,24.91,2306.53,5241.02,mortgage,97,1
87,5241.02,2331.44,17.3,2314.14,2926.88,mortgage,97,1
88,2926.88,2331.44,9.66,2321.78,605.1,mortgage,97,1
89,605.1,2331.44,2.0,2329.44,-1724.34,mortgage,97,1
0,4000.0,70.0,16.0,54.0,3946.0,testing,97,2
1,3946.0,70.0,15.78,54.22,3891.78,testing,97,2
2,3891.78,70.0,15.57,54.43,3837.35,testing,97,2
3,3837.35,70.0,15.35,54.65,3782.7,testing,97,2
4,3782.7,70.0,15.13,54.87,3727.83,testing,97,2
5,3727.83,70.0,14.91,55.09,3672.74,testing,97,2
6,3672.74,70.0,14.69,55.31,3617.43,testing,97,2
7,3617.43,70.0,14.47,55.53,3561.9,testing,97,2
8,3561.9,70.0,14.25,55.75,3506.15,testing,97,2
9,3506.15,70.0,14.02,55.98,3450.17,testing,97,2
10,3450.17,70.0,13.8,56.2,3393.97,testing,97,2
11,3393.97,70.0,13.58,56.42,3337.55,testing,97,2
12,3337.55,70.0,13.35,56.65,3280.9,testing,97,2
13,3280.9,70.0,13.12,56.88,3224.02,testing,97,2
14,3224.02,70.0,12.9,57.1,3166.92,testing,97,2
15,3166.92,70.0,12.67,57.33,3109.59,testing,97,2
16,3109.59,70.0,12.44,57.56,3052.03,testing,97,2
17,3052.03,70.0,12.21,57.79,2994.24,testing,97,2
18,2994.24,70.0,11.98,58.02,2936.22,testing,97,2
19,2936.22,70.0,11.74,58.26,2877.96,testing,97,2
20,2877.96,70.0,11.51,58.49,2819.47,testing,97,2
21,2819.47,70.0,11.28,58.72,2760.75,testing,97,2
22,2760.75,70.0,11.04,58.96,2701.79,testing,97,2
23,2701.79,70.0,10.81,59.19,2642.6,testing,97,2
24,2642.6,70.0,10.57,59.43,2583.17,testing,97,2
25,2583.17,70.0,10.33,59.67,2523.5,testing,97,2
26,2523.5,70.0,10.09,59.91,2463.59,testing,97,2
27,2463.59,70.0,9.85,60.15,2403.44,testing,97,2
28,2403.44,70.0,9.61,60.39,2343.05,testing,97,2
29,2343.05,70.0,9.37,60.63,2282.42,testing,97,2
30,2282.42,70.0,9.13,60.87,2221.55,testing,97,2
31,2221.55,70.0,8.89,61.11,2160.44,testing,97,2
32,2160.44,70.0,8.64,61.36,2099.08,testing,97,2
33,2099.08,70.0,8.4,61.6,2037.48,testing,97,2
34,2037.48,70.0,8.15,61.85,1975.63,testing,97,2
35,1975.63,70.0,7.9,62.1,1913.53,testing,97,2
36,1913.53,70.0,7.65,62.35,1851.18,testing,97,2
37,1851.18,70.0,7.4,62.6,1788.58,testing,97,2
38,1788.58,70.0,7.15,62.85,1725.73,testing,97,2
39,1725.73,70.0,6.9,63.1,1662.63,testing,97,2
40,1662.63,70.0,6.65,63.35,1599.28,testing,97,2
41,1599.28,70.0,6.4,63.6,1535.68,testing,97,2
42,1535.68,70.0,6.14,63.86,1471.82,testing,97,2
43,1471.82,70.0,5.89,64.11,1407.71,testing,97,2
44,1407.71,70.0,5.63,64.37,1343.34,testing,97,2
45,1343.34,70.0,5.37,64.63,1278.71,testing,97,2
46,1278.71,70.0,5.11,64.89,1213.82,testing,97,2
47,1213.82,70.0,4.86,65.14,1148.68,testing,97,2
48,1148.68,70.0,4.59,65.41,1083.27,testing,97,2
49,1083.27,70.0,4.33,65.67,1017.6,testing,97,2
50,1017.6,70.0,4.07,65.93,951.67,testing,97,2
51,951.67,70.0,3.81,66.19,885.48,testing,97,2
52,885.48,70.0,3.54,66.46,819.02,testing,97,2
53,819.02,70.0,3.28,66.72,752.3,testing,97,2
54,752.3,70.0,3.01,66.99,685.31,testing,97,2
55,685.31,70.0,2.74,67.26,618.05,testing,97,2
56,618.05,70.0,2.47,67.53,550.52,testing,97,2
57,550.52,70.0,2.2,67.8,482.72,testing,97,2
58,482.72,70.0,1.93,68.07,414.65,testing,97,2
59,414.65,70.0,1.66,68.34,346.31,testing,97,2
60,346.31,70.0,1.39,68.61,277.7,testing,97,2
61,277.7,70.0,1.11,68.89,208.81,testing,97,2
62,208.81,70.0,0.84,69.16,139.65,testing,97,2
63,139.65,70.0,0.56,69.44,70.21,testing,97,2
64,70.21,70.0,0.28,69.72,0.49,testing,97,2
65,0.49,70.0,0.0,70.0,-69.51,testing,97,2
0,5000.0,333.0,36.0,297.0,4703.0,Car,97,3
1,4703.0,333.0,33.86,299.14,4403.86,Car,97,3
2,4403.86,333.0,31.71,301.29,4102.57,Car,97,3
3,4102.57,333.0,29.54,303.46,3799.11,Car,97,3
4,3799.11,333.0,27.35,305.65,3493.46,Car,97,3
5,3493.46,333.0,25.15,307.85,3185.61,Car,97,3
6,3185.61,333.0,22.94,310.06,2875.55,Car,97,3
7,2875.55,333.0,20.7,312.3,2563.25,Car,97,3
8,2563.25,333.0,18.46,314.54,2248.71,Car,97,3
9,2248.71,333.0,16.19,316.81,1931.9,Car,97,3
10,1931.9,333.0,13.91,319.09,1612.81,Car,97,3
11,1612.81,333.0,11.61,321.39,1291.42,Car,97,3
12,1291.42,333.0,9.3,323.7,967.72,Car,97,3
13,967.72,333.0,6.97,326.03,641.69,Car,97,3
14,641.69,333.0,4.62,328.38,313.31,Car,97,3
15,313.31,333.0,2.26,330.74,-17.43,Car,97,3
0,8250.57,84.62,53.63,30.99,8219.58,WellsFargo1,97,4
1,8219.58,84.62,53.43,31.19,8188.39,WellsFargo1,97,4
2,8188.39,84.62,53.22,31.4,8156.99,WellsFargo1,97,4
3,8156.99,84.62,53.02,31.6,8125.39,WellsFargo1,97,4
4,8125.39,84.62,52.82,31.8,8093.59,WellsFargo1,97,4
5,8093.59,84.62,52.61,32.01,8061.58,WellsFargo1,97,4
6,8061.58,84.62,52.4,32.22,8029.36,WellsFargo1,97,4
7,8029.36,84.62,52.19,32.43,7996.93,WellsFargo1,97,4
8,7996.93,84.62,51.98,32.64,7964.29,WellsFargo1,97,4
9,7964.29,84.62,51.77,32.85,7931.44,WellsFargo1,97,4
10,7931.44,84.62,51.55,33.07,7898.37,WellsFargo1,97,4
11,7898.37,84.62,51.34,33.28,7865.09,WellsFargo1,97,4
12,7865.09,84.62,51.12,33.5,7831.59,WellsFargo1,97,4
13,7831.59,84.62,50.91,33.71,7797.88,WellsFargo1,97,4
14,7797.88,84.62,50.69,33.93,7763.95,WellsFargo1,97,4
15,7763.95,102.05,50.47,51.58,7712.37,WellsFargo1,97,4
16,7712.37,2819.06,50.13,2768.93,4943.44,WellsFargo1,97,4
17,4943.44,2819.06,32.13,2786.93,2156.51,WellsFargo1,97,4
18,2156.51,2819.06,14.02,2805.04,-648.53,WellsFargo1,97,4
0,20000.0,191.04,108.0,83.04,19916.96,WellsFargo2,97,5
1,19916.96,191.04,107.55,83.49,19833.47,WellsFargo2,97,5
2,19833.47,191.04,107.1,83.94,19749.53,WellsFargo2,97,5
3,19749.53,191.04,106.65,84.39,19665.14,WellsFargo2,97,5
4,19665.14,191.04,106.19,84.85,19580.29,WellsFargo2,97,5
5,19580.29,191.04,105.73,85.31,19494.98,WellsFargo2,97,5
6,19494.98,191.04,105.27,85.77,19409.21,WellsFargo2,97,5
7,19409.21,191.04,104.81,86.23,19322.98,WellsFargo2,97,5
8,19322.98,191.04,104.34,86.7,19236.28,WellsFargo2,97,5
9,19236.28,191.04,103.88,87.16,19149.12,WellsFargo2,97,5
10,19149.12,191.04,103.41,87.63,19061.49,WellsFargo2,97,5
11,19061.49,191.04,102.93,88.11,18973.38,WellsFargo2,97,5
12,18973.38,191.04,102.46,88.58,18884.8,WellsFargo2,97,5
13,18884.8,191.04,101.98,89.06,18795.74,WellsFargo2,97,5
14,18795.74,191.04,101.5,89.54,18706.2,WellsFargo2,97,5
15,18706.2,191.04,101.01,90.03,18616.17,WellsFargo2,97,5
16,18616.17,191.04,100.53,90.51,18525.66,WellsFargo2,97,5
17,18525.66,191.04,100.04,91.0,18434.66,WellsFargo2,97,5
18,18434.66,839.57,99.55,740.02,17694.64,WellsFargo2,97,5
19,17694.64,3010.1,95.55,2914.55,14780.09,WellsFargo2,97,5
20,14780.09,3010.1,79.81,2930.29,11849.8,WellsFargo2,97,5
21,11849.8,3010.1,63.99,2946.11,8903.69,WellsFargo2,97,5
22,8903.69,3010.1,48.08,2962.02,5941.67,WellsFargo2,97,5
23,5941.67,3010.1,32.09,2978.01,2963.66,WellsFargo2,97,5
24,2963.66,3010.1,16.0,2994.1,-30.44,WellsFargo2,97,5
0,180000.0,2331.44,594.0,1737.44,178262.56,mortgage,98,1
1,178262.56,2331.44,588.27,1743.17,176519.39,mortgage,98,1
2,176519.39,2331.44,582.51,1748.93,174770.46,mortgage,98,1
3,174770.46,2331.44,576.74,1754.7,173015.76,mortgage,98,1
4,173015.76,2331.44,570.95,1760.49,171255.27,mortgage,98,1
5,171255.27,2331.44,565.14,1766.3,169488.97,mortgage,98,1
6,169488.97,2331.44,559.31,1772.13,167716.84,mortgage,98,1
7,167716.84,2331.44,553.47,1777.97,165938.87,mortgage,98,1
8,165938.87,2331.44,547.6,1783.84,164155.03,mortgage,98,1
9,164155.03,2331.44,541.71,1789.73,162365.3,mortgage,98,1
10,162365.3,2331.44,535.81,1795.63,160569.67,mortgage,98,1
11,160569.67,2331.44,529.88,1801.56,158768.11,mortgage,98,1
12,158768.11,2331.44,523.93,1807.51,156960.6,mortgage,98,1
13,156960.6,2331.44,517.97,1813.47,155147.13,mortgage,98,1
14,155147.13,2331.44,511.99,1819.45,153327.68,mortgage,98,1
15,153327.68,2331.44,505.98,1825.46,151502.22,mortgage,98,1
16,151502.22,2331.44,499.96,1831.48,149670.74,mortgage,98,1
17,149670.74,2331.44,493.91,1837.53,147833.21,mortgage,98,1
18,147833.21,2331.44,487.85,1843.59,145989.62,mortgage,98,1
19,145989.62,2331.44,481.77,1849.67,144139.95,mortgage,98,1
20,144139.95,2331.44,475.66,1855.78,142284.17,mortgage,98,1
21,142284.17,2331.44,469.54,1861.9,140422.27,mortgage,98,1
22,140422.27,2331.44,463.39,1868.05,138554.22,mortgage,98,1
23,138554.22,2331.44,457.23,1874.21,136680.01,mortgage,98,1
24,136680.01,2331.44,451.04,1880.4,134799.61,mortgage,98,1
25,134799.61,2331.44,444.84,1886.6,132913.01,mortgage,98,1
26,132913.01,2331.44,438.61,1892.83,131020.18,mortgage,98,1
27,131020.18,2331.44,432.37,1899.07,129121.11,mortgage,98,1
28,129121.11,2331.44,426.1,1905.34,127215.77,mortgage,98,1
29,127215.77,2331.44,419.81,1911.63,125304.14,mortgage,98,1
30,125304.14,2331.44,413.5,1917.94,123386.2,mortgage,98,1
31,123386.2,2331.44,407.17,1924.27,121461.93,mortgage,98,1
32,121461.93,2331.44,400.82,1930.62,119531.31,mortgage,98,1
33,119531.31,2331.44,394.45,1936.99,117594.32,mortgage,98,1
34,117594.32,2331.44,388.06,1943.38,115650.94,mortgage,98,1
35,115650.94,2331.44,381.65,1949.79,113701.15,mortgage,98,1
36,113701.15,2331.44,375.21,1956.23,111744.92,mortgage,98,1
37,111744.92,2331.44,368.76,1962.68,109782.24,mortgage,98,1
38,109782.24,2331.44,362.28,1969.16,107813.08,mortgage,98,1
39,107813.08,2331.44,355.78,1975.66,105837.42,mortgage,98,1
40,105837.42,2331.44,349.26,1982.18,103855.24,mortgage,98,1
41,103855.24,2331.44,342.72,1988.72,101866.52,mortgage,98,1
42,101866.52,2331.44,336.16,1995.28,99871.24,mortgage,98,1
43,99871.24,2331.44,329.58,2001.86,97869.38,mortgage,98,1
44,97869.38,2331.44,322.97,2008.47,95860.91,mortgage,98,1
45,95860.91,2331.44,316.34,2015.1,93845.81,mortgage,98,1
46,93845.81,2331.44,309.69,2021.75,91824.06,mortgage,98,1
47,91824.06,2331.44,303.02,2028.42,89795.64,mortgage,98,1
48,89795.64,2331.44,296.33,2035.11,87760.53,mortgage,98,1
49,87760.53,2331.44,289.61,2041.83,85718.7,mortgage,98,1
50,85718.7,2331.44,282.87,2048.57,83670.13,mortgage,98,1
51,83670.13,2331.44,276.11,2055.33,81614.8,mortgage,98,1
52,81614.8,2331.44,269.33,2062.11,79552.69,mortgage,98,1
53,79552.69,2331.44,262.52,2068.92,77483.77,mortgage,98,1
54,77483.77,2331.44,255.7,2075.74,75408.03,mortgage,98,1
55,75408.03,2331.44,248.85,2082.59,73325.44,mortgage,98,1
56,73325.44,2331.44,241.97,2089.47,71235.97,mortgage,98,1
57,71235.97,2331.44,235.08,2096.36,69139.61,mortgage,98,1
58,69139.61,2331.44,228.16,2103.28,67036.33,mortgage,98,1
59,67036.33,2331.44,221.22,2110.22,64926.11,mortgage,98,1
60,64926.11,2331.44,214.26,2117.18,62808.93,mortgage,98,1
61,62808.93,2331.44,207.27,2124.17,60684.76,mortgage,98,1
62,60684.76,2331.44,200.26,2131.18,58553.58,mortgage,98,1
63,58553.58,2331.44,193.23,2138.21,56415.37,mortgage,98,1
64,56415.37,2331.44,186.17,2145.27,54270.1,mortgage,98,1
65,54270.1,2331.44,179.09,2152.35,52117.75,mortgage,98,1
66,52117.75,2331.44,171.99,2159.45,49958.3,mortgage,98,1
67,49958.3,2331.44,164.86,2166.58,47791.72,mortgage,98,1
68,47791.72,2331.44,157.71,2173.73,45617.99,mortgage,98,1
69,45617.99,2331.44,150.54,2180.9,43437.09,mortgage,98,1
70,43437.09,2331.44,143.34,2188.1,41248.99,mortgage,98,1
71,41248.99,2331.44,136.12,2195.32,39053.67,mortgage,98,1
72,39053.67,2331.44,128.88,2202.56,36851.11,mortgage,98,1
73,36851.11,2331.44,121.61,2209.83,34641.28,mortgage,98,1
74,34641.28,2331.44,114.32,2217.12,32424.16,mortgage,98,1
75,32424.16,2331.44,107.0,2224.44,30199.72,mortgage,98,1
76,30199.72,2331.44,99.66,2231.78,27967.94,mortgage,98,1
77,27967.94,2331.44,92.29,2239.15,25728.79,mortgage,98,1
78,25728.79,2331.44,84.91,2246.53,23482.26,mortgage,98,1
79,23482.26,2331.44,77.49,2253.95,21228.31,mortgage,98,1
80,21228.31,2331.44,70.05,2261.39,18966.92,mortgage,98,1
81,18966.92,2331.44,62.59,2268.85,16698.07,mortgage,98,1
82,16698.07,2331.44,55.1,2276.34,14421.73,mortgage,98,1
83,14421.73,2331.44,47.59,2283.85,12137.88,mortgage,98,1
84,12137.88,2331.44,40.06,2291.38,9846.5,mortgage,98,1
85,9846.5,2331.44,32.49,2298.95,7547.55,mortgage,98,1
86,7547.55,2331.44,24.91,2306.53,5241.02,mortgage,98,1
87,5241.02,2331.44,17.3,2314.14,2926.88,mortgage,98,1
88,2926.88,2331.44,9.66,2321.78,605.1,mortgage,98,1
89,605.1,2331.44,2.0,2329.44,-1724.34,mortgage,98,1
0,4000.0,70.0,16.0,54.0,3946.0,testing,98,2
1,3946.0,70.0,15.78,54.22,3891.78,testing,98,2
2,3891.78,70.0,15.57,54.43,3837.35,testing,98,2
3,3837.35,70.0,15.35,54.65,3782.7,testing,98,2
4,3782.7,70.0,15.13,54.87,3727.83,testing,98,2
5,3727.83,70.0,14.91,55.09,3672.74,testing,98,2
6,3672.74,70.0,14.69,55.31,3617.43,testing,98,2
7,3617.43,70.0,14.47,55.53,3561.9,testing,98,2
8,3561.9,70.0,14.25,55.75,3506.15,testing,98,2
9,3506.15,70.0,14.02,55.98,3450.17,testing,98,2
10,3450.17,70.0,13.8,56.2,3393.97,testing,98,2
11,3393.97,70.0,13.58,56.42,3337.55,testing,98,2
12,3337.55,70.0,13.35,56.65,3280.9,testing,98,2
13,3280.9,70.0,13.12,56.88,3224.02,testing,98,2
14,3224.02,70.0,12.9,57.1,3166.92,testing,98,2
15,3166.92,70.0,12.67,57.33,3109.59,testing,98,2
16,3109.59,70.0,12.44,57.56,3052.03,testing,98,2
17,3052.03,70.0,12.21,57.79,2994.24,testing,98,2
18,2994.24,70.0,11.98,58.02,2936.22,testing,98,2
19,2936.22,70.0,11.74,58.26,2877.96,testing,98,2
20,2877.96,70.0,11.51,58.49,2819.47,testing,98,2
21,2819.47,70.0,11.28,58.72,2760.75,testing,98,2
22,2760.75,70.0,11.04,58.96,2701.79,testing,98,2
23,2701.79,70.0,10.81,59.19,2642.6,testing,98,2
24,2642.6,70.0,10.57,59.43,2583.17,testing,98,2
25,2583.17,70.0,10.33,59.67,2523.5,testing,98,2
26,2523.5,70.0,10.09,59.91,2463.59,testing,98,2
27,2463.59,70.0,9.85,60.15,2403.44,testing,98,2
28,2403.44,70.0,9.61,60.39,2343.05,testing,98,2
29,2343.05,70.0,9.37,60.63,2282.42,testing,98,2
30,2282.42,70.0,9.13,60.87,2221.55,testing,98,2
31,2221.55,70.0,8.89,61.11,2160.44,testing,98,2
32,2160.44,70.0,8.64,61.36,2099.08,testing,98,2
33,2099.08,70.0,8.4,61.6,2037.48,testing,98,2
34,2037.48,70.0,8.15,61.85,1975.63,testing,98,2
35,1975.63,70.0,7.9,62.1,1913.53,testing,98,2
36,1913.53,70.0,7.65,62.35,1851.18,testing,98,2
37,1851.18,70.0,7.4,62.6,1788.58,testing,98,2
38,1788.58,70.0,7.15,62.85,1725.73,testing,98,2
39,1725.73,70.0,6.9,63.1,1662.63,testing,98,2
40,1662.63,70.0,6.65,63.35,1599.28,testing,98,2
41,1599.28,70.0,6.4,63.6,1535.68,testing,98,2
42,1535.68,70.0,6.14,63.86,1471.82,testing,98,2
43,1471.82,70.0,5.89,64.11,1407.71,testing,98,2
44,1407.71,70.0,5.63,64.37,1343.34,testing,98,2
45,1343.34,70.0,5.37,64.63,1278.71,testing,98,2
46,1278.71,70.0,5.11,64.89,1213.82,testing,98,2
47,1213.82,70.0,4.86,65.14,1148.68,testing,98,2
48,1148.68,70.0,4.59,65.41,1083.27,testing,98,2
49,1083.27,70.0,4.33,65.67,1017.6,testing,98,2
50,1017.6,70.0,4.07,65.93,951.67,testing,98,2
51,951.67,70.0,3.81,66.19,885.48,testing,98,2
52,885.48,70.0,3.54,66.46,819.02,testing,98,2
53,819.02,70.0,3.28,66.72,752.3,testing,98,2
54,752.3,70.0,3.01,66.99,685.31,testing,98,2
55,685.31,70.0,2.74,67.26,618.05,testing,98,2
56,618.05,70.0,2.47,67.53,550.52,testing,98,2
57,550.52,70.0,2.2,67.8,482.72,testing,98,2
58,482.72,70.0,1.93,68.07,414.65,testing,98,2
59,414.65,70.0,1.66,68.34,346.31,testing,98,2
60,346.31,70.0,1.39,68.61,277.7,testing,98,2
61,277.7,70.0,1.11,68.89,208.81,testing,98,2
62,208.81,70.0,0.84,69.16,139.65,testing,98,2
63,139.65,70.0,0.56,69.44,70.21,testing,98,2
64,70.21,70.0,0.28,69.72,0.49,testing,98,2
65,0.49,70.0,0.0,70.0,-69.51,testing,98,2
0,5000.0,333.0,36.0,297.0,4703.0,Car,98,3
1,4703.0,333.0,33.86,299.14,4403.86,Car,98,3
2,4403.86,333.0,31.71,301.29,4102.57,Car,98,3
3,4102.57,333.0,29.54,303.46,3799.11,Car,98,3
4,3799.11,333.0,27.35,305.65,3493.46,Car,98,3
5,3493.46,333.0,25.15,307.85,3185.61,Car,98,3
6,3185.61,333.0,22.94,310.06,2875.55,Car,98,3
7,2875.55,333.0,20.7,312.3,2563.25,Car,98,3
8,2563.25,333.0,18.46,314.54,2248.71,Car,98,3
9,2248.71,333.0,16.19,316.81,1931.9,Car,98,3
10,1931.9,333.0,13.91,319.09,1612.81,Car,98,3
11,1612.81,333.0,11.61,321.39,1291.42,Car,98,3
12,1291.42,333.0,9.3,323.7,967.72,Car,98,3
13,967.72,333.0,6.97,326.03,641.69,Car,98,3
14,641.69,333.0,4.62,328.38,313.31,Car,98,3
15,313.31,333.0,2.26,330.74,-17.43,Car,98,3
0,20000.0,191.04,108.0,83.04,19916.96,WellsFargo2,98,4
1,19916.96,191.04,107.55,83.49,19833.47,WellsFargo2,98,4
2,19833.47,191.04,107.1,83.94,19749.53,WellsFargo2,98,4
3,19749.53,191.04,106.65,84.39,19665.14,WellsFargo2,98,4
4,19665.14,191.04,106.19,84.85,19580.29,WellsFargo2,98,4
5,19580.29,191.04,105.73,85.31,19494.98,WellsFargo2,98,4
6,19494.98,191.04,105.27,85.77,19409.21,WellsFargo2,98,4
7,19409.21,191.04,104.81,86.23,19322.98,WellsFargo2,98,4
8,19322.98,191.04,104.34,86.7,19236.28,WellsFargo2,98,4
9,19236.28,191.04,103.88,87.16,19149.12,WellsFargo2,98,4
10,19149.12,191.04,103.41,87.63,19061.49,WellsFargo2,98,4
11,19061.49,191.04,102.93,88.11,18973.38,WellsFargo2,98,4
12,18973.38,191.04,102.46,88.58,18884.8,WellsFargo2,98,4
13,18884.8,191.04,101.98,89.06,18795.74,WellsFargo2,98,4
14,18795.74,191.04,101.5,89.54,18706.2,WellsFargo2,98,4
15,18706.2,208.47,101.01,107.46,18598.74,WellsFargo2,98,4
16,18598.74,2925.48,100.43,2825.05,15773.69,WellsFargo2,98,4
17,15773.69,2925.48,85.18,2840.3,12933.39,WellsFargo2,98,4
18,12933.39,2925.48,69.84,2855.64,10077.75,WellsFargo2,98,4
19,10077.75,2925.48,54.42,2871.06,7206.69,WellsFargo2,98,4
20,7206.69,2925.48,38.92,2886.56,4320.13,WellsFargo2,98,4
21,4320.13,2925.48,23.33,2902.15,1417.98,WellsFargo2,98,4
22,1417.98,2925.48,7.66,2917.82,-1499.84,WellsFargo2,98,4
0,8250.57,84.62,53.63,30.99,8219.58,WellsFargo1,98,5
1,8219.58,84.62,53.43,31.19,8188.39,WellsFargo1,98,5
2,8188.39,84.62,53.22,31.4,8156.99,WellsFargo1,98,5
3,8156.99,84.62,53.02,31.6,8125.39,WellsFargo1,98,5
4,8125.39,84.62,52.82,31.8,8093.59,WellsFargo1,98,5
5,8093.59,84.62,52.61,32.01,8061.58,WellsFargo1,98,5
6,8061.58,84.62,52.4,32.22,8029.36,WellsFargo1,98,5
7,8029.36,84.62,52.19,32.43,7996.93,WellsFargo1,98,5
8,7996.93,84.62,51.98,32.64,7964.29,WellsFargo1,98,5
9,7964.29,84.62,51.77,32.85,7931.44,WellsFargo1,98,5
10,7931.44,84.62,51.55,33.07,7898.37,WellsFargo1,98,5
11,7898.37,84.62,51.34,33.28,7865.09,WellsFargo1,98,5
12,7865.09,84.62,51.12,33.5,7831.59,WellsFargo1,98,5
13,7831.59,84.62,50.91,33.71,7797.88,WellsFargo1,98,5
14,7797.88,84.62,50.69,33.93,7763.95,WellsFargo1,98,5
15,7763.95,84.62,50.47,34.15,7729.8,WellsFargo1,98,5
16,7729.8,84.62,50.24,34.38,7695.42,WellsFargo1,98,5
17,7695.42,84.62,50.02,34.6,7660.82,WellsFargo1,98,5
18,7660.82,84.62,49.8,34.82,7626.0,WellsFargo1,98,5
19,7626.0,84.62,49.57,35.05,7590.95,WellsFargo1,98,5
20,7590.95,84.62,49.34,35.28,7555.67,WellsFargo1,98,5
21,7555.67,84.62,49.11,35.51,7520.16,WellsFargo1,98,5
22,7520.16,1584.46,48.88,1535.58,5984.58,WellsFargo1,98,5
23,5984.58,3010.1,38.9,2971.2,3013.38,WellsFargo1,98,5
24,3013.38,3010.1,19.59,2990.51,22.87,WellsFargo1,98,5
25,22.87,3010.1,0.15,3009.95,-2987.08,WellsFargo1,98,5
0,180000.0,2331.44,594.0,1737.44,178262.56,mortgage,99,1
1,178262.56,2331.44,588.27,1743.17,176519.39,mortgage,99,1
2,176519.39,2331.44,582.51,1748.93,174770.46,mortgage,99,1
3,174770.46,2331.44,576.74,1754.7,173015.76,mortgage,99,1
4,173015.76,2331.44,570.95,1760.49,171255.27,mortgage,99,1
5,171255.27,2331.44,565.14,1766.3,169488.97,mortgage,99,1
6,169488.97,2331.44,559.31,1772.13,167716.84,mortgage,99,1
7,167716.84,2331.44,553.47,1777.97,165938.87,mortgage,99,1
8,165938.87,2331.44,547.6,1783.84,164155.03,mortgage,99,1
9,164155.03,2331.44,541.71,1789.73,162365.3,mortgage,99,1
10,162365.3,2331.44,535.81,1795.63,160569.67,mortgage,99,1
11,160569.67,2331.44,529.88,1801.56,158768.11,mortgage,99,1
12,158768.11,2331.44,523.93,1807.51,156960.6,mortgage,99,1
13,156960.6,2331.44,517.97,1813.47,155147.13,mortgage,99,1
14,155147.13,2331.44,511.99,1819.45,153327.68,mortgage,99,1
15,153327.68,2331.44,505.98,1825.46,151502.22,mortgage,99,1
16,151502.22,2331.44,499.96,1831.48,149670.74,mortgage,99,1
17,149670.74,2331.44,493.91,1837.53,147833.21,mortgage,99,1
18,147833.21,2331.44,487.85,1843.59,145989.62,mortgage,99,1
19,145989.62,2331.44,481.77,1849.67,144139.95,mortgage,99,1
20,144139.95,2331.44,475.66,1855.78,142284.17,mortgage,99,1
21,142284.17,2331.44,469.54,1861.9,140422.27,mortgage,99,1
22,140422.27,2331.44,463.39,1868.05,138554.22,mortgage,99,1
23,138554.22,2331.44,457.23,1874.21,136680.01,mortgage,99,1
24,136680.01,2331.44,451.04,1880.4,134799.61,mortgage,99,1
25,134799.61,2331.44,444.84,1886.6,132913.01,mortgage,99,1
26,132913.01,2331.44,438.61,1892.83,131020.18,mortgage,99,1
27,131020.18,2331.44,432.37,1899.07,129121.11,mortgage,99,1
28,129121.11,2331.44,426.1,1905.34,127215.77,mortgage,99,1
29,127215.77,2331.44,419.81,1911.63,125304.14,mortgage,99,1
30,125304.14,2331.44,413.5,1917.94,123386.2,mortgage,99,1
31,123386.2,2331.44,407.17,1924.27,121461.93,mortgage,99,1
32,121461.93,2331.44,400.82,1930.62,119531.31,mortgage,99,1
33,119531.31,2331.44,394.45,1936.99,117594.32,mortgage,99,1
34,117594.32,2331.44,388.06,1943.38,115650.94,mortgage,99,1
35,115650.94,2331.44,381.65,1949.79,113701.15,mortgage,99,1
36,113701.15,2331.44,375.21,1956.23,111744.92,mortgage,99,1
37,111744.92,2331.44,368.76,1962.68,109782.24,mortgage,99,1
38,109782.24,2331.44,362.28,1969.16,107813.08,mortgage,99,1
39,107813.08,2331.44,355.78,1975.66,105837.42,mortgage,99,1
40,105837.42,2331.44,349.26,1982.18,103855.24,mortgage,99,1
41,103855.24,2331.44,342.72,1988.72,101866.52,mortgage,99,1
42,101866.52,2331.44,336.16,1995.28,99871.24,mortgage,99,1
43,99871.24,2331.44,329.58,2001.86,97869.38,mortgage,99,1
44,97869.38,2331.44,322.97,2008.47,95860.91,mortgage,99,1
45,95860.91,2331.44,316.34,2015.1,93845.81,mortgage,99,1
46,93845.81,2331.44,309.69,2021.75,91824.06,mortgage,99,1
47,91824.06,2331.44,303.02,2028.42,89795.64,mortgage,99,1
48,89795.64,2331.44,296.33,2035.11,87760.53,mortgage,99,1
49,87760.53,2331.44,289.61,2041.83,85718.7,mortgage,99,1
50,85718.7,2331.44,282.87,2048.57,83670.13,mortgage,99,1
51,83670.13,2331.44,276.11,2055.33,81614.8,mortgage,99,1
52,81614.8,2331.44,269.33,2062.11,79552.69,mortgage,99,1
53,79552.69,2331.44,262.52,2068.92,77483.77,mortgage,99,1
54,77483.77,2331.44,255.7,2075.74,75408.03,mortgage,99,1
55,75408.03,2331.44,248.85,2082.59,73325.44,mortgage,99,1
56,73325.44,2331.44,241.97,2089.47,71235.97,mortgage,99,1
57,71235.97,2331.44,235.08,2096.36,69139.61,mortgage,99,1
58,69139.61,2331.44,228.16,2103.28,67036.33,mortgage,99,1
59,67036.33,2331.44,221.22,2110.22,64926.11,mortgage,99,1
60,64926.11,2331.44,214.26,2117.18,62808.93,mortgage,99,1
61,62808.93,2331.44,207.27,2124.17,60684.76,mortgage,99,1
62,60684.76,2331.44,200.26,2131.18,58553.58,mortgage,99,1
63,58553.58,2331.44,193.23,2138.21,56415.37,mortgage,99,1
64,56415.37,2331.44,186.17,2145.27,54270.1,mortgage,99,1
65,54270.1,2331.44,179.09,2152.35,52117.75,mortgage,99,1
66,52117.75,2331.44,171.99,2159.45,49958.3,mortgage,99,1
67,49958.3,2331.44,164.86,2166.58,47791.72,mortgage,99,1
68,47791.72,2331.44,157.71,2173.73,45617.99,mortgage,99,1
69,45617.99,2331.44,150.54,2180.9,43437.09,mortgage,99,1
70,43437.09,2331.44,143.34,2188.1,41248.99,mortgage,99,1
71,41248.99,2331.44,136.12,2195.32,39053.67,mortgage,99,1
72,39053.67,2331.44,128.88,2202.56,36851.11,mortgage,99,1
73,36851.11,2331.44,121.61,2209.83,34641.28,mortgage,99,1
74,34641.28,2331.44,114.32,2217.12,32424.16,mortgage,99,1
75,32424.16,2331.44,107.0,2224.44,30199.72,mortgage,99,1
76,30199.72,2331.44,99.66,2231.78,27967.94,mortgage,99,1
77,27967.94,2331.44,92.29,2239.15,25728.79,mortgage,99,1
78,25728.79,2331.44,84.91,2246.53,23482.26,mortgage,99,1
79,23482.26,2331.44,77.49,2253.95,21228.31,mortgage,99,1
80,21228.31,2331.44,70.05,2261.39,18966.92,mortgage,99,1
81,18966.92,2331.44,62.59,2268.85,16698.07,mortgage,99,1
82,16698.07,2331.44,55.1,2276.34,14421.73,mortgage,99,1
83,14421.73,2331.44,47.59,2283.85,12137.88,mortgage,99,1
84,12137.88,2331.44,40.06,2291.38,9846.5,mortgage,99,1
85,9846.5,2331.44,32.49,2298.95,7547.55,mortgage,99,1
86,7547.55,2331.44,24.91,2306.53,5241.02,mortgage,99,1
87,5241.02,2331.44,17.3,2314.14,2926.88,mortgage,99,1
88,2926.88,2331.44,9.66,2321.78,605.1,mortgage,99,1
89,605.1,2331.44,2.0,2329.44,-1724.34,mortgage,99,1
0,4000.0,70.0,16.0,54.0,3946.0,testing,99,2
1,3946.0,70.0,15.78,54.22,3891.78,testing,99,2
2,3891.78,70.0,15.57,54.43,3837.35,testing,99,2
3,3837.35,70.0,15.35,54.65,3782.7,testing,99,2
4,3782.7,70.0,15.13,54.87,3727.83,testing,99,2
5,3727.83,70.0,14.91,55.09,3672.74,testing,99,2
6,3672.74,70.0,14.69,55.31,3617.43,testing,99,2
7,3617.43,70.0,14.47,55.53,3561.9,testing,99,2
8,3561.9,70.0,14.25,55.75,3506.15,testing,99,2
9,3506.15,70.0,14.02,55.98,3450.17,testing,99,2
10,3450.17,70.0,13.8,56.2,3393.97,testing,99,2
11,3393.97,70.0,13.58,56.42,3337.55,testing,99,2
12,3337.55,70.0,13.35,56.65,3280.9,testing,99,2
13,3280.9,70.0,13.12,56.88,3224.02,testing,99,2
14,3224.02,70.0,12.9,57.1,3166.92,testing,99,2
15,3166.92,70.0,12.67,57.33,3109.59,testing,99,2
16,3109.59,70.0,12.44,57.56,3052.03,testing,99,2
17,3052.03,70.0,12.21,57.79,2994.24,testing,99,2
18,2994.24,70.0,11.98,58.02,2936.22,testing,99,2
19,2936.22,70.0,11.74,58.26,2877.96,testing,99,2
20,2877.96,70.0,11.51,58.49,2819.47,testing,99,2
21,2819.47,70.0,11.28,58.72,2760.75,testing,99,2
22,2760.75,70.0,11.04,58.96,2701.79,testing,99,2
23,2701.79,70.0,10.81,59.19,2642.6,testing,99,2
24,2642.6,70.0,10.57,59.43,2583.17,testing,99,2
25,2583.17,70.0,10.33,59.67,2523.5,testing,99,2
26,2523.5,70.0,10.09,59.91,2463.59,testing,99,2
27,2463.59,70.0,9.85,60.15,2403.44,testing,99,2
28,2403.44,70.0,9.61,60.39,2343.05,testing,99,2
29,2343.05,70.0,9.37,60.63,2282.42,testing,99,2
30,2282.42,70.0,9.13,60.87,2221.55,testing,99,2
31,2221.55,70.0,8.89,61.11,2160.44,testing,99,2
32,2160.44,70.0,8.64,61.36,2099.08,testing,99,2
33,2099.08,70.0,8.4,61.6,2037.48,testing,99,2
34,2037.48,70.0,8.15,61.85,1975.63,testing,99,2
35,1975.63,70.0,7.9,62.1,1913.53,testing,99,2
36,1913.53,70.0,7.65,62.35,1851.18,testing,99,2
37,1851.18,70.0,7.4,62.6,1788.58,testing,99,2
38,1788.58,70.0,7.15,62.85,1725.73,testing,99,2
39,1725.73,70.0,6.9,63.1,1662.63,testing,99,2
40,1662.63,70.0,6.65,63.35,1599.28,testing,99,2
41,1599.28,70.0,6.4,63.6,1535.68,testing,99,2
42,1535.68,70.0,6.14,63.86,1471.82,testing,99,2
43,1471.82,70.0,5.89,64.11,1407.71,testing,99,2
44,1407.71,70.0,5.63,64.37,1343.34,testing,99,2
45,1343.34,70.0,5.37,64.63,1278.71,testing,99,2
46,1278.71,70.0,5.11,64.89,1213.82,testing,99,2
47,1213.82,70.0,4.86,65.14,1148.68,testing,99,2
48,1148.68,70.0,4.59,65.41,1083.27,testing,99,2
49,1083.27,70.0,4.33,65.67,1017.6,testing,99,2
50,1017.6,70.0,4.07,65.93,951.67,testing,99,2
51,951.67,70.0,3.81,66.19,885.48,testing,99,2
52,885.48,70.0,3.54,66.46,819.02,testing,99,2
53,819.02,70.0,3.28,66.72,752.3,testing,99,2
54,752.3,70.0,3.01,66.99,685.31,testing,99,2
55,685.31,70.0,2.74,67.26,618.05,testing,99,2
56,618.05,70.0,2.47,67.53,550.52,testing,99,2
57,550.52,70.0,2.2,67.8,482.72,testing,99,2
58,482.72,70.0,1.93,68.07,414.65,testing,99,2
59,414.65,70.0,1.66,68.34,346.31,testing,99,2
60,346.31,70.0,1.39,68.61,277.7,testing,99,2
61,277.7,70.0,1.11,68.89,208.81,testing,99,2
62,208.81,70.0,0.84,69.16,139.65,testing,99,2
63,139.65,70.0,0.56,69.44,70.21,testing,99,2
64,70.21,70.0,0.28,69.72,0.49,testing,99,2
65,0.49,70.0,0.0,70.0,-69.51,testing,99,2
0,8250.57,84.62,53.63,30.99,8219.58,WellsFargo1,99,3
1,8219.58,84.62,53.43,31.19,8188.39,WellsFargo1,99,3
2,8188.39,84.62,53.22,31.4,8156.99,WellsFargo1,99,3
3,8156.99,84.62,53.02,31.6,8125.39,WellsFargo1,99,3
4,8125.39,84.62,52.82,31.8,8093.59,WellsFargo1,99,3
5,8093.59,84.62,52.61,32.01,8061.58,WellsFargo1,99,3
6,8061.58,84.62,52.4,32.22,8029.36,WellsFargo1,99,3
7,8029.36,84.62,52.19,32.43,7996.93,WellsFargo1,99,3
8,7996.93,84.62,51.98,32.64,7964.29,WellsFargo1,99,3
9,7964.29,84.62,51.77,32.85,7931.44,WellsFargo1,99,3
10,7931.44,84.62,51.55,33.07,7898.37,WellsFargo1,99,3
11,7898.37,84.62,51.34,33.28,7865.09,WellsFargo1,99,3
12,7865.09,84.62,51.12,33.5,7831.59,WellsFargo1,99,3
13,7831.59,84.62,50.91,33.71,7797.88,WellsFargo1,99,3
14,7797.88,84.62,50.69,33.93,7763.95,WellsFargo1,99,3
15,7763.95,84.62,50.47,34.15,7729.8,WellsFargo1,99,3
16,7729.8,84.62,50.24,34.38,7695.42,WellsFargo1,99,3
17,7695.42,84.62,50.02,34.6,7660.82,WellsFargo1,99,3
18,7660.82,84.62,49.8,34.82,7626.0,WellsFargo1,99,3
19,7626.0,84.62,49.57,35.05,7590.95,WellsFargo1,99,3
20,7590.95,84.62,49.34,35.28,7555.67,WellsFargo1,99,3
21,7555.67,84.62,49.11,35.51,7520.16,WellsFargo1,99,3
22,7520.16,84.62,48.88,35.74,7484.42,WellsFargo1,99,3
23,7484.42,84.62,48.65,35.97,7448.45,WellsFargo1,99,3
24,7448.45,84.62,48.41,36.21,7412.24,WellsFargo1,99,3
25,7412.24,84.62,48.18,36.44,7375.8,WellsFargo1,99,3
26,7375.8,84.62,47.94,36.68,7339.12,WellsFargo1,99,3
27,7339.12,84.62,47.7,36.92,7302.2,WellsFargo1,99,3
28,7302.2,84.62,47.46,37.16,7265.04,WellsFargo1,99,3
29,7265.04,84.62,47.22,37.4,7227.64,WellsFargo1,99,3
30,7227.64,84.62,46.98,37.64,7190.0,WellsFargo1,99,3
31,7190.0,84.62,46.73,37.89,7152.11,WellsFargo1,99,3
32,7152.11,84.62,46.49,38.13,7113.98,WellsFargo1,99,3
33,7113.98,84.62,46.24,38.38,7075.6,WellsFargo1,99,3
34,7075.6,84.62,45.99,38.63,7036.97,WellsFargo1,99,3
35,7036.97,84.62,45.74,38.88,6998.09,WellsFargo1,99,3
36,6998.09,84.62,45.49,39.13,6958.96,WellsFargo1,99,3
37,6958.96,84.62,45.23,39.39,6919.57,WellsFargo1,99,3
38,6919.57,84.62,44.98,39.64,6879.93,WellsFargo1,99,3
39,6879.93,84.62,44.72,39.9,6840.03,WellsFargo1,99,3
40,6840.03,84.62,44.46,40.16,6799.87,WellsFargo1,99,3
41,6799.87,84.62,44.2,40.42,6759.45,WellsFargo1,99,3
42,6759.45,84.62,43.94,40.68,6718.77,WellsFargo1,99,3
43,6718.77,84.62,43.67,40.95,6677.82,WellsFargo1,99,3
44,6677.82,84.62,43.41,41.21,6636.61,WellsFargo1,99,3
45,6636.61,84.62,43.14,41.48,6595.13,WellsFargo1,99,3
46,6595.13,84.62,42.87,41.75,6553.38,WellsFargo1,99,3
47,6553.38,84.62,42.6,42.02,6511.36,WellsFargo1,99,3
48,6511.36,84.62,42.32,42.3,6469.06,WellsFargo1,99,3
49,6469.06,84.62,42.05,42.57,6426.49,WellsFargo1,99,3
50,6426.49,84.62,41.77,42.85,6383.64,WellsFargo1,99,3
51,6383.64,84.62,41.49,43.13,6340.51,WellsFargo1,99,3
52,6340.51,84.62,41.21,43.41,6297.1,WellsFargo1,99,3
53,6297.1,84.62,40.93,43.69,6253.41,WellsFargo1,99,3
54,6253.41,84.62,40.65,43.97,6209.44,WellsFargo1,99,3
55,6209.44,84.62,40.36,44.26,6165.18,WellsFargo1,99,3
56,6165.18,84.62,40.07,44.55,6120.63,WellsFargo1,99,3
57,6120.63,84.62,39.78,44.84,6075.79,WellsFargo1,99,3
58,6075.79,84.62,39.49,45.13,6030.66,WellsFargo1,99,3
59,6030.66,84.62,39.2,45.42,5985.24,WellsFargo1,99,3
60,5985.24,84.62,38.9,45.72,5939.52,WellsFargo1,99,3
61,5939.52,84.62,38.61,46.01,5893.51,WellsFargo1,99,3
62,5893.51,84.62,38.31,46.31,5847.2,WellsFargo1,99,3
63,5847.2,84.62,38.01,46.61,5800.59,WellsFargo1,99,3
64,5800.59,84.62,37.7,46.92,5753.67,WellsFargo1,99,3
65,5753.67,154.13,37.4,116.73,5636.94,WellsFargo1,99,3
66,5636.94,2486.06,36.64,2449.42,3187.52,WellsFargo1,99,3
67,3187.52,2486.06,20.72,2465.34,722.18,WellsFargo1,99,3
68,722.18,2486.06,4.69,2481.37,-1759.19,WellsFargo1,99,3
0,5000.0,333.0,36.0,297.0,4703.0,Car,99,4
1,4703.0,333.0,33.86,299.14,4403.86,Car,99,4
2,4403.86,333.0,31.71,301.29,4102.57,Car,99,4
3,4102.57,333.0,29.54,303.46,3799.11,Car,99,4
4,3799.11,333.0,27.35,305.65,3493.46,Car,99,4
5,3493.46,333.0,25.15,307.85,3185.61,Car,99,4
6,3185.61,333.0,22.94,310.06,2875.55,Car,99,4
7,2875.55,333.0,20.7,312.3,2563.25,Car,99,4
8,2563.25,333.0,18.46,314.54,2248.71,Car,99,4
9,2248.71,333.0,16.19,316.81,1931.9,Car,99,4
10,1931.9,333.0,13.91,319.09,1612.81,Car,99,4
11,1612.81,333.0,11.61,321.39,1291.42,Car,99,4
12,1291.42,333.0,9.3,323.7,967.72,Car,99,4
13,967.72,333.0,6.97,326.03,641.69,Car,99,4
14,641.69,333.0,4.62,328.38,313.31,Car,99,4
15,313.31,333.0,2.26,330.74,-17.43,Car,99,4
0,20000.0,191.04,108.0,83.04,19916.96,WellsFargo2,99,5
1,19916.96,191.04,107.55,83.49,19833.47,WellsFargo2,99,5
2,19833.47,191.04,107.1,83.94,19749.53,WellsFargo2,99,5
3,19749.53,191.04,106.65,84.39,19665.14,WellsFargo2,99,5
4,19665.14,191.04,106.19,84.85,19580.29,WellsFargo2,99,5
5,19580.29,191.04,105.73,85.31,19494.98,WellsFargo2,99,5
6,19494.98,191.04,105.27,85.77,19409.21,WellsFargo2,99,5
7,19409.21,191.04,104.81,86.23,19322.98,WellsFargo2,99,5
8,19322.98,191.04,104.34,86.7,19236.28,WellsFargo2,99,5
9,19236.28,191.04,103.88,87.16,19149.12,WellsFargo2,99,5
10,19149.12,191.04,103.41,87.63,19061.49,WellsFargo2,99,5
11,19061.49,191.04,102.93,88.11,18973.38,WellsFargo2,99,5
12,18973.38,191.04,102.46,88.58,18884.8,WellsFargo2,99,5
13,18884.8,191.04,101.98,89.06,18795.74,WellsFargo2,99,5
14,18795.74,191.04,101.5,89.54,18706.2,WellsFargo2,99,5
15,18706.2,208.47,101.01,107.46,18598.74,WellsFargo2,99,5
16,18598.74,3010.1,100.43,2909.67,15689.07,WellsFargo2,99,5
17,15689.07,3010.1,84.72,2925.38,12763.69,WellsFargo2,99,5
18,12763.69,3010.1,68.92,2941.18,9822.51,WellsFargo2,99,5
19,9822.51,3010.1,53.04,2957.06,6865.45,WellsFargo2,99,5
20,6865.45,3010.1,37.07,2973.03,3892.42,WellsFargo2,99,5
21,3892.42,3010.1,21.02,2989.08,903.34,WellsFargo2,99,5
22,903.34,3010.1,4.88,3005.22,-2101.88,WellsFargo2,99,5
0,180000.0,2331.44,594.0,1737.44,178262.56,mortgage,100,1
1,178262.56,2331.44,588.27,1743.17,176519.39,mortgage,100,1
2,176519.39,2331.44,582.51,1748.93,174770.46,mortgage,100,1
3,174770.46,2331.44,576.74,1754.7,173015.76,mortgage,100,1
4,173015.76,2331.44,570.95,1760.49,171255.27,mortgage,100,1
5,171255.27,2331.44,565.14,1766.3,169488.97,mortgage,100,1
6,169488.97,2331.44,559.31,1772.13,167716.84,mortgage,100,1
7,167716.84,2331.44,553.47,1777.97,165938.87,mortgage,100,1
8,165938.87,2331.44,547.6,1783.84,164155.03,mortgage,100,1
9,164155.03,2331.44,541.71,1789.73,162365.3,mortgage,100,1
10,162365.3,2331.44,535.81,1795.63,160569.67,mortgage,100,1
11,160569.67,2331.44,529.88,1801.56,158768.11,mortgage,100,1
12,158768.11,2331.44,523.93,1807.51,156960.6,mortgage,100,1
13,156960.6,2331.44,517.97,1813.47,155147.13,mortgage,100,1
14,155147.13,2331.44,511.99,1819.45,153327.68,mortgage,100,1
15,153327.68,2331.44,505.98,1825.46,151502.22,mortgage,100,1
16,151502.22,2331.44,499.96,1831.48,149670.74,mortgage,100,1
17,149670.74,2331.44,493.91,1837.53,147833.21,mortgage,100,1
18,147833.21,2331.44,487.85,1843.59,145989.62,mortgage,100,1
19,145989.62,2331.44,481.77,1849.67,144139.95,mortgage,100,1
20,144139.95,2331.44,475.66,1855.78,142284.17,mortgage,100,1
21,142284.17,2331.44,469.54,1861.9,140422.27,mortgage,100,1
22,140422.27,2331.44,463.39,1868.05,138554.22,mortgage,100,1
23,138554.22,2331.44,457.23,1874.21,136680.01,mortgage,100,1
24,136680.01,2331.44,451.04,1880.4,134799.61,mortgage,100,1
25,134799.61,2331.44,444.84,1886.6,132913.01,mortgage,100,1
26,132913.01,2331.44,438.61,1892.83,131020.18,mortgage,100,1
27,131020.18,2331.44,432.37,1899.07,129121.11,mortgage,100,1
28,129121.11,2331.44,426.1,1905.34,127215.77,mortgage,100,1
29,127215.77,2331.44,419.81,1911.63,125304.14,mortgage,100,1
30,125304.14,2331.44,413.5,1917.94,123386.2,mortgage,100,1
31,123386.2,2331.44,407.17,1924.27,121461.93,mortgage,100,1
32,121461.93,2331.44,400.82,1930.62,119531.31,mortgage,100,1
33,119531.31,2331.44,394.45,1936.99,117594.32,mortgage,100,1
34,117594.32,2331.44,388.06,1943.38,115650.94,mortgage,100,1
35,115650.94,2331.44,381.65,1949.79,113701.15,mortgage,100,1
36,113701.15,2331.44,375.21,1956.23,111744.92,mortgage,100,1
37,111744.92,2331.44,368.76,1962.68,109782.24,mortgage,100,1
38,109782.24,2331.44,362.28,1969.16,107813.08,mortgage,100,1
39,107813.08,2331.44,355.78,1975.66,105837.42,mortgage,100,1
40,105837.42,2331.44,349.26,1982.18,103855.24,mortgage,100,1
41,103855.24,2331.44,342.72,1988.72,101866.52,mortgage,100,1
42,101866.52,2331.44,336.16,1995.28,99871.24,mortgage,100,1
43,99871.24,2331.44,329.58,2001.86,97869.38,mortgage,100,1
44,97869.38,2331.44,322.97,2008.47,95860.91,mortgage,100,1
45,95860.91,2331.44,316.34,2015.1,93845.81,mortgage,100,1
46,93845.81,2331.44,309.69,2021.75,91824.06,mortgage,100,1
47,91824.06,2331.44,303.02,2028.42,89795.64,mortgage,100,1
48,89795.64,2331.44,296.33,2035.11,87760.53,mortgage,100,1
49,87760.53,2331.44,289.61,2041.83,85718.7,mortgage,100,1
50,85718.7,2331.44,282.87,2048.57,83670.13,mortgage,100,1
51,83670.13,2331.44,276.11,2055.33,81614.8,mortgage,100,1
52,81614.8,2331.44,269.33,2062.11,79552.69,mortgage,100,1
53,79552.69,2331.44,262.52,2068.92,77483.77,mortgage,100,1
54,77483.77,2331.44,255.7,2075.74,75408.03,mortgage,100,1
55,75408.03,2331.44,248.85,2082.59,73325.44,mortgage,100,1
56,73325.44,2331.44,241.97,2089.47,71235.97,mortgage,100,1
57,71235.97,2331.44,235.08,2096.36,69139.61,mortgage,100,1
58,69139.61,2331.44,228.16,2103.28,67036.33,mortgage,100,1
59,67036.33,2331.44,221.22,2110.22,64926.11,mortgage,100,1
60,64926.11,2331.44,214.26,2117.18,62808.93,mortgage,100,1
61,62808.93,2331.44,207.27,2124.17,60684.76,mortgage,100,1
62,60684.76,2331.44,200.26,2131.18,58553.58,mortgage,100,1
63,58553.58,2331.44,193.23,2138.21,56415.37,mortgage,100,1
64,56415.37,2331.44,186.17,2145.27,54270.1,mortgage,100,1
65,54270.1,2331.44,179.09,2152.35,52117.75,mortgage,100,1
66,52117.75,2331.44,171.99,2159.45,49958.3,mortgage,100,1
67,49958.3,2331.44,164.86,2166.58,47791.72,mortgage,100,1
68,47791.72,2331.44,157.71,2173.73,45617.99,mortgage,100,1
69,45617.99,2331.44,150.54,2180.9,43437.09,mortgage,100,1
70,43437.09,2331.44,143.34,2188.1,41248.99,mortgage,100,1
71,41248.99,2331.44,136.12,2195.32,39053.67,mortgage,100,1
72,39053.67,2331.44,128.88,2202.56,36851.11,mortgage,100,1
73,36851.11,2331.44,121.61,2209.83,34641.28,mortgage,100,1
74,34641.28,2331.44,114.32,2217.12,32424.16,mortgage,100,1
75,32424.16,2331.44,107.0,2224.44,30199.72,mortgage,100,1
76,30199.72,2331.44,99.66,2231.78,27967.94,mortgage,100,1
77,27967.94,2331.44,92.29,2239.15,25728.79,mortgage,100,1
78,25728.79,2331.44,84.91,2246.53,23482.26,mortgage,100,1
79,23482.26,2331.44,77.49,2253.95,21228.31,mortgage,100,1
80,21228.31,2331.44,70.05,2261.39,18966.92,mortgage,100,1
81,18966.92,2331.44,62.59,2268.85,16698.07,mortgage,100,1
82,16698.07,2331.44,55.1,2276.34,14421.73,mortgage,100,1
83,14421.73,2331.44,47.59,2283.85,12137.88,mortgage,100,1
84,12137.88,2331.44,40.06,2291.38,9846.5,mortgage,100,1
85,9846.5,2331.44,32.49,2298.95,7547.55,mortgage,100,1
86,7547.55,2331.44,24.91,2306.53,5241.02,mortgage,100,1
87,5241.02,2331.44,17.3,2314.14,2926.88,mortgage,100,1
88,2926.88,2331.44,9.66,2321.78,605.1,mortgage,100,1
89,605.1,2331.44,2.0,2329.44,-1724.34,mortgage,100,1
0,4000.0,70.0,16.0,54.0,3946.0,testing,100,2
1,3946.0,70.0,15.78,54.22,3891.78,testing,100,2
2,3891.78,70.0,15.57,54.43,3837.35,testing,100,2
3,3837.35,70.0,15.35,54.65,3782.7,testing,100,2
4,3782.7,70.0,15.13,54.87,3727.83,testing,100,2
5,3727.83,70.0,14.91,55.09,3672.74,testing,100,2
6,3672.74,70.0,14.69,55.31,3617.43,testing,100,2
7,3617.43,70.0,14.47,55.53,3561.9,testing,100,2
8,3561.9,70.0,14.25,55.75,3506.15,testing,100,2
9,3506.15,70.0,14.02,55.98,3450.17,testing,100,2
10,3450.17,70.0,13.8,56.2,3393.97,testing,100,2
11,3393.97,70.0,13.58,56.42,3337.55,testing,100,2
12,3337.55,70.0,13.35,56.65,3280.9,testing,100,2
13,3280.9,70.0,13.12,56.88,3224.02,testing,100,2
14,3224.02,70.0,12.9,57.1,3166.92,testing,100,2
15,3166.92,70.0,12.67,57.33,3109.59,testing,100,2
16,3109.59,70.0,12.44,57.56,3052.03,testing,100,2
17,3052.03,70.0,12.21,57.79,2994.24,testing,100,2
18,2994.24,70.0,11.98,58.02,2936.22,testing,100,2
19,2936.22,70.0,11.74,58.26,2877.96,testing,100,2
20,2877.96,70.0,11.51,58.49,2819.47,testing,100,2
21,2819.47,70.0,11.28,58.72,2760.75,testing,100,2
22,2760.75,70.0,11.04,58.96,2701.79,testing,100,2
23,2701.79,70.0,10.81,59.19,2642.6,testing,100,2
24,2642.6,70.0,10.57,59.43,2583.17,testing,100,2
25,2583.17,70.0,10.33,59.67,2523.5,testing,100,2
26,2523.5,70.0,10.09,59.91,2463.59,testing,100,2
27,2463.59,70.0,9.85,60.15,2403.44,testing,100,2
28,2403.44,70.0,9.61,60.39,2343.05,testing,100,2
29,2343.05,70.0,9.37,60.63,2282.42,testing,100,2
30,2282.42,70.0,9.13,60.87,2221.55,testing,100,2
31,2221.55,70.0,8.89,61.11,2160.44,testing,100,2
32,2160.44,70.0,8.64,61.36,2099.08,testing,100,2
33,2099.08,70.0,8.4,61.6,2037.48,testing,100,2
34,2037.48,70.0,8.15,61.85,1975.63,testing,100,2
35,1975.63,70.0,7.9,62.1,1913.53,testing,100,2
36,1913.53,70.0,7.65,62.35,1851.18,testing,100,2
37,1851.18,70.0,7.4,62.6,1788.58,testing,100,2
38,1788.58,70.0,7.15,62.85,1725.73,testing,100,2
39,1725.73,70.0,6.9,63.1,1662.63,testing,100,2
40,1662.63,70.0,6.65,63.35,1599.28,testing,100,2
41,1599.28,70.0,6.4,63.6,1535.68,testing,100,2
42,1535.68,70.0,6.14,63.86,1471.82,testing,100,2
43,1471.82,70.0,5.89,64.11,1407.71,testing,100,2
44,1407.71,70.0,5.63,64.37,1343.34,testing,100,2
45,1343.34,70.0,5.37,64.63,1278.71,testing,100,2
46,1278.71,70.0,5.11,64.89,1213.82,testing,100,2
47,1213.82,70.0,4.86,65.14,1148.68,testing,100,2
48,1148.68,70.0,4.59,65.41,1083.27,testing,100,2
49,1083.27,70.0,4.33,65.67,1017.6,testing,100,2
50,1017.6,70.0,4.07,65.93,951.67,testing,100,2
51,951.67,70.0,3.81,66.19,885.48,testing,100,2
52,885.48,70.0,3.54,66.46,819.02,testing,100,2
53,819.02,70.0,3.28,66.72,752.3,testing,100,2
54,752.3,70.0,3.01,66.99,685.31,testing,100,2
55,685.31,70.0,2.74,67.26,618.05,testing,100,2
56,618.05,70.0,2.47,67.53,550.52,testing,100,2
57,550.52,70.0,2.2,67.8,482.72,testing,100,2
58,482.72,70.0,1.93,68.07,414.65,testing,100,2
59,414.65,70.0,1.66,68.34,346.31,testing,100,2
60,346.31,70.0,1.39,68.61,277.7,testing,100,2
61,277.7,70.0,1.11,68.89,208.81,testing,100,2
62,208.81,70.0,0.84,69.16,139.65,testing,100,2
63,139.65,70.0,0.56,69.44,70.21,testing,100,2
64,70.21,70.0,0.28,69.72,0.49,testing,100,2
65,0.49,70.0,0.0,70.0,-69.51,testing,100,2
0,8250.57,84.62,53.63,30.99,8219.58,WellsFargo1,100,3
1,8219.58,84.62,53.43,31.19,8188.39,WellsFargo1,100,3
2,8188.39,84.62,53.22,31.4,8156.99,WellsFargo1,100,3
3,8156.99,84.62,53.02,31.6,8125.39,WellsFargo1,100,3
4,8125.39,84.62,52.82,31.8,8093.59,WellsFargo1,100,3
5,8093.59,84.62,52.61,32.01,8061.58,WellsFargo1,100,3
6,8061.58,84.62,52.4,32.22,8029.36,WellsFargo1,100,3
7,8029.36,84.62,52.19,32.43,7996.93,WellsFargo1,100,3
8,7996.93,84.62,51.98,32.64,7964.29,WellsFargo1,100,3
9,7964.29,84.62,51.77,32.85,7931.44,WellsFargo1,100,3
10,7931.44,84.62,51.55,33.07,7898.37,WellsFargo1,100,3
11,7898.37,84.62,51.34,33.28,7865.09,WellsFargo1,100,3
12,7865.09,84.62,51.12,33.5,7831.59,WellsFargo1,100,3
13,7831.59,84.62,50.91,33.71,7797.88,WellsFargo1,100,3
14,7797.88,84.62,50.69,33.93,7763.95,WellsFargo1,100,3
15,7763.95,84.62,50.47,34.15,7729.8,WellsFargo1,100,3
16,7729.8,84.62,50.24,34.38,7695.42,WellsFargo1,100,3
17,7695.42,84.62,50.02,34.6,7660.82,WellsFargo1,100,3
18,7660.82,84.62,49.8,34.82,7626.0,WellsFargo1,100,3
19,7626.0,84.62,49.57,35.05,7590.95,WellsFargo1,100,3
20,7590.95,84.62,49.34,35.28,7555.67,WellsFargo1,100,3
21,7555.67,84.62,49.11,35.51,7520.16,WellsFargo1,100,3
22,7520.16,84.62,48.88,35.74,7484.42,WellsFargo1,100,3
23,7484.42,84.62,48.65,35.97,7448.45,WellsFargo1,100,3
24,7448.45,84.62,48.41,36.21,7412.24,WellsFargo1,100,3
25,7412.24,84.62,48.18,36.44,7375.8,WellsFargo1,100,3
26,7375.8,84.62,47.94,36.68,7339.12,WellsFargo1,100,3
27,7339.12,84.62,47.7,36.92,7302.2,WellsFargo1,100,3
28,7302.2,84.62,47.46,37.16,7265.04,WellsFargo1,100,3
29,7265.04,84.62,47.22,37.4,7227.64,WellsFargo1,100,3
30,7227.64,84.62,46.98,37.64,7190.0,WellsFargo1,100,3
31,7190.0,84.62,46.73,37.89,7152.11,WellsFargo1,100,3
32,7152.11,84.62,46.49,38.13,7113.98,WellsFargo1,100,3
33,7113.98,84.62,46.24,38.38,7075.6,WellsFargo1,100,3
34,7075.6,84.62,45.99,38.63,7036.97,WellsFargo1,100,3
35,7036.97,84.62,45.74,38.88,6998.09,WellsFargo1,100,3
36,6998.09,84.62,45.49,39.13,6958.96,WellsFargo1,100,3
37,6958.96,84.62,45.23,39.39,6919.57,WellsFargo1,100,3
38,6919.57,84.62,44.98,39.64,6879.93,WellsFargo1,100,3
39,6879.93,84.62,44.72,39.9,6840.03,WellsFargo1,100,3
40,6840.03,84.62,44.46,40.16,6799.87,WellsFargo1,100,3
41,6799.87,84.62,44.2,40.42,6759.45,WellsFargo1,100,3
42,6759.45,84.62,43.94,40.68,6718.77,WellsFargo1,100,3
43,6718.77,84.62,43.67,40.95,6677.82,WellsFargo1,100,3
44,6677.82,84.62,43.41,41.21,6636.61,WellsFargo1,100,3
45,6636.61,84.62,43.14,41.48,6595.13,WellsFargo1,100,3
46,6595.13,84.62,42.87,41.75,6553.38,WellsFargo1,100,3
47,6553.38,84.62,42.6,42.02,6511.36,WellsFargo1,100,3
48,6511.36,84.62,42.32,42.3,6469.06,WellsFargo1,100,3
49,6469.06,84.62,42.05,42.57,6426.49,WellsFargo1,100,3
50,6426.49,84.62,41.77,42.85,6383.64,WellsFargo1,100,3
51,6383.64,84.62,41.49,43.13,6340.51,WellsFargo1,100,3
52,6340.51,84.62,41.21,43.41,6297.1,WellsFargo1,100,3
53,6297.1,84.62,40.93,43.69,6253.41,WellsFargo1,100,3
54,6253.41,84.62,40.65,43.97,6209.44,WellsFargo1,100,3
55,6209.44,84.62,40.36,44.26,6165.18,WellsFargo1,100,3
56,6165.18,84.62,40.07,44.55,6120.63,WellsFargo1,100,3
57,6120.63,84.62,39.78,44.84,6075.79,WellsFargo1,100,3
58,6075.79,84.62,39.49,45.13,6030.66,WellsFargo1,100,3
59,6030.66,84.62,39.2,45.42,5985.24,WellsFargo1,100,3
60,5985.24,84.62,38.9,45.72,5939.52,WellsFargo1,100,3
61,5939.52,84.62,38.61,46.01,5893.51,WellsFargo1,100,3
62,5893.51,84.62,38.31,46.31,5847.2,WellsFargo1,100,3
63,5847.2,84.62,38.01,46.61,5800.59,WellsFargo1,100,3
64,5800.59,84.62,37.7,46.92,5753.67,WellsFargo1,100,3
65,5753.67,154.13,37.4,116.73,5636.94,WellsFargo1,100,3
66,5636.94,2486.06,36.64,2449.42,3187.52,WellsFargo1,100,3
67,3187.52,2486.06,20.72,2465.34,722.18,WellsFargo1,100,3
68,722.18,2486.06,4.69,2481.37,-1759.19,WellsFargo1,100,3
0,20000.0,191.04,108.0,83.04,19916.96,WellsFargo2,100,4
1,19916.96,191.04,107.55,83.49,19833.47,WellsFargo2,100,4
2,19833.47,191.04,107.1,83.94,19749.53,WellsFargo2,100,4
3,19749.53,191.04,106.65,84.39,19665.14,WellsFargo2,100,4
4,19665.14,191.04,106.19,84.85,19580.29,WellsFargo2,100,4
5,19580.29,191.04,105.73,85.31,19494.98,WellsFargo2,100,4
6,19494.98,191.04,105.27,85.77,19409.21,WellsFargo2,100,4
7,19409.21,191.04,104.81,86.23,19322.98,WellsFargo2,100,4
8,19322.98,191.04,104.34,86.7,19236.28,WellsFargo2,100,4
9,19236.28,191.04,103.88,87.16,19149.12,WellsFargo2,100,4
10,19149.12,191.04,103.41,87.63,19061.49,WellsFargo2,100,4
11,19061.49,191.04,102.93,88.11,18973.38,WellsFargo2,100,4
12,18973.38,191.04,102.46,88.58,18884.8,WellsFargo2,100,4
13,18884.8,191.04,101.98,89.06,18795.74,WellsFargo2,100,4
14,18795.74,191.04,101.5,89.54,18706.2,WellsFargo2,100,4
15,18706.2,191.04,101.01,90.03,18616.17,WellsFargo2,100,4
16,18616.17,191.04,100.53,90.51,18525.66,WellsFargo2,100,4
17,18525.66,191.04,100.04,91.0,18434.66,WellsFargo2,100,4
18,18434.66,191.04,99.55,91.49,18343.17,WellsFargo2,100,4
19,18343.17,191.04,99.05,91.99,18251.18,WellsFargo2,100,4
20,18251.18,191.04,98.56,92.48,18158.7,WellsFargo2,100,4
21,18158.7,191.04,98.06,92.98,18065.72,WellsFargo2,100,4
22,18065.72,191.04,97.55,93.49,17972.23,WellsFargo2,100,4
23,17972.23,191.04,97.05,93.99,17878.24,WellsFargo2,100,4
24,17878.24,191.04,96.54,94.5,17783.74,WellsFargo2,100,4
25,17783.74,191.04,96.03,95.01,17688.73,WellsFargo2,100,4
26,17688.73,191.04,95.52,95.52,17593.21,WellsFargo2,100,4
27,17593.21,191.04,95.0,96.04,17497.17,WellsFargo2,100,4
28,17497.17,191.04,94.48,96.56,17400.61,WellsFargo2,100,4
29,17400.61,191.04,93.96,97.08,17303.53,WellsFargo2,100,4
30,17303.53,191.04,93.44,97.6,17205.93,WellsFargo2,100,4
31,17205.93,191.04,92.91,98.13,17107.8,WellsFargo2,100,4
32,17107.8,191.04,92.38,98.66,17009.14,WellsFargo2,100,4
33,17009.14,191.04,91.85,99.19,16909.95,WellsFargo2,100,4
34,16909.95,191.04,91.31,99.73,16810.22,WellsFargo2,100,4
35,16810.22,191.04,90.78,100.26,16709.96,WellsFargo2,100,4
36,16709.96,191.04,90.23,100.81,16609.15,WellsFargo2,100,4
37,16609.15,191.04,89.69,101.35,16507.8,WellsFargo2,100,4
38,16507.8,191.04,89.14,101.9,16405.9,WellsFargo2,100,4
39,16405.9,191.04,88.59,102.45,16303.45,WellsFargo2,100,4
40,16303.45,191.04,88.04,103.0,16200.45,WellsFargo2,100,4
41,16200.45,191.04,87.48,103.56,16096.89,WellsFargo2,100,4
42,16096.89,191.04,86.92,104.12,15992.77,WellsFargo2,100,4
43,15992.77,191.04,86.36,104.68,15888.09,WellsFargo2,100,4
44,15888.09,191.04,85.8,105.24,15782.85,WellsFargo2,100,4
45,15782.85,191.04,85.23,105.81,15677.04,WellsFargo2,100,4
46,15677.04,191.04,84.66,106.38,15570.66,WellsFargo2,100,4
47,15570.66,191.04,84.08,106.96,15463.7,WellsFargo2,100,4
48,15463.7,191.04,83.5,107.54,15356.16,WellsFargo2,100,4
49,15356.16,191.04,82.92,108.12,15248.04,WellsFargo2,100,4
50,15248.04,191.04,82.34,108.7,15139.34,WellsFargo2,100,4
51,15139.34,191.04,81.75,109.29,15030.05,WellsFargo2,100,4
52,15030.05,191.04,81.16,109.88,14920.17,WellsFargo2,100,4
53,14920.17,191.04,80.57,110.47,14809.7,WellsFargo2,100,4
54,14809.7,191.04,79.97,111.07,14698.63,WellsFargo2,100,4
55,14698.63,191.04,79.37,111.67,14586.96,WellsFargo2,100,4
56,14586.96,191.04,78.77,112.27,14474.69,WellsFargo2,100,4
57,14474.69,191.04,78.16,112.88,14361.81,WellsFargo2,100,4
58,14361.81,191.04,77.55,113.49,14248.32,WellsFargo2,100,4
59,14248.32,191.04,76.94,114.1,14134.22,WellsFargo2,100,4
60,14134.22,191.04,76.32,114.72,14019.5,WellsFargo2,100,4
61,14019.5,191.04,75.71,115.33,13904.17,WellsFargo2,100,4
62,13904.17,191.04,75.08,115.96,13788.21,WellsFargo2,100,4
63,13788.21,191.04,74.46,116.58,13671.63,WellsFargo2,100,4
64,13671.63,191.04,73.83,117.21,13554.42,WellsFargo2,100,4
65,13554.42,191.04,73.19,117.85,13436.57,WellsFargo2,100,4
66,13436.57,191.04,72.56,118.48,13318.09,WellsFargo2,100,4
67,13318.09,191.04,71.92,119.12,13198.97,WellsFargo2,100,4
68,13198.97,1950.23,71.27,1878.96,11320.01,WellsFargo2,100,4
69,11320.01,2677.1,61.13,2615.97,8704.04,WellsFargo2,100,4
70,8704.04,2677.1,47.0,2630.1,6073.94,WellsFargo2,100,4
71,6073.94,2677.1,32.8,2644.3,3429.64,WellsFargo2,100,4
72,3429.64,2677.1,18.52,2658.58,771.06,WellsFargo2,100,4
73,771.06,2677.1,4.16,2672.94,-1901.88,WellsFargo2,100,4
0,5000.0,333.0,36.0,297.0,4703.0,Car,100,5
1,4703.0,333.0,33.86,299.14,4403.86,Car,100,5
2,4403.86,333.0,31.71,301.29,4102.57,Car,100,5
3,4102.57,333.0,29.54,303.46,3799.11,Car,100,5
4,3799.11,333.0,27.35,305.65,3493.46,Car,100,5
5,3493.46,333.0,25.15,307.85,3185.61,Car,100,5
6,3185.61,333.0,22.94,310.06,2875.55,Car,100,5
7,2875.55,333.0,20.7,312.3,2563.25,Car,100,5
8,2563.25,333.0,18.46,314.54,2248.71,Car,100,5
9,2248.71,333.0,16.19,316.81,1931.9,Car,100,5
10,1931.9,333.0,13.91,319.09,1612.81,Car,100,5
11,1612.81,333.0,11.61,321.39,1291.42,Car,100,5
12,1291.42,333.0,9.3,323.7,967.72,Car,100,5
13,967.72,333.0,6.97,326.03,641.69,Car,100,5
14,641.69,333.0,4.62,328.38,313.31,Car,100,5
15,313.31,333.0,2.26,330.74,-17.43,Car,100,5
0,180000.0,2331.44,594.0,1737.44,178262.56,mortgage,101,1
1,178262.56,2331.44,588.27,1743.17,176519.39,mortgage,101,1
2,176519.39,2331.44,582.51,1748.93,174770.46,mortgage,101,1
3,174770.46,2331.44,576.74,1754.7,173015.76,mortgage,101,1
4,173015.76,2331.44,570.95,1760.49,171255.27,mortgage,101,1
5,171255.27,2331.44,565.14,1766.3,169488.97,mortgage,101,1
6,169488.97,2331.44,559.31,1772.13,167716.84,mortgage,101,1
7,167716.84,2331.44,553.47,1777.97,165938.87,mortgage,101,1
8,165938.87,2331.44,547.6,1783.84,164155.03,mortgage,101,1
9,164155.03,2331.44,541.71,1789.73,162365.3,mortgage,101,1
10,162365.3,2331.44,535.81,1795.63,160569.67,mortgage,101,1
11,160569.67,2331.44,529.88,1801.56,158768.11,mortgage,101,1
12,158768.11,2331.44,523.93,1807.51,156960.6,mortgage,101,1
13,156960.6,2331.44,517.97,1813.47,155147.13,mortgage,101,1
14,155147.13,2331.44,511.99,1819.45,153327.68,mortgage,101,1
15,153327.68,2331.44,505.98,1825.46,151502.22,mortgage,101,1
16,151502.22,2331.44,499.96,1831.48,149670.74,mortgage,101,1
17,149670.74,2331.44,493.91,1837.53,147833.21,mortgage,101,1
18,147833.21,2331.44,487.85,1843.59,145989.62,mortgage,101,1
19,145989.62,2331.44,481.77,1849.67,144139.95,mortgage,101,1
20,144139.95,2331.44,475.66,1855.78,142284.17,mortgage,101,1
21,142284.17,2331.44,469.54,1861.9,140422.27,mortgage,101,1
22,140422.27,2331.44,463.39,1868.05,138554.22,mortgage,101,1
23,138554.22,2331.44,457.23,1874.21,136680.01,mortgage,101,1
24,136680.01,2331.44,451.04,1880.4,134799.61,mortgage,101,1
25,134799.61,2331.44,444.84,1886.6,132913.01,mortgage,101,1
26,132913.01,2331.44,438.61,1892.83,131020.18,mortgage,101,1
27,131020.18,2331.44,432.37,1899.07,129121.11,mortgage,101,1
28,129121.11,2331.44,426.1,1905.34,127215.77,mortgage,101,1
29,127215.77,2331.44,419.81,1911.63,125304.14,mortgage,101,1
30,125304.14,2331.44,413.5,1917.94,123386.2,mortgage,101,1
31,123386.2,2331.44,407.17,1924.27,121461.93,mortgage,101,1
32,121461.93,2331.44,400.82,1930.62,119531.31,mortgage,101,1
33,119531.31,2331.44,394.45,1936.99,117594.32,mortgage,101,1
34,117594.32,2331.44,388.06,1943.38,115650.94,mortgage,101,1
35,115650.94,2331.44,381.65,1949.79,113701.15,mortgage,101,1
36,113701.15,2331.44,375.21,1956.23,111744.92,mortgage,101,1
37,111744.92,2331.44,368.76,1962.68,109782.24,mortgage,101,1
38,109782.24,2331.44,362.28,1969.16,107813.08,mortgage,101,1
39,107813.08,2331.44,355.78,1975.66,105837.42,mortgage,101,1
40,105837.42,2331.44,349.26,1982.18,103855.24,mortgage,101,1
41,103855.24,2331.44,342.72,1988.72,101866.52,mortgage,101,1
42,101866.52,2331.44,336.16,1995.28,99871.24,mortgage,101,1
43,99871.24,2331.44,329.58,2001.86,97869.38,mortgage,101,1
44,97869.38,2331.44,322.97,2008.47,95860.91,mortgage,101,1
45,95860.91,2331.44,316.34,2015.1,93845.81,mortgage,101,1
46,93845.81,2331.44,309.69,2021.75,91824.06,mortgage,101,1
47,91824.06,2331.44,303.02,2028.42,89795.64,mortgage,101,1
48,89795.64,2331.44,296.33,2035.11,87760.53,mortgage,101,1
49,87760.53,2331.44,289.61,2041.83,85718.7,mortgage,101,1
50,85718.7,2331.44,282.87,2048.57,83670.13,mortgage,101,1
51,83670.13,2331.44,276.11,2055.33,81614.8,mortgage,101,1
52,81614.8,2331.44,269.33,2062.11,79552.69,mortgage,101,1
53,79552.69,2331.44,262.52,2068.92,77483.77,mortgage,101,1
54,77483.77,2331.44,255.7,2075.74,75408.03,mortgage,101,1
55,75408.03,2331.44,248.85,2082.59,73325.44,mortgage,101,1
56,73325.44,2331.44,241.97,2089.47,71235.97,mortgage,101,1
57,71235.97,2331.44,235.08,2096.36,69139.61,mortgage,101,1
58,69139.61,2331.44,228.16,2103.28,67036.33,mortgage,101,1
59,67036.33,2331.44,221.22,2110.22,64926.11,mortgage,101,1
60,64926.11,2331.44,214.26,2117.18,62808.93,mortgage,101,1
61,62808.93,2331.44,207.27,2124.17,60684.76,mortgage,101,1
62,60684.76,2331.44,200.26,2131.18,58553.58,mortgage,101,1
63,58553.58,2331.44,193.23,2138.21,56415.37,mortgage,101,1
64,56415.37,2331.44,186.17,2145.27,54270.1,mortgage,101,1
65,54270.1,2331.44,179.09,2152.35,52117.75,mortgage,101,1
66,52117.75,2331.44,171.99,2159.45,49958.3,mortgage,101,1
67,49958.3,2331.44,164.86,2166.58,47791.72,mortgage,101,1
68,47791.72,2331.44,157.71,2173.73,45617.99,mortgage,101,1
69,45617.99,2331.44,150.54,2180.9,43437.09,mortgage,101,1
70,43437.09,2331.44,143.34,2188.1,41248.99,mortgage,101,1
71,41248.99,2331.44,136.12,2195.32,39053.67,mortgage,101,1
72,39053.67,2331.44,128.88,2202.56,36851.11,mortgage,101,1
73,36851.11,2331.44,121.61,2209.83,34641.28,mortgage,101,1
74,34641.28,2331.44,114.32,2217.12,32424.16,mortgage,101,1
75,32424.16,2331.44,107.0,2224.44,30199.72,mortgage,101,1
76,30199.72,2331.44,99.66,2231.78,27967.94,mortgage,101,1
77,27967.94,2331.44,92.29,2239.15,25728.79,mortgage,101,1
78,25728.79,2331.44,84.91,2246.53,23482.26,mortgage,101,1
79,23482.26,2331.44,77.49,2253.95,21228.31,mortgage,101,1
80,21228.31,2331.44,70.05,2261.39,18966.92,mortgage,101,1
81,18966.92,2331.44,62.59,2268.85,16698.07,mortgage,101,1
82,16698.07,2331.44,55.1,2276.34,14421.73,mortgage,101,1
83,14421.73,2331.44,47.59,2283.85,12137.88,mortgage,101,1
84,12137.88,2331.44,40.06,2291.38,9846.5,mortgage,101,1
85,9846.5,2331.44,32.49,2298.95,7547.55,mortgage,101,1
86,7547.55,2331.44,24.91,2306.53,5241.02,mortgage,101,1
87,5241.02,2331.44,17.3,2314.14,2926.88,mortgage,101,1
88,2926.88,2331.44,9.66,2321.78,605.1,mortgage,101,1
89,605.1,2331.44,2.0,2329.44,-1724.34,mortgage,101,1
0,4000.0,70.0,16.0,54.0,3946.0,testing,101,2
1,3946.0,70.0,15.78,54.22,3891.78,testing,101,2
2,3891.78,70.0,15.57,54.43,3837.35,testing,101,2
3,3837.35,70.0,15.35,54.65,3782.7,testing,101,2
4,3782.7,70.0,15.13,54.87,3727.83,testing,101,2
5,3727.83,70.0,14.91,55.09,3672.74,testing,101,2
6,3672.74,70.0,14.69,55.31,3617.43,testing,101,2
7,3617.43,70.0,14.47,55.53,3561.9,testing,101,2
8,3561.9,70.0,14.25,55.75,3506.15,testing,101,2
9,3506.15,70.0,14.02,55.98,3450.17,testing,101,2
10,3450.17,70.0,13.8,56.2,3393.97,testing,101,2
11,3393.97,70.0,13.58,56.42,3337.55,testing,101,2
12,3337.55,70.0,13.35,56.65,3280.9,testing,101,2
13,3280.9,70.0,13.12,56.88,3224.02,testing,101,2
14,3224.02,70.0,12.9,57.1,3166.92,testing,101,2
15,3166.92,70.0,12.67,57.33,3109.59,testing,101,2
16,3109.59,70.0,12.44,57.56,3052.03,testing,101,2
17,3052.03,70.0,12.21,57.79,2994.24,testing,101,2
18,2994.24,70.0,11.98,58.02,2936.22,testing,101,2
19,2936.22,70.0,11.74,58.26,2877.96,testing,101,2
20,2877.96,70.0,11.51,58.49,2819.47,testing,101,2
21,2819.47,70.0,11.28,58.72,2760.75,testing,101,2
22,2760.75,70.0,11.04,58.96,2701.79,testing,101,2
23,2701.79,70.0,10.81,59.19,2642.6,testing,101,2
24,2642.6,70.0,10.57,59.43,2583.17,testing,101,2
25,2583.17,70.0,10.33,59.67,2523.5,testing,101,2
26,2523.5,70.0,10.09,59.91,2463.59,testing,101,2
27,2463.59,70.0,9.85,60.15,2403.44,testing,101,2
28,2403.44,70.0,9.61,60.39,2343.05,testing,101,2
29,2343.05,70.0,9.37,60.63,2282.42,testing,101,2
30,2282.42,70.0,9.13,60.87,2221.55,testing,101,2
31,2221.55,70.0,8.89,61.11,2160.44,testing,101,2
32,2160.44,70.0,8.64,61.36,2099.08,testing,101,2
33,2099.08,70.0,8.4,61.6,2037.48,testing,101,2
34,2037.48,70.0,8.15,61.85,1975.63,testing,101,2
35,1975.63,70.0,7.9,62.1,1913.53,testing,101,2
36,1913.53,70.0,7.65,62.35,1851.18,testing,101,2
37,1851.18,70.0,7.4,62.6,1788.58,testing,101,2
38,1788.58,70.0,7.15,62.85,1725.73,testing,101,2
39,1725.73,70.0,6.9,63.1,1662.63,testing,101,2
40,1662.63,70.0,6.65,63.35,1599.28,testing,101,2
41,1599.28,70.0,6.4,63.6,1535.68,testing,101,2
42,1535.68,70.0,6.14,63.86,1471.82,testing,101,2
43,1471.82,70.0,5.89,64.11,1407.71,testing,101,2
44,1407.71,70.0,5.63,64.37,1343.34,testing,101,2
45,1343.34,70.0,5.37,64.63,1278.71,testing,101,2
46,1278.71,70.0,5.11,64.89,1213.82,testing,101,2
47,1213.82,70.0,4.86,65.14,1148.68,testing,101,2
48,1148.68,70.0,4.59,65.41,1083.27,testing,101,2
49,1083.27,70.0,4.33,65.67,1017.6,testing,101,2
50,1017.6,70.0,4.07,65.93,951.67,testing,101,2
51,951.67,70.0,3.81,66.19,885.48,testing,101,2
52,885.48,70.0,3.54,66.46,819.02,testing,101,2
53,819.02,70.0,3.28,66.72,752.3,testing,101,2
54,752.3,70.0,3.01,66.99,685.31,testing,101,2
55,685.31,70.0,2.74,67.26,618.05,testing,101,2
56,618.05,70.0,2.47,67.53,550.52,testing,101,2
57,550.52,70.0,2.2,67.8,482.72,testing,101,2
58,482.72,70.0,1.93,68.07,414.65,testing,101,2
59,414.65,70.0,1.66,68.34,346.31,testing,101,2
60,346.31,70.0,1.39,68.61,277.7,testing,101,2
61,277.7,70.0,1.11,68.89,208.81,testing,101,2
62,208.81,70.0,0.84,69.16,139.65,testing,101,2
63,139.65,70.0,0.56,69.44,70.21,testing,101,2
64,70.21,70.0,0.28,69.72,0.49,testing,101,2
65,0.49,70.0,0.0,70.0,-69.51,testing,101,2
0,20000.0,191.04,108.0,83.04,19916.96,WellsFargo2,101,3
1,19916.96,191.04,107.55,83.49,19833.47,WellsFargo2,101,3
2,19833.47,191.04,107.1,83.94,19749.53,WellsFargo2,101,3
3,19749.53,191.04,106.65,84.39,19665.14,WellsFargo2,101,3
4,19665.14,191.04,106.19,84.85,19580.29,WellsFargo2,101,3
5,19580.29,191.04,105.73,85.31,19494.98,WellsFargo2,101,3
6,19494.98,191.04,105.27,85.77,19409.21,WellsFargo2,101,3
7,19409.21,191.04,104.81,86.23,19322.98,WellsFargo2,101,3
8,19322.98,191.04,104.34,86.7,19236.28,WellsFargo2,101,3
9,19236.28,191.04,103.88,87.16,19149.12,WellsFargo2,101,3
10,19149.12,191.04,103.41,87.63,19061.49,WellsFargo2,101,3
11,19061.49,191.04,102.93,88.11,18973.38,WellsFargo2,101,3
12,18973.38,191.04,102.46,88.58,18884.8,WellsFargo2,101,3
13,18884.8,191.04,101.98,89.06,18795.74,WellsFargo2,101,3
14,18795.74,191.04,101.5,89.54,18706.2,WellsFargo2,101,3
15,18706.2,191.04,101.01,90.03,18616.17,WellsFargo2,101,3
16,18616.17,191.04,100.53,90.51,18525.66,WellsFargo2,101,3
17,18525.66,191.04,100.04,91.0,18434.66,WellsFargo2,101,3
18,18434.66,191.04,99.55,91.49,18343.17,WellsFargo2,101,3
19,18343.17,191.04,99.05,91.99,18251.18,WellsFargo2,101,3
20,18251.18,191.04,98.56,92.48,18158.7,WellsFargo2,101,3
21,18158.7,191.04,98.06,92.98,18065.72,WellsFargo2,101,3
22,18065.72,191.04,97.55,93.49,17972.23,WellsFargo2,101,3
23,17972.23,191.04,97.05,93.99,17878.24,WellsFargo2,101,3
24,17878.24,191.04,96.54,94.5,17783.74,WellsFargo2,101,3
25,17783.74,191.04,96.03,95.01,17688.73,WellsFargo2,101,3
26,17688.73,191.04,95.52,95.52,17593.21,WellsFargo2,101,3
27,17593.21,191.04,95.0,96.04,17497.17,WellsFargo2,101,3
28,17497.17,191.04,94.48,96.56,17400.61,WellsFargo2,101,3
29,17400.61,191.04,93.96,97.08,17303.53,WellsFargo2,101,3
30,17303.53,191.04,93.44,97.6,17205.93,WellsFargo2,101,3
31,17205.93,191.04,92.91,98.13,17107.8,WellsFargo2,101,3
32,17107.8,191.04,92.38,98.66,17009.14,WellsFargo2,101,3
33,17009.14,191.04,91.85,99.19,16909.95,WellsFargo2,101,3
34,16909.95,191.04,91.31,99.73,16810.22,WellsFargo2,101,3
35,16810.22,191.04,90.78,100.26,16709.96,WellsFargo2,101,3
36,16709.96,191.04,90.23,100.81,16609.15,WellsFargo2,101,3
37,16609.15,191.04,89.69,101.35,16507.8,WellsFargo2,101,3
38,16507.8,191.04,89.14,101.9,16405.9,WellsFargo2,101,3
39,16405.9,191.04,88.59,102.45,16303.45,WellsFargo2,101,3
40,16303.45,191.04,88.04,103.0,16200.45,WellsFargo2,101,3
41,16200.45,191.04,87.48,103.56,16096.89,WellsFargo2,101,3
42,16096.89,191.04,86.92,104.12,15992.77,WellsFargo2,101,3
43,15992.77,191.04,86.36,104.68,15888.09,WellsFargo2,101,3
44,15888.09,191.04,85.8,105.24,15782.85,WellsFargo2,101,3
45,15782.85,191.04,85.23,105.81,15677.04,WellsFargo2,101,3
46,15677.04,191.04,84.66,106.38,15570.66,WellsFargo2,101,3
47,15570.66,191.04,84.08,106.96,15463.7,WellsFargo2,101,3
48,15463.7,191.04,83.5,107.54,15356.16,WellsFargo2,101,3
49,15356.16,191.04,82.92,108.12,15248.04,WellsFargo2,101,3
50,15248.04,191.04,82.34,108.7,15139.34,WellsFargo2,101,3
51,15139.34,191.04,81.75,109.29,15030.05,WellsFargo2,101,3
52,15030.05,191.04,81.16,109.88,14920.17,WellsFargo2,101,3
53,14920.17,191.04,80.57,110.47,14809.7,WellsFargo2,101,3
54,14809.7,191.04,79.97,111.07,14698.63,WellsFargo2,101,3
55,14698.63,191.04,79.37,111.67,14586.96,WellsFargo2,101,3
56,14586.96,191.04,78.77,112.27,14474.69,WellsFargo2,101,3
57,14474.69,191.04,78.16,112.88,14361.81,WellsFargo2,101,3
58,14361.81,191.04,77.55,113.49,14248.32,WellsFargo2,101,3
59,14248.32,191.04,76.94,114.1,14134.22,WellsFargo2,101,3
60,14134.22,191.04,76.32,114.72,14019.5,WellsFargo2,101,3
61,14019.5,191.04,75.71,115.33,13904.17,WellsFargo2,101,3
62,13904.17,191.04,75.08,115.96,13788.21,WellsFargo2,101,3
63,13788.21,191.04,74.46,116.58,13671.63,WellsFargo2,101,3
64,13671.63,191.04,73.83,117.21,13554.42,WellsFargo2,101,3
65,13554.42,260.55,73.19,187.36,13367.06,WellsFargo2,101,3
66,13367.06,2592.48,72.18,2520.3,10846.76,WellsFargo2,101,3
67,10846.76,2592.48,58.57,2533.91,8312.85,WellsFargo2,101,3
68,8312.85,2592.48,44.89,2547.59,5765.26,WellsFargo2,101,3
69,5765.26,2592.48,31.13,2561.35,3203.91,WellsFargo2,101,3
70,3203.91,2592.48,17.3,2575.18,628.73,WellsFargo2,101,3
71,628.73,2592.48,3.4,2589.08,-1960.35,WellsFargo2,101,3
0,5000.0,333.0,36.0,297.0,4703.0,Car,101,4
1,4703.0,333.0,33.86,299.14,4403.86,Car,101,4
2,4403.86,333.0,31.71,301.29,4102.57,Car,101,4
3,4102.57,333.0,29.54,303.46,3799.11,Car,101,4
4,3799.11,333.0,27.35,305.65,3493.46,Car,101,4
5,3493.46,333.0,25.15,307.85,3185.61,Car,101,4
6,3185.61,333.0,22.94,310.06,2875.55,Car,101,4
7,2875.55,333.0,20.7,312.3,2563.25,Car,101,4
8,2563.25,333.0,18.46,314.54,2248.71,Car,101,4
9,2248.71,333.0,16.19,316.81,1931.9,Car,101,4
10,1931.9,333.0,13.91,319.09,1612.81,Car,101,4
11,1612.81,333.0,11.61,321.39,1291.42,Car,101,4
12,1291.42,333.0,9.3,323.7,967.72,Car,101,4
13,967.72,333.0,6.97,326.03,641.69,Car,101,4
14,641.69,333.0,4.62,328.38,313.31,Car,101,4
15,313.31,333.0,2.26,330.74,-17.43,Car,101,4
0,8250.57,84.62,53.63,30.99,8219.58,WellsFargo1,101,5
1,8219.58,84.62,53.43,31.19,8188.39,WellsFargo1,101,5
2,8188.39,84.62,53.22,31.4,8156.99,WellsFargo1,101,5
3,8156.99,84.62,53.02,31.6,8125.39,WellsFargo1,101,5
4,8125.39,84.62,52.82,31.8,8093.59,WellsFargo1,101,5
5,8093.59,84.62,52.61,32.01,8061.58,WellsFargo1,101,5
6,8061.58,84.62,52.4,32.22,8029.36,WellsFargo1,101,5
7,8029.36,84.62,52.19,32.43,7996.93,WellsFargo1,101,5
8,7996.93,84.62,51.98,32.64,7964.29,WellsFargo1,101,5
9,7964.29,84.62,51.77,32.85,7931.44,WellsFargo1,101,5
10,7931.44,84.62,51.55,33.07,7898.37,WellsFargo1,101,5
11,7898.37,84.62,51.34,33.28,7865.09,WellsFargo1,101,5
12,7865.09,84.62,51.12,33.5,7831.59,WellsFargo1,101,5
13,7831.59,84.62,50.91,33.71,7797.88,WellsFargo1,101,5
14,7797.88,84.62,50.69,33.93,7763.95,WellsFargo1,101,5
15,7763.95,102.05,50.47,51.58,7712.37,WellsFargo1,101,5
16,7712.37,3010.1,50.13,2959.97,4752.4,WellsFargo1,101,5
17,4752.4,3010.1,30.89,2979.21,1773.19,WellsFargo1,101,5
18,1773.19,3010.1,11.53,2998.57,-1225.38,WellsFargo1,101,5
0,180000.0,2331.44,594.0,1737.44,178262.56,mortgage,102,1
1,178262.56,2331.44,588.27,1743.17,176519.39,mortgage,102,1
2,176519.39,2331.44,582.51,1748.93,174770.46,mortgage,102,1
3,174770.46,2331.44,576.74,1754.7,173015.76,mortgage,102,1
4,173015.76,2331.44,570.95,1760.49,171255.27,mortgage,102,1
5,171255.27,2331.44,565.14,1766.3,169488.97,mortgage,102,1
6,169488.97,2331.44,559.31,1772.13,167716.84,mortgage,102,1
7,167716.84,2331.44,553.47,1777.97,165938.87,mortgage,102,1
8,165938.87,2331.44,547.6,1783.84,164155.03,mortgage,102,1
9,164155.03,2331.44,541.71,1789.73,162365.3,mortgage,102,1
10,162365.3,2331.44,535.81,1795.63,160569.67,mortgage,102,1
11,160569.67,2331.44,529.88,1801.56,158768.11,mortgage,102,1
12,158768.11,2331.44,523.93,1807.51,156960.6,mortgage,102,1
13,156960.6,2331.44,517.97,1813.47,155147.13,mortgage,102,1
14,155147.13,2331.44,511.99,1819.45,153327.68,mortgage,102,1
15,153327.68,2331.44,505.98,1825.46,151502.22,mortgage,102,1
16,151502.22,2331.44,499.96,1831.48,149670.74,mortgage,102,1
17,149670.74,2331.44,493.91,1837.53,147833.21,mortgage,102,1
18,147833.21,2331.44,487.85,1843.59,145989.62,mortgage,102,1
19,145989.62,2331.44,481.77,1849.67,144139.95,mortgage,102,1
20,144139.95,2331.44,475.66,1855.78,142284.17,mortgage,102,1
21,142284.17,2331.44,469.54,1861.9,140422.27,mortgage,102,1
22,140422.27,2331.44,463.39,1868.05,138554.22,mortgage,102,1
23,138554.22,2331.44,457.23,1874.21,136680.01,mortgage,102,1
24,136680.01,2331.44,451.04,1880.4,134799.61,mortgage,102,1
25,134799.61,2331.44,444.84,1886.6,132913.01,mortgage,102,1
26,132913.01,2331.44,438.61,1892.83,131020.18,mortgage,102,1
27,131020.18,2331.44,432.37,1899.07,129121.11,mortgage,102,1
28,129121.11,2331.44,426.1,1905.34,127215.77,mortgage,102,1
29,127215.77,2331.44,419.81,1911.63,125304.14,mortgage,102,1
30,125304.14,2331.44,413.5,1917.94,123386.2,mortgage,102,1
31,123386.2,2331.44,407.17,1924.27,121461.93,mortgage,102,1
32,121461.93,2331.44,400.82,1930.62,119531.31,mortgage,102,1
33,119531.31,2331.44,394.45,1936.99,117594.32,mortgage,102,1
34,117594.32,2331.44,388.06,1943.38,115650.94,mortgage,102,1
35,115650.94,2331.44,381.65,1949.79,113701.15,mortgage,102,1
36,113701.15,2331.44,375.21,1956.23,111744.92,mortgage,102,1
37,111744.92,2331.44,368.76,1962.68,109782.24,mortgage,102,1
38,109782.24,2331.44,362.28,1969.16,107813.08,mortgage,102,1
39,107813.08,2331.44,355.78,1975.66,105837.42,mortgage,102,1
40,105837.42,2331.44,349.26,1982.18,103855.24,mortgage,102,1
41,103855.24,2331.44,342.72,1988.72,101866.52,mortgage,102,1
42,101866.52,2331.44,336.16,1995.28,99871.24,mortgage,102,1
43,99871.24,2331.44,329.58,2001.86,97869.38,mortgage,102,1
44,97869.38,2331.44,322.97,2008.47,95860.91,mortgage,102,1
45,95860.91,2331.44,316.34,2015.1,93845.81,mortgage,102,1
46,93845.81,2331.44,309.69,2021.75,91824.06,mortgage,102,1
47,91824.06,2331.44,303.02,2028.42,89795.64,mortgage,102,1
48,89795.64,2331.44,296.33,2035.11,87760.53,mortgage,102,1
49,87760.53,2331.44,289.61,2041.83,85718.7,mortgage,102,1
50,85718.7,2331.44,282.87,2048.57,83670.13,mortgage,102,1
51,83670.13,2331.44,276.11,2055.33,81614.8,mortgage,102,1
52,81614.8,2331.44,269.33,2062.11,79552.69,mortgage,102,1
53,79552.69,2331.44,262.52,2068.92,77483.77,mortgage,102,1
54,77483.77,2331.44,255.7,2075.74,75408.03,mortgage,102,1
55,75408.03,2331.44,248.85,2082.59,73325.44,mortgage,102,1
56,73325.44,2331.44,241.97,2089.47,71235.97,mortgage,102,1
57,71235.97,2331.44,235.08,2096.36,69139.61,mortgage,102,1
58,69139.61,2331.44,228.16,2103.28,67036.33,mortgage,102,1
59,67036.33,2331.44,221.22,2110.22,64926.11,mortgage,102,1
60,64926.11,2331.44,214.26,2117.18,62808.93,mortgage,102,1
61,62808.93,2331.44,207.27,2124.17,60684.76,mortgage,102,1
62,60684.76,2331.44,200.26,2131.18,58553.58,mortgage,102,1
63,58553.58,2331.44,193.23,2138.21,56415.37,mortgage,102,1
64,56415.37,2331.44,186.17,2145.27,54270.1,mortgage,102,1
65,54270.1,2331.44,179.09,2152.35,52117.75,mortgage,102,1
66,52117.75,2331.44,171.99,2159.45,49958.3,mortgage,102,1
67,49958.3,2331.44,164.86,2166.58,47791.72,mortgage,102,1
68,47791.72,2331.44,157.71,2173.73,45617.99,mortgage,102,1
69,45617.99,2331.44,150.54,2180.9,43437.09,mortgage,102,1
70,43437.09,2331.44,143.34,2188.1,41248.99,mortgage,102,1
71,41248.99,2331.44,136.12,2195.32,39053.67,mortgage,102,1
72,39053.67,2331.44,128.88,2202.56,36851.11,mortgage,102,1
73,36851.11,2331.44,121.61,2209.83,34641.28,mortgage,102,1
74,34641.28,2331.44,114.32,2217.12,32424.16,mortgage,102,1
75,32424.16,2331.44,107.0,2224.44,30199.72,mortgage,102,1
76,30199.72,2331.44,99.66,2231.78,27967.94,mortgage,102,1
77,27967.94,2331.44,92.29,2239.15,25728.79,mortgage,102,1
78,25728.79,2331.44,84.91,2246.53,23482.26,mortgage,102,1
79,23482.26,2331.44,77.49,2253.95,21228.31,mortgage,102,1
80,21228.31,2331.44,70.05,2261.39,18966.92,mortgage,102,1
81,18966.92,2331.44,62.59,2268.85,16698.07,mortgage,102,1
82,16698.07,2331.44,55.1,2276.34,14421.73,mortgage,102,1
83,14421.73,2331.44,47.59,2283.85,12137.88,mortgage,102,1
84,12137.88,2331.44,40.06,2291.38,9846.5,mortgage,102,1
85,9846.5,2331.44,32.49,2298.95,7547.55,mortgage,102,1
86,7547.55,2331.44,24.91,2306.53,5241.02,mortgage,102,1
87,5241.02,2331.44,17.3,2314.14,2926.88,mortgage,102,1
88,2926.88,2331.44,9.66,2321.78,605.1,mortgage,102,1
89,605.1,2331.44,2.0,2329.44,-1724.34,mortgage,102,1
0,4000.0,70.0,16.0,54.0,3946.0,testing,102,2
1,3946.0,70.0,15.78,54.22,3891.78,testing,102,2
2,3891.78,70.0,15.57,54.43,3837.35,testing,102,2
3,3837.35,70.0,15.35,54.65,3782.7,testing,102,2
4,3782.7,70.0,15.13,54.87,3727.83,testing,102,2
5,3727.83,70.0,14.91,55.09,3672.74,testing,102,2
6,3672.74,70.0,14.69,55.31,3617.43,testing,102,2
7,3617.43,70.0,14.47,55.53,3561.9,testing,102,2
8,3561.9,70.0,14.25,55.75,3506.15,testing,102,2
9,3506.15,70.0,14.02,55.98,3450.17,testing,102,2
10,3450.17,70.0,13.8,56.2,3393.97,testing,102,2
11,3393.97,70.0,13.58,56.42,3337.55,testing,102,2
12,3337.55,70.0,13.35,56.65,3280.9,testing,102,2
13,3280.9,70.0,13.12,56.88,3224.02,testing,102,2
14,3224.02,70.0,12.9,57.1,3166.92,testing,102,2
15,3166.92,70.0,12.67,57.33,3109.59,testing,102,2
16,3109.59,70.0,12.44,57.56,3052.03,testing,102,2
17,3052.03,70.0,12.21,57.79,2994.24,testing,102,2
18,2994.24,70.0,11.98,58.02,2936.22,testing,102,2
19,2936.22,70.0,11.74,58.26,2877.96,testing,102,2
20,2877.96,70.0,11.51,58.49,2819.47,testing,102,2
21,2819.47,70.0,11.28,58.72,2760.75,testing,102,2
22,2760.75,70.0,11.04,58.96,2701.79,testing,102,2
23,2701.79,70.0,10.81,59.19,2642.6,testing,102,2
24,2642.6,70.0,10.57,59.43,2583.17,testing,102,2
25,2583.17,70.0,10.33,59.67,2523.5,testing,102,2
26,2523.5,70.0,10.09,59.91,2463.59,testing,102,2
27,2463.59,70.0,9.85,60.15,2403.44,testing,102,2
28,2403.44,70.0,9.61,60.39,2343.05,testing,102,2
29,2343.05,70.0,9.37,60.63,2282.42,testing,102,2
30,2282.42,70.0,9.13,60.87,2221.55,testing,102,2
31,2221.55,70.0,8.89,61.11,2160.44,testing,102,2
32,2160.44,70.0,8.64,61.36,2099.08,testing,102,2
33,2099.08,70.0,8.4,61.6,2037.48,testing,102,2
34,2037.48,70.0,8.15,61.85,1975.63,testing,102,2
35,1975.63,70.0,7.9,62.1,1913.53,testing,102,2
36,1913.53,70.0,7.65,62.35,1851.18,testing,102,2
37,1851.18,70.0,7.4,62.6,1788.58,testing,102,2
38,1788.58,70.0,7.15,62.85,1725.73,testing,102,2
39,1725.73,70.0,6.9,63.1,1662.63,testing,102,2
40,1662.63,70.0,6.65,63.35,1599.28,testing,102,2
41,1599.28,70.0,6.4,63.6,1535.68,testing,102,2
42,1535.68,70.0,6.14,63.86,1471.82,testing,102,2
43,1471.82,70.0,5.89,64.11,1407.71,testing,102,2
44,1407.71,70.0,5.63,64.37,1343.34,testing,102,2
45,1343.34,70.0,5.37,64.63,1278.71,testing,102,2
46,1278.71,70.0,5.11,64.89,1213.82,testing,102,2
47,1213.82,70.0,4.86,65.14,1148.68,testing,102,2
48,1148.68,70.0,4.59,65.41,1083.27,testing,102,2
49,1083.27,70.0,4.33,65.67,1017.6,testing,102,2
50,1017.6,70.0,4.07,65.93,951.67,testing,102,2
51,951.67,70.0,3.81,66.19,885.48,testing,102,2
52,885.48,70.0,3.54,66.46,819.02,testing,102,2
53,819.02,70.0,3.28,66.72,752.3,testing,102,2
54,752.3,70.0,3.01,66.99,685.31,testing,102,2
55,685.31,70.0,2.74,67.26,618.05,testing,102,2
56,618.05,70.0,2.47,67.53,550.52,testing,102,2
57,550.52,70.0,2.2,67.8,482.72,testing,102,2
58,482.72,70.0,1.93,68.07,414.65,testing,102,2
59,414.65,70.0,1.66,68.34,346.31,testing,102,2
60,346.31,70.0,1.39,68.61,277.7,testing,102,2
61,277.7,70.0,1.11,68.89,208.81,testing,102,2
62,208.81,70.0,0.84,69.16,139.65,testing,102,2
63,139.65,70.0,0.56,69.44,70.21,testing,102,2
64,70.21,70.0,0.28,69.72,0.49,testing,102,2
65,0.49,70.0,0.0,70.0,-69.51,testing,102,2
0,20000.0,191.04,108.0,83.04,19916.96,WellsFargo2,102,3
1,19916.96,191.04,107.55,83.49,19833.47,WellsFargo2,102,3
2,19833.47,191.04,107.1,83.94,19749.53,WellsFargo2,102,3
3,19749.53,191.04,106.65,84.39,19665.14,WellsFargo2,102,3
4,19665.14,191.04,106.19,84.85,19580.29,WellsFargo2,102,3
5,19580.29,191.04,105.73,85.31,19494.98,WellsFargo2,102,3
6,19494.98,191.04,105.27,85.77,19409.21,WellsFargo2,102,3
7,19409.21,191.04,104.81,86.23,19322.98,WellsFargo2,102,3
8,19322.98,191.04,104.34,86.7,19236.28,WellsFargo2,102,3
9,19236.28,191.04,103.88,87.16,19149.12,WellsFargo2,102,3
10,19149.12,191.04,103.41,87.63,19061.49,WellsFargo2,102,3
11,19061.49,191.04,102.93,88.11,18973.38,WellsFargo2,102,3
12,18973.38,191.04,102.46,88.58,18884.8,WellsFargo2,102,3
13,18884.8,191.04,101.98,89.06,18795.74,WellsFargo2,102,3
14,18795.74,191.04,101.5,89.54,18706.2,WellsFargo2,102,3
15,18706.2,191.04,101.01,90.03,18616.17,WellsFargo2,102,3
16,18616.17,191.04,100.53,90.51,18525.66,WellsFargo2,102,3
17,18525.66,191.04,100.04,91.0,18434.66,WellsFargo2,102,3
18,18434.66,191.04,99.55,91.49,18343.17,WellsFargo2,102,3
19,18343.17,191.04,99.05,91.99,18251.18,WellsFargo2,102,3
20,18251.18,191.04,98.56,92.48,18158.7,WellsFargo2,102,3
21,18158.7,191.04,98.06,92.98,18065.72,WellsFargo2,102,3
22,18065.72,191.04,97.55,93.49,17972.23,WellsFargo2,102,3
23,17972.23,191.04,97.05,93.99,17878.24,WellsFargo2,102,3
24,17878.24,191.04,96.54,94.5,17783.74,WellsFargo2,102,3
25,17783.74,191.04,96.03,95.01,17688.73,WellsFargo2,102,3
26,17688.73,191.04,95.52,95.52,17593.21,WellsFargo2,102,3
27,17593.21,191.04,95.0,96.04,17497.17,WellsFargo2,102,3
28,17497.17,191.04,94.48,96.56,17400.61,WellsFargo2,102,3
29,17400.61,191.04,93.96,97.08,17303.53,WellsFargo2,102,3
30,17303.53,191.04,93.44,97.6,17205.93,WellsFargo2,102,3
31,17205.93,191.04,92.91,98.13,17107.8,WellsFargo2,102,3
32,17107.8,191.04,92.38,98.66,17009.14,WellsFargo2,102,3
33,17009.14,191.04,91.85,99.19,16909.95,WellsFargo2,102,3
34,16909.95,191.04,91.31,99.73,16810.22,WellsFargo2,102,3
35,16810.22,191.04,90.78,100.26,16709.96,WellsFargo2,102,3
36,16709.96,191.04,90.23,100.81,16609.15,WellsFargo2,102,3
37,16609.15,191.04,89.69,101.35,16507.8,WellsFargo2,102,3
38,16507.8,191.04,89.14,101.9,16405.9,WellsFargo2,102,3
39,16405.9,191.04,88.59,102.45,16303.45,WellsFargo2,102,3
40,16303.45,191.04,88.04,103.0,16200.45,WellsFargo2,102,3
41,16200.45,191.04,87.48,103.56,16096.89,WellsFargo2,102,3
42,16096.89,191.04,86.92,104.12,15992.77,WellsFargo2,102,3
43,15992.77,191.04,86.36,104.68,15888.09,WellsFargo2,102,3
44,15888.09,191.04,85.8,105.24,15782.85,WellsFargo2,102,3
45,15782.85,191.04,85.23,105.81,15677.04,WellsFargo2,102,3
46,15677.04,191.04,84.66,106.38,15570.66,WellsFargo2,102,3
47,15570.66,191.04,84.08,106.96,15463.7,WellsFargo2,102,3
48,15463.7,191.04,83.5,107.54,15356.16,WellsFargo2,102,3
49,15356.16,191.04,82.92,108.12,15248.04,WellsFargo2,102,3
50,15248.04,191.04,82.34,108.7,15139.34,WellsFargo2,102,3
51,15139.34,191.04,81.75,109.29,15030.05,WellsFargo2,102,3
52,15030.05,191.04,81.16,109.88,14920.17,WellsFargo2,102,3
53,14920.17,191.04,80.57,110.47,14809.7,WellsFargo2,102,3
54,14809.7,191.04,79.97,111.07,14698.63,WellsFargo2,102,3
55,14698.63,191.04,79.37,111.67,14586.96,WellsFargo2,102,3
56,14586.96,191.04,78.77,112.27,14474.69,WellsFargo2,102,3
57,14474.69,191.04,78.16,112.88,14361.81,WellsFargo2,102,3
58,14361.81,191.04,77.55,113.49,14248.32,WellsFargo2,102,3
59,14248.32,191.04,76.94,114.1,14134.22,WellsFargo2,102,3
60,14134.22,191.04,76.32,114.72,14019.5,WellsFargo2,102,3
61,14019.5,191.04,75.71,115.33,13904.17,WellsFargo2,102,3
62,13904.17,191.04,75.08,115.96,13788.21,WellsFargo2,102,3
63,13788.21,191.04,74.46,116.58,13671.63,WellsFargo2,102,3
64,13671.63,191.04,73.83,117.21,13554.42,WellsFargo2,102,3
65,13554.42,260.55,73.19,187.36,13367.06,WellsFargo2,102,3
66,13367.06,2592.48,72.18,2520.3,10846.76,WellsFargo2,102,3
67,10846.76,2592.48,58.57,2533.91,8312.85,WellsFargo2,102,3
68,8312.85,2592.48,44.89,2547.59,5765.26,WellsFargo2,102,3
69,5765.26,2592.48,31.13,2561.35,3203.91,WellsFargo2,102,3
70,3203.91,2592.48,17.3,2575.18,628.73,WellsFargo2,102,3
71,628.73,2592.48,3.4,2589.08,-1960.35,WellsFargo2,102,3
0,8250.57,84.62,53.63,30.99,8219.58,WellsFargo1,102,4
1,8219.58,84.62,53.43,31.19,8188.39,WellsFargo1,102,4
2,8188.39,84.62,53.22,31.4,8156.99,WellsFargo1,102,4
3,8156.99,84.62,53.02,31.6,8125.39,WellsFargo1,102,4
4,8125.39,84.62,52.82,31.8,8093.59,WellsFargo1,102,4
5,8093.59,84.62,52.61,32.01,8061.58,WellsFargo1,102,4
6,8061.58,84.62,52.4,32.22,8029.36,WellsFargo1,102,4
7,8029.36,84.62,52.19,32.43,7996.93,WellsFargo1,102,4
8,7996.93,84.62,51.98,32.64,7964.29,WellsFargo1,102,4
9,7964.29,84.62,51.77,32.85,7931.44,WellsFargo1,102,4
10,7931.44,84.62,51.55,33.07,7898.37,WellsFargo1,102,4
11,7898.37,84.62,51.34,33.28,7865.09,WellsFargo1,102,4
12,7865.09,84.62,51.12,33.5,7831.59,WellsFargo1,102,4
13,7831.59,84.62,50.91,33.71,7797.88,WellsFargo1,102,4
14,7797.88,84.62,50.69,33.93,7763.95,WellsFargo1,102,4
15,7763.95,84.62,50.47,34.15,7729.8,WellsFargo1,102,4
16,7729.8,84.62,50.24,34.38,7695.42,WellsFargo1,102,4
17,7695.42,84.62,50.02,34.6,7660.82,WellsFargo1,102,4
18,7660.82,84.62,49.8,34.82,7626.0,WellsFargo1,102,4
19,7626.0,84.62,49.57,35.05,7590.95,WellsFargo1,102,4
20,7590.95,84.62,49.34,35.28,7555.67,WellsFargo1,102,4
21,7555.67,84.62,49.11,35.51,7520.16,WellsFargo1,102,4
22,7520.16,84.62,48.88,35.74,7484.42,WellsFargo1,102,4
23,7484.42,84.62,48.65,35.97,7448.45,WellsFargo1,102,4
24,7448.45,84.62,48.41,36.21,7412.24,WellsFargo1,102,4
25,7412.24,84.62,48.18,36.44,7375.8,WellsFargo1,102,4
26,7375.8,84.62,47.94,36.68,7339.12,WellsFargo1,102,4
27,7339.12,84.62,47.7,36.92,7302.2,WellsFargo1,102,4
28,7302.2,84.62,47.46,37.16,7265.04,WellsFargo1,102,4
29,7265.04,84.62,47.22,37.4,7227.64,WellsFargo1,102,4
30,7227.64,84.62,46.98,37.64,7190.0,WellsFargo1,102,4
31,7190.0,84.62,46.73,37.89,7152.11,WellsFargo1,102,4
32,7152.11,84.62,46.49,38.13,7113.98,WellsFargo1,102,4
33,7113.98,84.62,46.24,38.38,7075.6,WellsFargo1,102,4
34,7075.6,84.62,45.99,38.63,7036.97,WellsFargo1,102,4
35,7036.97,84.62,45.74,38.88,6998.09,WellsFargo1,102,4
36,6998.09,84.62,45.49,39.13,6958.96,WellsFargo1,102,4
37,6958.96,84.62,45.23,39.39,6919.57,WellsFargo1,102,4
38,6919.57,84.62,44.98,39.64,6879.93,WellsFargo1,102,4
39,6879.93,84.62,44.72,39.9,6840.03,WellsFargo1,102,4
40,6840.03,84.62,44.46,40.16,6799.87,WellsFargo1,102,4
41,6799.87,84.62,44.2,40.42,6759.45,WellsFargo1,102,4
42,6759.45,84.62,43.94,40.68,6718.77,WellsFargo1,102,4
43,6718.77,84.62,43.67,40.95,6677.82,WellsFargo1,102,4
44,6677.82,84.62,43.41,41.21,6636.61,WellsFargo1,102,4
45,6636.61,84.62,43.14,41.48,6595.13,WellsFargo1,102,4
46,6595.13,84.62,42.87,41.75,6553.38,WellsFargo1,102,4
47,6553.38,84.62,42.6,42.02,6511.36,WellsFargo1,102,4
48,6511.36,84.62,42.32,42.3,6469.06,WellsFargo1,102,4
49,6469.06,84.62,42.05,42.57,6426.49,WellsFargo1,102,4
50,6426.49,84.62,41.77,42.85,6383.64,WellsFargo1,102,4
51,6383.64,84.62,41.49,43.13,6340.51,WellsFargo1,102,4
52,6340.51,84.62,41.21,43.41,6297.1,WellsFargo1,102,4
53,6297.1,84.62,40.93,43.69,6253.41,WellsFargo1,102,4
54,6253.41,84.62,40.65,43.97,6209.44,WellsFargo1,102,4
55,6209.44,84.62,40.36,44.26,6165.18,WellsFargo1,102,4
56,6165.18,84.62,40.07,44.55,6120.63,WellsFargo1,102,4
57,6120.63,84.62,39.78,44.84,6075.79,WellsFargo1,102,4
58,6075.79,84.62,39.49,45.13,6030.66,WellsFargo1,102,4
59,6030.66,84.62,39.2,45.42,5985.24,WellsFargo1,102,4
60,5985.24,84.62,38.9,45.72,5939.52,WellsFargo1,102,4
61,5939.52,84.62,38.61,46.01,5893.51,WellsFargo1,102,4
62,5893.51,84.62,38.31,46.31,5847.2,WellsFargo1,102,4
63,5847.2,84.62,38.01,46.61,5800.59,WellsFargo1,102,4
64,5800.59,84.62,37.7,46.92,5753.67,WellsFargo1,102,4
65,5753.67,84.62,37.4,47.22,5706.45,WellsFargo1,102,4
66,5706.45,84.62,37.09,47.53,5658.92,WellsFargo1,102,4
67,5658.92,84.62,36.78,47.84,5611.08,WellsFargo1,102,4
68,5611.08,84.62,36.47,48.15,5562.93,WellsFargo1,102,4
69,5562.93,84.62,36.16,48.46,5514.47,WellsFargo1,102,4
70,5514.47,84.62,35.84,48.78,5465.69,WellsFargo1,102,4
71,5465.69,2044.97,35.53,2009.44,3456.25,WellsFargo1,102,4
72,3456.25,2677.1,22.47,2654.63,801.62,WellsFargo1,102,4
73,801.62,2677.1,5.21,2671.89,-1870.27,WellsFargo1,102,4
0,5000.0,333.0,36.0,297.0,4703.0,Car,102,5
1,4703.0,333.0,33.86,299.14,4403.86,Car,102,5
2,4403.86,333.0,31.71,301.29,4102.57,Car,102,5
3,4102.57,333.0,29.54,303.46,3799.11,Car,102,5
4,3799.11,333.0,27.35,305.65,3493.46,Car,102,5
5,3493.46,333.0,25.15,307.85,3185.61,Car,102,5
6,3185.61,333.0,22.94,310.06,2875.55,Car,102,5
7,2875.55,333.0,20.7,312.3,2563.25,Car,102,5
8,2563.25,333.0,18.46,314.54,2248.71,Car,102,5
9,2248.71,333.0,16.19,316.81,1931.9,Car,102,5
10,1931.9,333.0,13.91,319.09,1612.81,Car,102,5
11,1612.81,333.0,11.61,321.39,1291.42,Car,102,5
12,1291.42,333.0,9.3,323.7,967.72,Car,102,5
13,967.72,333.0,6.97,326.03,641.69,Car,102,5
14,641.69,333.0,4.62,328.38,313.31,Car,102,5
15,313.31,333.0,2.26,330.74,-17.43,Car,102,5
0,180000.0,2331.44,594.0,1737.44,178262.56,mortgage,103,1
1,178262.56,2331.44,588.27,1743.17,176519.39,mortgage,103,1
2,176519.39,2331.44,582.51,1748.93,174770.46,mortgage,103,1
3,174770.46,2331.44,576.74,1754.7,173015.76,mortgage,103,1
4,173015.76,2331.44,570.95,1760.49,171255.27,mortgage,103,1
5,171255.27,2331.44,565.14,1766.3,169488.97,mortgage,103,1
6,169488.97,2331.44,559.31,1772.13,167716.84,mortgage,103,1
7,167716.84,2331.44,553.47,1777.97,165938.87,mortgage,103,1
8,165938.87,2331.44,547.6,1783.84,164155.03,mortgage,103,1
9,164155.03,2331.44,541.71,1789.73,162365.3,mortgage,103,1
10,162365.3,2331.44,535.81,1795.63,160569.67,mortgage,103,1
11,160569.67,2331.44,529.88,1801.56,158768.11,mortgage,103,1
12,158768.11,2331.44,523.93,1807.51,156960.6,mortgage,103,1
13,156960.6,2331.44,517.97,1813.47,155147.13,mortgage,103,1
14,155147.13,2331.44,511.99,1819.45,153327.68,mortgage,103,1
15,153327.68,2331.44,505.98,1825.46,151502.22,mortgage,103,1
16,151502.22,2331.44,499.96,1831.48,149670.74,mortgage,103,1
17,149670.74,2331.44,493.91,1837.53,147833.21,mortgage,103,1
18,147833.21,2331.44,487.85,1843.59,145989.62,mortgage,103,1
19,145989.62,2331.44,481.77,1849.67,144139.95,mortgage,103,1
20,144139.95,2331.44,475.66,1855.78,142284.17,mortgage,103,1
21,142284.17,2331.44,469.54,1861.9,140422.27,mortgage,103,1
22,140422.27,2331.44,463.39,1868.05,138554.22,mortgage,103,1
23,138554.22,2331.44,457.23,1874.21,136680.01,mortgage,103,1
24,136680.01,2331.44,451.04,1880.4,134799.61,mortgage,103,1
25,134799.61,2331.44,444.84,1886.6,132913.01,mortgage,103,1
26,132913.01,2331.44,438.61,1892.83,131020.18,mortgage,103,1
27,131020.18,2331.44,432.37,1899.07,129121.11,mortgage,103,1
28,129121.11,2331.44,426.1,1905.34,127215.77,mortgage,103,1
29,127215.77,2331.44,419.81,1911.63,125304.14,mortgage,103,1
30,125304.14,2331.44,413.5,1917.94,123386.2,mortgage,103,1
31,123386.2,2331.44,407.17,1924.27,121461.93,mortgage,103,1
32,121461.93,2331.44,400.82,1930.62,119531.31,mortgage,103,1
33,119531.31,2331.44,394.45,1936.99,117594.32,mortgage,103,1
34,117594.32,2331.44,388.06,1943.38,115650.94,mortgage,103,1
35,115650.94,2331.44,381.65,1949.79,113701.15,mortgage,103,1
36,113701.15,2331.44,375.21,1956.23,111744.92,mortgage,103,1
37,111744.92,2331.44,368.76,1962.68,109782.24,mortgage,103,1
38,109782.24,2331.44,362.28,1969.16,107813.08,mortgage,103,1
39,107813.08,2331.44,355.78,1975.66,105837.42,mortgage,103,1
40,105837.42,2331.44,349.26,1982.18,103855.24,mortgage,103,1
41,103855.24,2331.44,342.72,1988.72,101866.52,mortgage,103,1
42,101866.52,2331.44,336.16,1995.28,99871.24,mortgage,103,1
43,99871.24,2331.44,329.58,2001.86,97869.38,mortgage,103,1
44,97869.38,2331.44,322.97,2008.47,95860.91,mortgage,103,1
45,95860.91,2331.44,316.34,2015.1,93845.81,mortgage,103,1
46,93845.81,2331.44,309.69,2021.75,91824.06,mortgage,103,1
47,91824.06,2331.44,303.02,2028.42,89795.64,mortgage,103,1
48,89795.64,2331.44,296.33,2035.11,87760.53,mortgage,103,1
49,87760.53,2331.44,289.61,2041.83,85718.7,mortgage,103,1
50,85718.7,2331.44,282.87,2048.57,83670.13,mortgage,103,1
51,83670.13,2331.44,276.11,2055.33,81614.8,mortgage,103,1
52,81614.8,2331.44,269.33,2062.11,79552.69,mortgage,103,1
53,79552.69,2331.44,262.52,2068.92,77483.77,mortgage,103,1
54,77483.77,2331.44,255.7,2075.74,75408.03,mortgage,103,1
55,75408.03,2331.44,248.85,2082.59,73325.44,mortgage,103,1
56,73325.44,2331.44,241.97,2089.47,71235.97,mortgage,103,1
57,71235.97,2331.44,235.08,2096.36,69139.61,mortgage,103,1
58,69139.61,2331.44,228.16,2103.28,67036.33,mortgage,103,1
59,67036.33,2331.44,221.22,2110.22,64926.11,mortgage,103,1
60,64926.11,2331.44,214.26,2117.18,62808.93,mortgage,103,1
61,62808.93,2331.44,207.27,2124.17,60684.76,mortgage,103,1
62,60684.76,2331.44,200.26,2131.18,58553.58,mortgage,103,1
63,58553.58,2331.44,193.23,2138.21,56415.37,mortgage,103,1
64,56415.37,2331.44,186.17,2145.27,54270.1,mortgage,103,1
65,54270.1,2331.44,179.09,2152.35,52117.75,mortgage,103,1
66,52117.75,2331.44,171.99,2159.45,49958.3,mortgage,103,1
67,49958.3,2331.44,164.86,2166.58,47791.72,mortgage,103,1
68,47791.72,2331.44,157.71,2173.73,45617.99,mortgage,103,1
69,45617.99,2331.44,150.54,2180.9,43437.09,mortgage,103,1
70,43437.09,2331.44,143.34,2188.1,41248.99,mortgage,103,1
71,41248.99,2331.44,136.12,2195.32,39053.67,mortgage,103,1
72,39053.67,2331.44,128.88,2202.56,36851.11,mortgage,103,1
73,36851.11,2331.44,121.61,2209.83,34641.28,mortgage,103,1
74,34641.28,2331.44,114.32,2217.12,32424.16,mortgage,103,1
75,32424.16,2331.44,107.0,2224.44,30199.72,mortgage,103,1
76,30199.72,2331.44,99.66,2231.78,27967.94,mortgage,103,1
77,27967.94,2331.44,92.29,2239.15,25728.79,mortgage,103,1
78,25728.79,2331.44,84.91,2246.53,23482.26,mortgage,103,1
79,23482.26,2331.44,77.49,2253.95,21228.31,mortgage,103,1
80,21228.31,2331.44,70.05,2261.39,18966.92,mortgage,103,1
81,18966.92,2331.44,62.59,2268.85,16698.07,mortgage,103,1
82,16698.07,2331.44,55.1,2276.34,14421.73,mortgage,103,1
83,14421.73,2331.44,47.59,2283.85,12137.88,mortgage,103,1
84,12137.88,2331.44,40.06,2291.38,9846.5,mortgage,103,1
85,9846.5,2331.44,32.49,2298.95,7547.55,mortgage,103,1
86,7547.55,2331.44,24.91,2306.53,5241.02,mortgage,103,1
87,5241.02,2331.44,17.3,2314.14,2926.88,mortgage,103,1
88,2926.88,2331.44,9.66,2321.78,605.1,mortgage,103,1
89,605.1,2331.44,2.0,2329.44,-1724.34,mortgage,103,1
0,5000.0,333.0,36.0,297.0,4703.0,Car,103,2
1,4703.0,333.0,33.86,299.14,4403.86,Car,103,2
2,4403.86,333.0,31.71,301.29,4102.57,Car,103,2
3,4102.57,333.0,29.54,303.46,3799.11,Car,103,2
4,3799.11,333.0,27.35,305.65,3493.46,Car,103,2
5,3493.46,333.0,25.15,307.85,3185.61,Car,103,2
6,3185.61,333.0,22.94,310.06,2875.55,Car,103,2
7,2875.55,333.0,20.7,312.3,2563.25,Car,103,2
8,2563.25,333.0,18.46,314.54,2248.71,Car,103,2
9,2248.71,333.0,16.19,316.81,1931.9,Car,103,2
10,1931.9,333.0,13.91,319.09,1612.81,Car,103,2
11,1612.81,333.0,11.61,321.39,1291.42,Car,103,2
12,1291.42,333.0,9.3,323.7,967.72,Car,103,2
13,967.72,333.0,6.97,326.03,641.69,Car,103,2
14,641.69,333.0,4.62,328.38,313.31,Car,103,2
15,313.31,333.0,2.26,330.74,-17.43,Car,103,2
0,4000.0,70.0,16.0,54.0,3946.0,testing,103,3
1,3946.0,70.0,15.78,54.22,3891.78,testing,103,3
2,3891.78,70.0,15.57,54.43,3837.35,testing,103,3
3,3837.35,70.0,15.35,54.65,3782.7,testing,103,3
4,3782.7,70.0,15.13,54.87,3727.83,testing,103,3
5,3727.83,70.0,14.91,55.09,3672.74,testing,103,3
6,3672.74,70.0,14.69,55.31,3617.43,testing,103,3
7,3617.43,70.0,14.47,55.53,3561.9,testing,103,3
8,3561.9,70.0,14.25,55.75,3506.15,testing,103,3
9,3506.15,70.0,14.02,55.98,3450.17,testing,103,3
10,3450.17,70.0,13.8,56.2,3393.97,testing,103,3
11,3393.97,70.0,13.58,56.42,3337.55,testing,103,3
12,3337.55,70.0,13.35,56.65,3280.9,testing,103,3
13,3280.9,70.0,13.12,56.88,3224.02,testing,103,3
14,3224.02,70.0,12.9,57.1,3166.92,testing,103,3
15,3166.92,87.43,12.67,74.76,3092.16,testing,103,3
16,3092.16,2734.44,12.37,2722.07,370.09,testing,103,3
17,370.09,2734.44,1.48,2732.96,-2362.87,testing,103,3
0,8250.57,84.62,53.63,30.99,8219.58,WellsFargo1,103,4
1,8219.58,84.62,53.43,31.19,8188.39,WellsFargo1,103,4
2,8188.39,84.62,53.22,31.4,8156.99,WellsFargo1,103,4
3,8156.99,84.62,53.02,31.6,8125.39,WellsFargo1,103,4
4,8125.39,84.62,52.82,31.8,8093.59,WellsFargo1,103,4
5,8093.59,84.62,52.61,32.01,8061.58,WellsFargo1,103,4
6,8061.58,84.62,52.4,32.22,8029.36,WellsFargo1,103,4
7,8029.36,84.62,52.19,32.43,7996.93,WellsFargo1,103,4
8,7996.93,84.62,51.98,32.64,7964.29,WellsFargo1,103,4
9,7964.29,84.62,51.77,32.85,7931.44,WellsFargo1,103,4
10,7931.44,84.62,51.55,33.07,7898.37,WellsFargo1,103,4
11,7898.37,84.62,51.34,33.28,7865.09,WellsFargo1,103,4
12,7865.09,84.62,51.12,33.5,7831.59,WellsFargo1,103,4
13,7831.59,84.62,50.91,33.71,7797.88,WellsFargo1,103,4
14,7797.88,84.62,50.69,33.93,7763.95,WellsFargo1,103,4
15,7763.95,84.62,50.47,34.15,7729.8,WellsFargo1,103,4
16,7729.8,84.62,50.24,34.38,7695.42,WellsFargo1,103,4
17,7695.42,2447.49,50.02,2397.47,5297.95,WellsFargo1,103,4
18,5297.95,2819.06,34.44,2784.62,2513.33,WellsFargo1,103,4
19,2513.33,2819.06,16.34,2802.72,-289.39,WellsFargo1,103,4
0,20000.0,191.04,108.0,83.04,19916.96,WellsFargo2,103,5
1,19916.96,191.04,107.55,83.49,19833.47,WellsFargo2,103,5
2,19833.47,191.04,107.1,83.94,19749.53,WellsFargo2,103,5
3,19749.53,191.04,106.65,84.39,19665.14,WellsFargo2,103,5
4,19665.14,191.04,106.19,84.85,19580.29,WellsFargo2,103,5
5,19580.29,191.04,105.73,85.31,19494.98,WellsFargo2,103,5
6,19494.98,191.04,105.27,85.77,19409.21,WellsFargo2,103,5
7,19409.21,191.04,104.81,86.23,19322.98,WellsFargo2,103,5
8,19322.98,191.04,104.34,86.7,19236.28,WellsFargo2,103,5
9,19236.28,191.04,103.88,87.16,19149.12,WellsFargo2,103,5
10,19149.12,191.04,103.41,87.63,19061.49,WellsFargo2,103,5
11,19061.49,191.04,102.93,88.11,18973.38,WellsFargo2,103,5
12,18973.38,191.04,102.46,88.58,18884.8,WellsFargo2,103,5
13,18884.8,191.04,101.98,89.06,18795.74,WellsFargo2,103,5
14,18795.74,191.04,101.5,89.54,18706.2,WellsFargo2,103,5
15,18706.2,191.04,101.01,90.03,18616.17,WellsFargo2,103,5
16,18616.17,191.04,100.53,90.51,18525.66,WellsFargo2,103,5
17,18525.66,191.04,100.04,91.0,18434.66,WellsFargo2,103,5
18,18434.66,191.04,99.55,91.49,18343.17,WellsFargo2,103,5
19,18343.17,480.43,99.05,381.38,17961.79,WellsFargo2,103,5
20,17961.79,3010.1,96.99,2913.11,15048.68,WellsFargo2,103,5
21,15048.68,3010.1,81.26,2928.84,12119.84,WellsFargo2,103,5
22,12119.84,3010.1,65.45,2944.65,9175.19,WellsFargo2,103,5
23,9175.19,3010.1,49.55,2960.55,6214.64,WellsFargo2,103,5
24,6214.64,3010.1,33.56,2976.54,3238.1,WellsFargo2,103,5
25,3238.1,3010.1,17.49,2992.61,245.49,WellsFargo2,103,5
26,245.49,3010.1,1.33,3008.77,-2763.28,WellsFargo2,103,5
0,180000.0,2331.44,594.0,1737.44,178262.56,mortgage,104,1
1,178262.56,2331.44,588.27,1743.17,176519.39,mortgage,104,1
2,176519.39,2331.44,582.51,1748.93,174770.46,mortgage,104,1
3,174770.46,2331.44,576.74,1754.7,173015.76,mortgage,104,1
4,173015.76,2331.44,570.95,1760.49,171255.27,mortgage,104,1
5,171255.27,2331.44,565.14,1766.3,169488.97,mortgage,104,1
6,169488.97,2331.44,559.31,1772.13,167716.84,mortgage,104,1
7,167716.84,2331.44,553.47,1777.97,165938.87,mortgage,104,1
8,165938.87,2331.44,547.6,1783.84,164155.03,mortgage,104,1
9,164155.03,2331.44,541.71,1789.73,162365.3,mortgage,104,1
10,162365.3,2331.44,535.81,1795.63,160569.67,mortgage,104,1
11,160569.67,2331.44,529.88,1801.56,158768.11,mortgage,104,1
12,158768.11,2331.44,523.93,1807.51,156960.6,mortgage,104,1
13,156960.6,2331.44,517.97,1813.47,155147.13,mortgage,104,1
14,155147.13,2331.44,511.99,1819.45,153327.68,mortgage,104,1
15,153327.68,2331.44,505.98,1825.46,151502.22,mortgage,104,1
16,151502.22,2331.44,499.96,1831.48,149670.74,mortgage,104,1
17,149670.74,2331.44,493.91,1837.53,147833.21,mortgage,104,1
18,147833.21,2331.44,487.85,1843.59,145989.62,mortgage,104,1
19,145989.62,2331.44,481.77,1849.67,144139.95,mortgage,104,1
20,144139.95,2331.44,475.66,1855.78,142284.17,mortgage,104,1
21,142284.17,2331.44,469.54,1861.9,140422.27,mortgage,104,1
22,140422.27,2331.44,463.39,1868.05,138554.22,mortgage,104,1
23,138554.22,2331.44,457.23,1874.21,136680.01,mortgage,104,1
24,136680.01,2331.44,451.04,1880.4,134799.61,mortgage,104,1
25,134799.61,2331.44,444.84,1886.6,132913.01,mortgage,104,1
26,132913.01,2331.44,438.61,1892.83,131020.18,mortgage,104,1
27,131020.18,2331.44,432.37,1899.07,129121.11,mortgage,104,1
28,129121.11,2331.44,426.1,1905.34,127215.77,mortgage,104,1
29,127215.77,2331.44,419.81,1911.63,125304.14,mortgage,104,1
30,125304.14,2331.44,413.5,1917.94,123386.2,mortgage,104,1
31,123386.2,2331.44,407.17,1924.27,121461.93,mortgage,104,1
32,121461.93,2331.44,400.82,1930.62,119531.31,mortgage,104,1
33,119531.31,2331.44,394.45,1936.99,117594.32,mortgage,104,1
34,117594.32,2331.44,388.06,1943.38,115650.94,mortgage,104,1
35,115650.94,2331.44,381.65,1949.79,113701.15,mortgage,104,1
36,113701.15,2331.44,375.21,1956.23,111744.92,mortgage,104,1
37,111744.92,2331.44,368.76,1962.68,109782.24,mortgage,104,1
38,109782.24,2331.44,362.28,1969.16,107813.08,mortgage,104,1
39,107813.08,2331.44,355.78,1975.66,105837.42,mortgage,104,1
40,105837.42,2331.44,349.26,1982.18,103855.24,mortgage,104,1
41,103855.24,2331.44,342.72,1988.72,101866.52,mortgage,104,1
42,101866.52,2331.44,336.16,1995.28,99871.24,mortgage,104,1
43,99871.24,2331.44,329.58,2001.86,97869.38,mortgage,104,1
44,97869.38,2331.44,322.97,2008.47,95860.91,mortgage,104,1
45,95860.91,2331.44,316.34,2015.1,93845.81,mortgage,104,1
46,93845.81,2331.44,309.69,2021.75,91824.06,mortgage,104,1
47,91824.06,2331.44,303.02,2028.42,89795.64,mortgage,104,1
48,89795.64,2331.44,296.33,2035.11,87760.53,mortgage,104,1
49,87760.53,2331.44,289.61,2041.83,85718.7,mortgage,104,1
50,85718.7,2331.44,282.87,2048.57,83670.13,mortgage,104,1
51,83670.13,2331.44,276.11,2055.33,81614.8,mortgage,104,1
52,81614.8,2331.44,269.33,2062.11,79552.69,mortgage,104,1
53,79552.69,2331.44,262.52,2068.92,77483.77,mortgage,104,1
54,77483.77,2331.44,255.7,2075.74,75408.03,mortgage,104,1
55,75408.03,2331.44,248.85,2082.59,73325.44,mortgage,104,1
56,73325.44,2331.44,241.97,2089.47,71235.97,mortgage,104,1
57,71235.97,2331.44,235.08,2096.36,69139.61,mortgage,104,1
58,69139.61,2331.44,228.16,2103.28,67036.33,mortgage,104,1
59,67036.33,2331.44,221.22,2110.22,64926.11,mortgage,104,1
60,64926.11,2331.44,214.26,2117.18,62808.93,mortgage,104,1
61,62808.93,2331.44,207.27,2124.17,60684.76,mortgage,104,1
62,60684.76,2331.44,200.26,2131.18,58553.58,mortgage,104,1
63,58553.58,2331.44,193.23,2138.21,56415.37,mortgage,104,1
64,56415.37,2331.44,186.17,2145.27,54270.1,mortgage,104,1
65,54270.1,2331.44,179.09,2152.35,52117.75,mortgage,104,1
66,52117.75,2331.44,171.99,2159.45,49958.3,mortgage,104,1
67,49958.3,2331.44,164.86,2166.58,47791.72,mortgage,104,1
68,47791.72,2331.44,157.71,2173.73,45617.99,mortgage,104,1
69,45617.99,2331.44,150.54,2180.9,43437.09,mortgage,104,1
70,43437.09,2331.44,143.34,2188.1,41248.99,mortgage,104,1
71,41248.99,2331.44,136.12,2195.32,39053.67,mortgage,104,1
72,39053.67,2331.44,128.88,2202.56,36851.11,mortgage,104,1
73,36851.11,2331.44,121.61,2209.83,34641.28,mortgage,104,1
74,34641.28,2331.44,114.32,2217.12,32424.16,mortgage,104,1
75,32424.16,2331.44,107.0,2224.44,30199.72,mortgage,104,1
76,30199.72,2331.44,99.66,2231.78,27967.94,mortgage,104,1
77,27967.94,2331.44,92.29,2239.15,25728.79,mortgage,104,1
78,25728.79,2331.44,84.91,2246.53,23482.26,mortgage,104,1
79,23482.26,2331.44,77.49,2253.95,21228.31,mortgage,104,1
80,21228.31,2331.44,70.05,2261.39,18966.92,mortgage,104,1
81,18966.92,2331.44,62.59,2268.85,16698.07,mortgage,104,1
82,16698.07,2331.44,55.1,2276.34,14421.73,mortgage,104,1
83,14421.73,2331.44,47.59,2283.85,12137.88,mortgage,104,1
84,12137.88,2331.44,40.06,2291.38,9846.5,mortgage,104,1
85,9846.5,2331.44,32.49,2298.95,7547.55,mortgage,104,1
86,7547.55,2331.44,24.91,2306.53,5241.02,mortgage,104,1
87,5241.02,2331.44,17.3,2314.14,2926.88,mortgage,104,1
88,2926.88,2331.44,9.66,2321.78,605.1,mortgage,104,1
89,605.1,2331.44,2.0,2329.44,-1724.34,mortgage,104,1
0,5000.0,333.0,36.0,297.0,4703.0,Car,104,2
1,4703.0,333.0,33.86,299.14,4403.86,Car,104,2
2,4403.86,333.0,31.71,301.29,4102.57,Car,104,2
3,4102.57,333.0,29.54,303.46,3799.11,Car,104,2
4,3799.11,333.0,27.35,305.65,3493.46,Car,104,2
5,3493.46,333.0,25.15,307.85,3185.61,Car,104,2
6,3185.61,333.0,22.94,310.06,2875.55,Car,104,2
7,2875.55,333.0,20.7,312.3,2563.25,Car,104,2
8,2563.25,333.0,18.46,314.54,2248.71,Car,104,2
9,2248.71,333.0,16.19,316.81,1931.9,Car,104,2
10,1931.9,333.0,13.91,319.09,1612.81,Car,104,2
11,1612.81,333.0,11.61,321.39,1291.42,Car,104,2
12,1291.42,333.0,9.3,323.7,967.72,Car,104,2
13,967.72,333.0,6.97,326.03,641.69,Car,104,2
14,641.69,333.0,4.62,328.38,313.31,Car,104,2
15,313.31,333.0,2.26,330.74,-17.43,Car,104,2
0,4000.0,70.0,16.0,54.0,3946.0,testing,104,3
1,3946.0,70.0,15.78,54.22,3891.78,testing,104,3
2,3891.78,70.0,15.57,54.43,3837.35,testing,104,3
3,3837.35,70.0,15.35,54.65,3782.7,testing,104,3
4,3782.7,70.0,15.13,54.87,3727.83,testing,104,3
5,3727.83,70.0,14.91,55.09,3672.74,testing,104,3
6,3672.74,70.0,14.69,55.31,3617.43,testing,104,3
7,3617.43,70.0,14.47,55.53,3561.9,testing,104,3
8,3561.9,70.0,14.25,55.75,3506.15,testing,104,3
9,3506.15,70.0,14.02,55.98,3450.17,testing,104,3
10,3450.17,70.0,13.8,56.2,3393.97,testing,104,3
11,3393.97,70.0,13.58,56.42,3337.55,testing,104,3
12,3337.55,70.0,13.35,56.65,3280.9,testing,104,3
13,3280.9,70.0,13.12,56.88,3224.02,testing,104,3
14,3224.02,70.0,12.9,57.1,3166.92,testing,104,3
15,3166.92,87.43,12.67,74.76,3092.16,testing,104,3
16,3092.16,2734.44,12.37,2722.07,370.09,testing,104,3
17,370.09,2734.44,1.48,2732.96,-2362.87,testing,104,3
0,20000.0,191.04,108.0,83.04,19916.96,WellsFargo2,104,4
1,19916.96,191.04,107.55,83.49,19833.47,WellsFargo2,104,4
2,19833.47,191.04,107.1,83.94,19749.53,WellsFargo2,104,4
3,19749.53,191.04,106.65,84.39,19665.14,WellsFargo2,104,4
4,19665.14,191.04,106.19,84.85,19580.29,WellsFargo2,104,4
5,19580.29,191.04,105.73,85.31,19494.98,WellsFargo2,104,4
6,19494.98,191.04,105.27,85.77,19409.21,WellsFargo2,104,4
7,19409.21,191.04,104.81,86.23,19322.98,WellsFargo2,104,4
8,19322.98,191.04,104.34,86.7,19236.28,WellsFargo2,104,4
9,19236.28,191.04,103.88,87.16,19149.12,WellsFargo2,104,4
10,19149.12,191.04,103.41,87.63,19061.49,WellsFargo2,104,4
11,19061.49,191.04,102.93,88.11,18973.38,WellsFargo2,104,4
12,18973.38,191.04,102.46,88.58,18884.8,WellsFargo2,104,4
13,18884.8,191.04,101.98,89.06,18795.74,WellsFargo2,104,4
14,18795.74,191.04,101.5,89.54,18706.2,WellsFargo2,104,4
15,18706.2,191.04,101.01,90.03,18616.17,WellsFargo2,104,4
16,18616.17,191.04,100.53,90.51,18525.66,WellsFargo2,104,4
17,18525.66,2553.91,100.04,2453.87,16071.79,WellsFargo2,104,4
18,16071.79,2925.48,86.79,2838.69,13233.1,WellsFargo2,104,4
19,13233.1,2925.48,71.46,2854.02,10379.08,WellsFargo2,104,4
20,10379.08,2925.48,56.05,2869.43,7509.65,WellsFargo2,104,4
21,7509.65,2925.48,40.55,2884.93,4624.72,WellsFargo2,104,4
22,4624.72,2925.48,24.97,2900.51,1724.21,WellsFargo2,104,4
23,1724.21,2925.48,9.31,2916.17,-1191.96,WellsFargo2,104,4
0,8250.57,84.62,53.63,30.99,8219.58,WellsFargo1,104,5
1,8219.58,84.62,53.43,31.19,8188.39,WellsFargo1,104,5
2,8188.39,84.62,53.22,31.4,8156.99,WellsFargo1,104,5
3,8156.99,84.62,53.02,31.6,8125.39,WellsFargo1,104,5
4,8125.39,84.62,52.82,31.8,8093.59,WellsFargo1,104,5
5,8093.59,84.62,52.61,32.01,8061.58,WellsFargo1,104,5
6,8061.58,84.62,52.4,32.22,8029.36,WellsFargo1,104,5
7,8029.36,84.62,52.19,32.43,7996.93,WellsFargo1,104,5
8,7996.93,84.62,51.98,32.64,7964.29,WellsFargo1,104,5
9,7964.29,84.62,51.77,32.85,7931.44,WellsFargo1,104,5
10,7931.44,84.62,51.55,33.07,7898.37,WellsFargo1,104,5
11,7898.37,84.62,51.34,33.28,7865.09,WellsFargo1,104,5
12,7865.09,84.62,51.12,33.5,7831.59,WellsFargo1,104,5
13,7831.59,84.62,50.91,33.71,7797.88,WellsFargo1,104,5
14,7797.88,84.62,50.69,33.93,7763.95,WellsFargo1,104,5
15,7763.95,84.62,50.47,34.15,7729.8,WellsFargo1,104,5
16,7729.8,84.62,50.24,34.38,7695.42,WellsFargo1,104,5
17,7695.42,84.62,50.02,34.6,7660.82,WellsFargo1,104,5
18,7660.82,84.62,49.8,34.82,7626.0,WellsFargo1,104,5
19,7626.0,84.62,49.57,35.05,7590.95,WellsFargo1,104,5
20,7590.95,84.62,49.34,35.28,7555.67,WellsFargo1,104,5
21,7555.67,84.62,49.11,35.51,7520.16,WellsFargo1,104,5
22,7520.16,84.62,48.88,35.74,7484.42,WellsFargo1,104,5
23,7484.42,1276.58,48.65,1227.93,6256.49,WellsFargo1,104,5
24,6256.49,3010.1,40.67,2969.43,3287.06,WellsFargo1,104,5
25,3287.06,3010.1,21.37,2988.73,298.33,WellsFargo1,104,5
26,298.33,3010.1,1.94,3008.16,-2709.83,WellsFargo1,104,5
0,180000.0,2331.44,594.0,1737.44,178262.56,mortgage,105,1
1,178262.56,2331.44,588.27,1743.17,176519.39,mortgage,105,1
2,176519.39,2331.44,582.51,1748.93,174770.46,mortgage,105,1
3,174770.46,2331.44,576.74,1754.7,173015.76,mortgage,105,1
4,173015.76,2331.44,570.95,1760.49,171255.27,mortgage,105,1
5,171255.27,2331.44,565.14,1766.3,169488.97,mortgage,105,1
6,169488.97,2331.44,559.31,1772.13,167716.84,mortgage,105,1
7,167716.84,2331.44,553.47,1777.97,165938.87,mortgage,105,1
8,165938.87,2331.44,547.6,1783.84,164155.03,mortgage,105,1
9,164155.03,2331.44,541.71,1789.73,162365.3,mortgage,105,1
10,162365.3,2331.44,535.81,1795.63,160569.67,mortgage,105,1
11,160569.67,2331.44,529.88,1801.56,158768.11,mortgage,105,1
12,158768.11,2331.44,523.93,1807.51,156960.6,mortgage,105,1
13,156960.6,2331.44,517.97,1813.47,155147.13,mortgage,105,1
14,155147.13,2331.44,511.99,1819.45,153327.68,mortgage,105,1
15,153327.68,2331.44,505.98,1825.46,151502.22,mortgage,105,1
16,151502.22,2331.44,499.96,1831.48,149670.74,mortgage,105,1
17,149670.74,2331.44,493.91,1837.53,147833.21,mortgage,105,1
18,147833.21,2331.44,487.85,1843.59,145989.62,mortgage,105,1
19,145989.62,2331.44,481.77,1849.67,144139.95,mortgage,105,1
20,144139.95,2331.44,475.66,1855.78,142284.17,mortgage,105,1
21,142284.17,2331.44,469.54,1861.9,140422.27,mortgage,105,1
22,140422.27,2331.44,463.39,1868.05,138554.22,mortgage,105,1
23,138554.22,2331.44,457.23,1874.21,136680.01,mortgage,105,1
24,136680.01,2331.44,451.04,1880.4,134799.61,mortgage,105,1
25,134799.61,2331.44,444.84,1886.6,132913.01,mortgage,105,1
26,132913.01,2331.44,438.61,1892.83,131020.18,mortgage,105,1
27,131020.18,2331.44,432.37,1899.07,129121.11,mortgage,105,1
28,129121.11,2331.44,426.1,1905.34,127215.77,mortgage,105,1
29,127215.77,2331.44,419.81,1911.63,125304.14,mortgage,105,1
30,125304.14,2331.44,413.5,1917.94,123386.2,mortgage,105,1
31,123386.2,2331.44,407.17,1924.27,121461.93,mortgage,105,1
32,121461.93,2331.44,400.82,1930.62,119531.31,mortgage,105,1
33,119531.31,2331.44,394.45,1936.99,117594.32,mortgage,105,1
34,117594.32,2331.44,388.06,1943.38,115650.94,mortgage,105,1
35,115650.94,2331.44,381.65,1949.79,113701.15,mortgage,105,1
36,113701.15,2331.44,375.21,1956.23,111744.92,mortgage,105,1
37,111744.92,2331.44,368.76,1962.68,109782.24,mortgage,105,1
38,109782.24,2331.44,362.28,1969.16,107813.08,mortgage,105,1
39,107813.08,2331.44,355.78,1975.66,105837.42,mortgage,105,1
40,105837.42,2331.44,349.26,1982.18,103855.24,mortgage,105,1
41,103855.24,2331.44,342.72,1988.72,101866.52,mortgage,105,1
42,101866.52,2331.44,336.16,1995.28,99871.24,mortgage,105,1
43,99871.24,2331.44,329.58,2001.86,97869.38,mortgage,105,1
44,97869.38,2331.44,322.97,2008.47,95860.91,mortgage,105,1
45,95860.91,2331.44,316.34,2015.1,93845.81,mortgage,105,1
46,93845.81,2331.44,309.69,2021.75,91824.06,mortgage,105,1
47,91824.06,2331.44,303.02,2028.42,89795.64,mortgage,105,1
48,89795.64,2331.44,296.33,2035.11,87760.53,mortgage,105,1
49,87760.53,2331.44,289.61,2041.83,85718.7,mortgage,105,1
50,85718.7,2331.44,282.87,2048.57,83670.13,mortgage,105,1
51,83670.13,2331.44,276.11,2055.33,81614.8,mortgage,105,1
52,81614.8,2331.44,269.33,2062.11,79552.69,mortgage,105,1
53,79552.69,2331.44,262.52,2068.92,77483.77,mortgage,105,1
54,77483.77,2331.44,255.7,2075.74,75408.03,mortgage,105,1
55,75408.03,2331.44,248.85,2082.59,73325.44,mortgage,105,1
56,73325.44,2331.44,241.97,2089.47,71235.97,mortgage,105,1
57,71235.97,2331.44,235.08,2096.36,69139.61,mortgage,105,1
58,69139.61,2331.44,228.16,2103.28,67036.33,mortgage,105,1
59,67036.33,2331.44,221.22,2110.22,64926.11,mortgage,105,1
60,64926.11,2331.44,214.26,2117.18,62808.93,mortgage,105,1
61,62808.93,2331.44,207.27,2124.17,60684.76,mortgage,105,1
62,60684.76,2331.44,200.26,2131.18,58553.58,mortgage,105,1
63,58553.58,2331.44,193.23,2138.21,56415.37,mortgage,105,1
64,56415.37,2331.44,186.17,2145.27,54270.1,mortgage,105,1
65,54270.1,2331.44,179.09,2152.35,52117.75,mortgage,105,1
66,52117.75,2331.44,171.99,2159.45,49958.3,mortgage,105,1
67,49958.3,2331.44,164.86,2166.58,47791.72,mortgage,105,1
68,47791.72,2331.44,157.71,2173.73,45617.99,mortgage,105,1
69,45617.99,2331.44,150.54,2180.9,43437.09,mortgage,105,1
70,43437.09,2331.44,143.34,2188.1,41248.99,mortgage,105,1
71,41248.99,2331.44,136.12,2195.32,39053.67,mortgage,105,1
72,39053.67,2331.44,128.88,2202.56,36851.11,mortgage,105,1
73,36851.11,2331.44,121.61,2209.83,34641.28,mortgage,105,1
74,34641.28,2331.44,114.32,2217.12,32424.16,mortgage,105,1
75,32424.16,2331.44,107.0,2224.44,30199.72,mortgage,105,1
76,30199.72,2331.44,99.66,2231.78,27967.94,mortgage,105,1
77,27967.94,2331.44,92.29,2239.15,25728.79,mortgage,105,1
78,25728.79,2331.44,84.91,2246.53,23482.26,mortgage,105,1
79,23482.26,2331.44,77.49,2253.95,21228.31,mortgage,105,1
80,21228.31,2331.44,70.05,2261.39,18966.92,mortgage,105,1
81,18966.92,2331.44,62.59,2268.85,16698.07,mortgage,105,1
82,16698.07,2331.44,55.1,2276.34,14421.73,mortgage,105,1
83,14421.73,2331.44,47.59,2283.85,12137.88,mortgage,105,1
84,12137.88,2331.44,40.06,2291.38,9846.5,mortgage,105,1
85,9846.5,2331.44,32.49,2298.95,7547.55,mortgage,105,1
86,7547.55,2331.44,24.91,2306.53,5241.02,mortgage,105,1
87,5241.02,2331.44,17.3,2314.14,2926.88,mortgage,105,1
88,2926.88,2331.44,9.66,2321.78,605.1,mortgage,105,1
89,605.1,2331.44,2.0,2329.44,-1724.34,mortgage,105,1
0,5000.0,333.0,36.0,297.0,4703.0,Car,105,2
1,4703.0,333.0,33.86,299.14,4403.86,Car,105,2
2,4403.86,333.0,31.71,301.29,4102.57,Car,105,2
3,4102.57,333.0,29.54,303.46,3799.11,Car,105,2
4,3799.11,333.0,27.35,305.65,3493.46,Car,105,2
5,3493.46,333.0,25.15,307.85,3185.61,Car,105,2
6,3185.61,333.0,22.94,310.06,2875.55,Car,105,2
7,2875.55,333.0,20.7,312.3,2563.25,Car,105,2
8,2563.25,333.0,18.46,314.54,2248.71,Car,105,2
9,2248.71,333.0,16.19,316.81,1931.9,Car,105,2
10,1931.9,333.0,13.91,319.09,1612.81,Car,105,2
11,1612.81,333.0,11.61,321.39,1291.42,Car,105,2
12,1291.42,333.0,9.3,323.7,967.72,Car,105,2
13,967.72,333.0,6.97,326.03,641.69,Car,105,2
14,641.69,333.0,4.62,328.38,313.31,Car,105,2
15,313.31,333.0,2.26,330.74,-17.43,Car,105,2
0,8250.57,84.62,53.63,30.99,8219.58,WellsFargo1,105,3
1,8219.58,84.62,53.43,31.19,8188.39,WellsFargo1,105,3
2,8188.39,84.62,53.22,31.4,8156.99,WellsFargo1,105,3
3,8156.99,84.62,53.02,31.6,8125.39,WellsFargo1,105,3
4,8125.39,84.62,52.82,31.8,8093.59,WellsFargo1,105,3
5,8093.59,84.62,52.61,32.01,8061.58,WellsFargo1,105,3
6,8061.58,84.62,52.4,32.22,8029.36,WellsFargo1,105,3
7,8029.36,84.62,52.19,32.43,7996.93,WellsFargo1,105,3
8,7996.93,84.62,51.98,32.64,7964.29,WellsFargo1,105,3
9,7964.29,84.62,51.77,32.85,7931.44,WellsFargo1,105,3
10,7931.44,84.62,51.55,33.07,7898.37,WellsFargo1,105,3
11,7898.37,84.62,51.34,33.28,7865.09,WellsFargo1,105,3
12,7865.09,84.62,51.12,33.5,7831.59,WellsFargo1,105,3
13,7831.59,84.62,50.91,33.71,7797.88,WellsFargo1,105,3
14,7797.88,84.62,50.69,33.93,7763.95,WellsFargo1,105,3
15,7763.95,102.05,50.47,51.58,7712.37,WellsFargo1,105,3
16,7712.37,2749.06,50.13,2698.93,5013.44,WellsFargo1,105,3
17,5013.44,2749.06,32.59,2716.47,2296.97,WellsFargo1,105,3
18,2296.97,2749.06,14.93,2734.13,-437.16,WellsFargo1,105,3
0,4000.0,70.0,16.0,54.0,3946.0,testing,105,4
1,3946.0,70.0,15.78,54.22,3891.78,testing,105,4
2,3891.78,70.0,15.57,54.43,3837.35,testing,105,4
3,3837.35,70.0,15.35,54.65,3782.7,testing,105,4
4,3782.7,70.0,15.13,54.87,3727.83,testing,105,4
5,3727.83,70.0,14.91,55.09,3672.74,testing,105,4
6,3672.74,70.0,14.69,55.31,3617.43,testing,105,4
7,3617.43,70.0,14.47,55.53,3561.9,testing,105,4
8,3561.9,70.0,14.25,55.75,3506.15,testing,105,4
9,3506.15,70.0,14.02,55.98,3450.17,testing,105,4
10,3450.17,70.0,13.8,56.2,3393.97,testing,105,4
11,3393.97,70.0,13.58,56.42,3337.55,testing,105,4
12,3337.55,70.0,13.35,56.65,3280.9,testing,105,4
13,3280.9,70.0,13.12,56.88,3224.02,testing,105,4
14,3224.02,70.0,12.9,57.1,3166.92,testing,105,4
15,3166.92,70.0,12.67,57.33,3109.59,testing,105,4
16,3109.59,70.0,12.44,57.56,3052.03,testing,105,4
17,3052.03,70.0,12.21,57.79,2994.24,testing,105,4
18,2994.24,507.16,11.98,495.18,2499.06,testing,105,4
19,2499.06,2819.06,10.0,2809.06,-310.0,testing,105,4
0,20000.0,191.04,108.0,83.04,19916.96,WellsFargo2,105,5
1,19916.96,191.04,107.55,83.49,19833.47,WellsFargo2,105,5
2,19833.47,191.04,107.1,83.94,19749.53,WellsFargo2,105,5
3,19749.53,191.04,106.65,84.39,19665.14,WellsFargo2,105,5
4,19665.14,191.04,106.19,84.85,19580.29,WellsFargo2,105,5
5,19580.29,191.04,105.73,85.31,19494.98,WellsFargo2,105,5
6,19494.98,191.04,105.27,85.77,19409.21,WellsFargo2,105,5
7,19409.21,191.04,104.81,86.23,19322.98,WellsFargo2,105,5
8,19322.98,191.04,104.34,86.7,19236.28,WellsFargo2,105,5
9,19236.28,191.04,103.88,87.16,19149.12,WellsFargo2,105,5
10,19149.12,191.04,103.41,87.63,19061.49,WellsFargo2,105,5
11,19061.49,191.04,102.93,88.11,18973.38,WellsFargo2,105,5
12,18973.38,191.04,102.46,88.58,18884.8,WellsFargo2,105,5
13,18884.8,191.04,101.98,89.06,18795.74,WellsFargo2,105,5
14,18795.74,191.04,101.5,89.54,18706.2,WellsFargo2,105,5
15,18706.2,191.04,101.01,90.03,18616.17,WellsFargo2,105,5
16,18616.17,191.04,100.53,90.51,18525.66,WellsFargo2,105,5
17,18525.66,191.04,100.04,91.0,18434.66,WellsFargo2,105,5
18,18434.66,191.04,99.55,91.49,18343.17,WellsFargo2,105,5
19,18343.17,501.04,99.05,401.99,17941.18,WellsFargo2,105,5
20,17941.18,3010.1,96.88,2913.22,15027.96,WellsFargo2,105,5
21,15027.96,3010.1,81.15,2928.95,12099.01,WellsFargo2,105,5
22,12099.01,3010.1,65.33,2944.77,9154.24,WellsFargo2,105,5
23,9154.24,3010.1,49.43,2960.67,6193.57,WellsFargo2,105,5
24,6193.57,3010.1,33.45,2976.65,3216.92,WellsFargo2,105,5
25,3216.92,3010.1,17.37,2992.73,224.19,WellsFargo2,105,5
26,224.19,3010.1,1.21,3008.89,-2784.7,WellsFargo2,105,5
0,180000.0,2331.44,594.0,1737.44,178262.56,mortgage,106,1
1,178262.56,2331.44,588.27,1743.17,176519.39,mortgage,106,1
2,176519.39,2331.44,582.51,1748.93,174770.46,mortgage,106,1
3,174770.46,2331.44,576.74,1754.7,173015.76,mortgage,106,1
4,173015.76,2331.44,570.95,1760.49,171255.27,mortgage,106,1
5,171255.27,2331.44,565.14,1766.3,169488.97,mortgage,106,1
6,169488.97,2331.44,559.31,1772.13,167716.84,mortgage,106,1
7,167716.84,2331.44,553.47,1777.97,165938.87,mortgage,106,1
8,165938.87,2331.44,547.6,1783.84,164155.03,mortgage,106,1
9,164155.03,2331.44,541.71,1789.73,162365.3,mortgage,106,1
10,162365.3,2331.44,535.81,1795.63,160569.67,mortgage,106,1
11,160569.67,2331.44,529.88,1801.56,158768.11,mortgage,106,1
12,158768.11,2331.44,523.93,1807.51,156960.6,mortgage,106,1
13,156960.6,2331.44,517.97,1813.47,155147.13,mortgage,106,1
14,155147.13,2331.44,511.99,1819.45,153327.68,mortgage,106,1
15,153327.68,2331.44,505.98,1825.46,151502.22,mortgage,106,1
16,151502.22,2331.44,499.96,1831.48,149670.74,mortgage,106,1
17,149670.74,2331.44,493.91,1837.53,147833.21,mortgage,106,1
18,147833.21,2331.44,487.85,1843.59,145989.62,mortgage,106,1
19,145989.62,2331.44,481.77,1849.67,144139.95,mortgage,106,1
20,144139.95,2331.44,475.66,1855.78,142284.17,mortgage,106,1
21,142284.17,2331.44,469.54,1861.9,140422.27,mortgage,106,1
22,140422.27,2331.44,463.39,1868.05,138554.22,mortgage,106,1
23,138554.22,2331.44,457.23,1874.21,136680.01,mortgage,106,1
24,136680.01,2331.44,451.04,1880.4,134799.61,mortgage,106,1
25,134799.61,2331.44,444.84,1886.6,132913.01,mortgage,106,1
26,132913.01,2331.44,438.61,1892.83,131020.18,mortgage,106,1
27,131020.18,2331.44,432.37,1899.07,129121.11,mortgage,106,1
28,129121.11,2331.44,426.1,1905.34,127215.77,mortgage,106,1
29,127215.77,2331.44,419.81,1911.63,125304.14,mortgage,106,1
30,125304.14,2331.44,413.5,1917.94,123386.2,mortgage,106,1
31,123386.2,2331.44,407.17,1924.27,121461.93,mortgage,106,1
32,121461.93,2331.44,400.82,1930.62,119531.31,mortgage,106,1
33,119531.31,2331.44,394.45,1936.99,117594.32,mortgage,106,1
34,117594.32,2331.44,388.06,1943.38,115650.94,mortgage,106,1
35,115650.94,2331.44,381.65,1949.79,113701.15,mortgage,106,1
36,113701.15,2331.44,375.21,1956.23,111744.92,mortgage,106,1
37,111744.92,2331.44,368.76,1962.68,109782.24,mortgage,106,1
38,109782.24,2331.44,362.28,1969.16,107813.08,mortgage,106,1
39,107813.08,2331.44,355.78,1975.66,105837.42,mortgage,106,1
40,105837.42,2331.44,349.26,1982.18,103855.24,mortgage,106,1
41,103855.24,2331.44,342.72,1988.72,101866.52,mortgage,106,1
42,101866.52,2331.44,336.16,1995.28,99871.24,mortgage,106,1
43,99871.24,2331.44,329.58,2001.86,97869.38,mortgage,106,1
44,97869.38,2331.44,322.97,2008.47,95860.91,mortgage,106,1
45,95860.91,2331.44,316.34,2015.1,93845.81,mortgage,106,1
46,93845.81,2331.44,309.69,2021.75,91824.06,mortgage,106,1
47,91824.06,2331.44,303.02,2028.42,89795.64,mortgage,106,1
48,89795.64,2331.44,296.33,2035.11,87760.53,mortgage,106,1
49,87760.53,2331.44,289.61,2041.83,85718.7,mortgage,106,1
50,85718.7,2331.44,282.87,2048.57,83670.13,mortgage,106,1
51,83670.13,2331.44,276.11,2055.33,81614.8,mortgage,106,1
52,81614.8,2331.44,269.33,2062.11,79552.69,mortgage,106,1
53,79552.69,2331.44,262.52,2068.92,77483.77,mortgage,106,1
54,77483.77,2331.44,255.7,2075.74,75408.03,mortgage,106,1
55,75408.03,2331.44,248.85,2082.59,73325.44,mortgage,106,1
56,73325.44,2331.44,241.97,2089.47,71235.97,mortgage,106,1
57,71235.97,2331.44,235.08,2096.36,69139.61,mortgage,106,1
58,69139.61,2331.44,228.16,2103.28,67036.33,mortgage,106,1
59,67036.33,2331.44,221.22,2110.22,64926.11,mortgage,106,1
60,64926.11,2331.44,214.26,2117.18,62808.93,mortgage,106,1
61,62808.93,2331.44,207.27,2124.17,60684.76,mortgage,106,1
62,60684.76,2331.44,200.26,2131.18,58553.58,mortgage,106,1
63,58553.58,2331.44,193.23,2138.21,56415.37,mortgage,106,1
64,56415.37,2331.44,186.17,2145.27,54270.1,mortgage,106,1
65,54270.1,2331.44,179.09,2152.35,52117.75,mortgage,106,1
66,52117.75,2331.44,171.99,2159.45,49958.3,mortgage,106,1
67,49958.3,2331.44,164.86,2166.58,47791.72,mortgage,106,1
68,47791.72,2331.44,157.71,2173.73,45617.99,mortgage,106,1
69,45617.99,2331.44,150.54,2180.9,43437.09,mortgage,106,1
70,43437.09,2331.44,143.34,2188.1,41248.99,mortgage,106,1
71,41248.99,2331.44,136.12,2195.32,39053.67,mortgage,106,1
72,39053.67,2331.44,128.88,2202.56,36851.11,mortgage,106,1
73,36851.11,2331.44,121.61,2209.83,34641.28,mortgage,106,1
74,34641.28,2331.44,114.32,2217.12,32424.16,mortgage,106,1
75,32424.16,2331.44,107.0,2224.44,30199.72,mortgage,106,1
76,30199.72,2331.44,99.66,2231.78,27967.94,mortgage,106,1
77,27967.94,2331.44,92.29,2239.15,25728.79,mortgage,106,1
78,25728.79,2331.44,84.91,2246.53,23482.26,mortgage,106,1
79,23482.26,2331.44,77.49,2253.95,21228.31,mortgage,106,1
80,21228.31,2331.44,70.05,2261.39,18966.92,mortgage,106,1
81,18966.92,2331.44,62.59,2268.85,16698.07,mortgage,106,1
82,16698.07,2331.44,55.1,2276.34,14421.73,mortgage,106,1
83,14421.73,2331.44,47.59,2283.85,12137.88,mortgage,106,1
84,12137.88,2331.44,40.06,2291.38,9846.5,mortgage,106,1
85,9846.5,2331.44,32.49,2298.95,7547.55,mortgage,106,1
86,7547.55,2331.44,24.91,2306.53,5241.02,mortgage,106,1
87,5241.02,2331.44,17.3,2314.14,2926.88,mortgage,106,1
88,2926.88,2331.44,9.66,2321.78,605.1,mortgage,106,1
89,605.1,2331.44,2.0,2329.44,-1724.34,mortgage,106,1
0,5000.0,333.0,36.0,297.0,4703.0,Car,106,2
1,4703.0,333.0,33.86,299.14,4403.86,Car,106,2
2,4403.86,333.0,31.71,301.29,4102.57,Car,106,2
3,4102.57,333.0,29.54,303.46,3799.11,Car,106,2
4,3799.11,333.0,27.35,305.65,3493.46,Car,106,2
5,3493.46,333.0,25.15,307.85,3185.61,Car,106,2
6,3185.61,333.0,22.94,310.06,2875.55,Car,106,2
7,2875.55,333.0,20.7,312.3,2563.25,Car,106,2
8,2563.25,333.0,18.46,314.54,2248.71,Car,106,2
9,2248.71,333.0,16.19,316.81,1931.9,Car,106,2
10,1931.9,333.0,13.91,319.09,1612.81,Car,106,2
11,1612.81,333.0,11.61,321.39,1291.42,Car,106,2
12,1291.42,333.0,9.3,323.7,967.72,Car,106,2
13,967.72,333.0,6.97,326.03,641.69,Car,106,2
14,641.69,333.0,4.62,328.38,313.31,Car,106,2
15,313.31,333.0,2.26,330.74,-17.43,Car,106,2
0,8250.57,84.62,53.63,30.99,8219.58,WellsFargo1,106,3
1,8219.58,84.62,53.43,31.19,8188.39,WellsFargo1,106,3
2,8188.39,84.62,53.22,31.4,8156.99,WellsFargo1,106,3
3,8156.99,84.62,53.02,31.6,8125.39,WellsFargo1,106,3
4,8125.39,84.62,52.82,31.8,8093.59,WellsFargo1,106,3
5,8093.59,84.62,52.61,32.01,8061.58,WellsFargo1,106,3
6,8061.58,84.62,52.4,32.22,8029.36,WellsFargo1,106,3
7,8029.36,84.62,52.19,32.43,7996.93,WellsFargo1,106,3
8,7996.93,84.62,51.98,32.64,7964.29,WellsFargo1,106,3
9,7964.29,84.62,51.77,32.85,7931.44,WellsFargo1,106,3
10,7931.44,84.62,51.55,33.07,7898.37,WellsFargo1,106,3
11,7898.37,84.62,51.34,33.28,7865.09,WellsFargo1,106,3
12,7865.09,84.62,51.12,33.5,7831.59,WellsFargo1,106,3
13,7831.59,84.62,50.91,33.71,7797.88,WellsFargo1,106,3
14,7797.88,84.62,50.69,33.93,7763.95,WellsFargo1,106,3
15,7763.95,102.05,50.47,51.58,7712.37,WellsFargo1,106,3
16,7712.37,2749.06,50.13,2698.93,5013.44,WellsFargo1,106,3
17,5013.44,2749.06,32.59,2716.47,2296.97,WellsFargo1,106,3
18,2296.97,2749.06,14.93,2734.13,-437.16,WellsFargo1,106,3
0,20000.0,191.04,108.0,83.04,19916.96,WellsFargo2,106,4
1,19916.96,191.04,107.55,83.49,19833.47,WellsFargo2,106,4
2,19833.47,191.04,107.1,83.94,19749.53,WellsFargo2,106,4
3,19749.53,191.04,106.65,84.39,19665.14,WellsFargo2,106,4
4,19665.14,191.04,106.19,84.85,19580.29,WellsFargo2,106,4
5,19580.29,191.04,105.73,85.31,19494.98,WellsFargo2,106,4
6,19494.98,191.04,105.27,85.77,19409.21,WellsFargo2,106,4
7,19409.21,191.04,104.81,86.23,19322.98,WellsFargo2,106,4
8,19322.98,191.04,104.34,86.7,19236.28,WellsFargo2,106,4
9,19236.28,191.04,103.88,87.16,19149.12,WellsFargo2,106,4
10,19149.12,191.04,103.41,87.63,19061.49,WellsFargo2,106,4
11,19061.49,191.04,102.93,88.11,18973.38,WellsFargo2,106,4
12,18973.38,191.04,102.46,88.58,18884.8,WellsFargo2,106,4
13,18884.8,191.04,101.98,89.06,18795.74,WellsFargo2,106,4
14,18795.74,191.04,101.5,89.54,18706.2,WellsFargo2,106,4
15,18706.2,191.04,101.01,90.03,18616.17,WellsFargo2,106,4
16,18616.17,191.04,100.53,90.51,18525.66,WellsFargo2,106,4
17,18525.66,191.04,100.04,91.0,18434.66,WellsFargo2,106,4
18,18434.66,628.2,99.55,528.65,17906.01,WellsFargo2,106,4
19,17906.01,2940.1,96.69,2843.41,15062.6,WellsFargo2,106,4
20,15062.6,2940.1,81.34,2858.76,12203.84,WellsFargo2,106,4
21,12203.84,2940.1,65.9,2874.2,9329.64,WellsFargo2,106,4
22,9329.64,2940.1,50.38,2889.72,6439.92,WellsFargo2,106,4
23,6439.92,2940.1,34.78,2905.32,3534.6,WellsFargo2,106,4
24,3534.6,2940.1,19.09,2921.01,613.59,WellsFargo2,106,4
25,613.59,2940.1,3.31,2936.79,-2323.2,WellsFargo2,106,4
0,4000.0,70.0,16.0,54.0,3946.0,testing,106,5
1,3946.0,70.0,15.78,54.22,3891.78,testing,106,5
2,3891.78,70.0,15.57,54.43,3837.35,testing,106,5
3,3837.35,70.0,15.35,54.65,3782.7,testing,106,5
4,3782.7,70.0,15.13,54.87,3727.83,testing,106,5
5,3727.83,70.0,14.91,55.09,3672.74,testing,106,5
6,3672.74,70.0,14.69,55.31,3617.43,testing,106,5
7,3617.43,70.0,14.47,55.53,3561.9,testing,106,5
8,3561.9,70.0,14.25,55.75,3506.15,testing,106,5
9,3506.15,70.0,14.02,55.98,3450.17,testing,106,5
10,3450.17,70.0,13.8,56.2,3393.97,testing,106,5
11,3393.97,70.0,13.58,56.42,3337.55,testing,106,5
12,3337.55,70.0,13.35,56.65,3280.9,testing,106,5
13,3280.9,70.0,13.12,56.88,3224.02,testing,106,5
14,3224.02,70.0,12.9,57.1,3166.92,testing,106,5
15,3166.92,70.0,12.67,57.33,3109.59,testing,106,5
16,3109.59,70.0,12.44,57.56,3052.03,testing,106,5
17,3052.03,70.0,12.21,57.79,2994.24,testing,106,5
18,2994.24,70.0,11.98,58.02,2936.22,testing,106,5
19,2936.22,70.0,11.74,58.26,2877.96,testing,106,5
20,2877.96,70.0,11.51,58.49,2819.47,testing,106,5
21,2819.47,70.0,11.28,58.72,2760.75,testing,106,5
22,2760.75,70.0,11.04,58.96,2701.79,testing,106,5
23,2701.79,70.0,10.81,59.19,2642.6,testing,106,5
24,2642.6,70.0,10.57,59.43,2583.17,testing,106,5
25,2583.17,2393.2,10.33,2382.87,200.3,testing,106,5
26,200.3,3010.1,0.8,3009.3,-2809.0,testing,106,5
0,180000.0,2331.44,594.0,1737.44,178262.56,mortgage,107,1
1,178262.56,2331.44,588.27,1743.17,176519.39,mortgage,107,1
2,176519.39,2331.44,582.51,1748.93,174770.46,mortgage,107,1
3,174770.46,2331.44,576.74,1754.7,173015.76,mortgage,107,1
4,173015.76,2331.44,570.95,1760.49,171255.27,mortgage,107,1
5,171255.27,2331.44,565.14,1766.3,169488.97,mortgage,107,1
6,169488.97,2331.44,559.31,1772.13,167716.84,mortgage,107,1
7,167716.84,2331.44,553.47,1777.97,165938.87,mortgage,107,1
8,165938.87,2331.44,547.6,1783.84,164155.03,mortgage,107,1
9,164155.03,2331.44,541.71,1789.73,162365.3,mortgage,107,1
10,162365.3,2331.44,535.81,1795.63,160569.67,mortgage,107,1
11,160569.67,2331.44,529.88,1801.56,158768.11,mortgage,107,1
12,158768.11,2331.44,523.93,1807.51,156960.6,mortgage,107,1
13,156960.6,2331.44,517.97,1813.47,155147.13,mortgage,107,1
14,155147.13,2331.44,511.99,1819.45,153327.68,mortgage,107,1
15,153327.68,2331.44,505.98,1825.46,151502.22,mortgage,107,1
16,151502.22,2331.44,499.96,1831.48,149670.74,mortgage,107,1
17,149670.74,2331.44,493.91,1837.53,147833.21,mortgage,107,1
18,147833.21,2331.44,487.85,1843.59,145989.62,mortgage,107,1
19,145989.62,2331.44,481.77,1849.67,144139.95,mortgage,107,1
20,144139.95,2331.44,475.66,1855.78,142284.17,mortgage,107,1
21,142284.17,2331.44,469.54,1861.9,140422.27,mortgage,107,1
22,140422.27,2331.44,463.39,1868.05,138554.22,mortgage,107,1
23,138554.22,2331.44,457.23,1874.21,136680.01,mortgage,107,1
24,136680.01,2331.44,451.04,1880.4,134799.61,mortgage,107,1
25,134799.61,2331.44,444.84,1886.6,132913.01,mortgage,107,1
26,132913.01,2331.44,438.61,1892.83,131020.18,mortgage,107,1
27,131020.18,2331.44,432.37,1899.07,129121.11,mortgage,107,1
28,129121.11,2331.44,426.1,1905.34,127215.77,mortgage,107,1
29,127215.77,2331.44,419.81,1911.63,125304.14,mortgage,107,1
30,125304.14,2331.44,413.5,1917.94,123386.2,mortgage,107,1
31,123386.2,2331.44,407.17,1924.27,121461.93,mortgage,107,1
32,121461.93,2331.44,400.82,1930.62,119531.31,mortgage,107,1
33,119531.31,2331.44,394.45,1936.99,117594.32,mortgage,107,1
34,117594.32,2331.44,388.06,1943.38,115650.94,mortgage,107,1
35,115650.94,2331.44,381.65,1949.79,113701.15,mortgage,107,1
36,113701.15,2331.44,375.21,1956.23,111744.92,mortgage,107,1
37,111744.92,2331.44,368.76,1962.68,109782.24,mortgage,107,1
38,109782.24,2331.44,362.28,1969.16,107813.08,mortgage,107,1
39,107813.08,2331.44,355.78,1975.66,105837.42,mortgage,107,1
40,105837.42,2331.44,349.26,1982.18,103855.24,mortgage,107,1
41,103855.24,2331.44,342.72,1988.72,101866.52,mortgage,107,1
42,101866.52,2331.44,336.16,1995.28,99871.24,mortgage,107,1
43,99871.24,2331.44,329.58,2001.86,97869.38,mortgage,107,1
44,97869.38,2331.44,322.97,2008.47,95860.91,mortgage,107,1
45,95860.91,2331.44,316.34,2015.1,93845.81,mortgage,107,1
46,93845.81,2331.44,309.69,2021.75,91824.06,mortgage,107,1
47,91824.06,2331.44,303.02,2028.42,89795.64,mortgage,107,1
48,89795.64,2331.44,296.33,2035.11,87760.53,mortgage,107,1
49,87760.53,2331.44,289.61,2041.83,85718.7,mortgage,107,1
50,85718.7,2331.44,282.87,2048.57,83670.13,mortgage,107,1
51,83670.13,2331.44,276.11,2055.33,81614.8,mortgage,107,1
52,81614.8,2331.44,269.33,2062.11,79552.69,mortgage,107,1
53,79552.69,2331.44,262.52,2068.92,77483.77,mortgage,107,1
54,77483.77,2331.44,255.7,2075.74,75408.03,mortgage,107,1
55,75408.03,2331.44,248.85,2082.59,73325.44,mortgage,107,1
56,73325.44,2331.44,241.97,2089.47,71235.97,mortgage,107,1
57,71235.97,2331.44,235.08,2096.36,69139.61,mortgage,107,1
58,69139.61,2331.44,228.16,2103.28,67036.33,mortgage,107,1
59,67036.33,2331.44,221.22,2110.22,64926.11,mortgage,107,1
60,64926.11,2331.44,214.26,2117.18,62808.93,mortgage,107,1
61,62808.93,2331.44,207.27,2124.17,60684.76,mortgage,107,1
62,60684.76,2331.44,200.26,2131.18,58553.58,mortgage,107,1
63,58553.58,2331.44,193.23,2138.21,56415.37,mortgage,107,1
64,56415.37,2331.44,186.17,2145.27,54270.1,mortgage,107,1
65,54270.1,2331.44,179.09,2152.35,52117.75,mortgage,107,1
66,52117.75,2331.44,171.99,2159.45,49958.3,mortgage,107,1
67,49958.3,2331.44,164.86,2166.58,47791.72,mortgage,107,1
68,47791.72,2331.44,157.71,2173.73,45617.99,mortgage,107,1
69,45617.99,2331.44,150.54,2180.9,43437.09,mortgage,107,1
70,43437.09,2331.44,143.34,2188.1,41248.99,mortgage,107,1
71,41248.99,2331.44,136.12,2195.32,39053.67,mortgage,107,1
72,39053.67,2331.44,128.88,2202.56,36851.11,mortgage,107,1
73,36851.11,2331.44,121.61,2209.83,34641.28,mortgage,107,1
74,34641.28,2331.44,114.32,2217.12,32424.16,mortgage,107,1
75,32424.16,2331.44,107.0,2224.44,30199.72,mortgage,107,1
76,30199.72,2331.44,99.66,2231.78,27967.94,mortgage,107,1
77,27967.94,2331.44,92.29,2239.15,25728.79,mortgage,107,1
78,25728.79,2331.44,84.91,2246.53,23482.26,mortgage,107,1
79,23482.26,2331.44,77.49,2253.95,21228.31,mortgage,107,1
80,21228.31,2331.44,70.05,2261.39,18966.92,mortgage,107,1
81,18966.92,2331.44,62.59,2268.85,16698.07,mortgage,107,1
82,16698.07,2331.44,55.1,2276.34,14421.73,mortgage,107,1
83,14421.73,2331.44,47.59,2283.85,12137.88,mortgage,107,1
84,12137.88,2331.44,40.06,2291.38,9846.5,mortgage,107,1
85,9846.5,2331.44,32.49,2298.95,7547.55,mortgage,107,1
86,7547.55,2331.44,24.91,2306.53,5241.02,mortgage,107,1
87,5241.02,2331.44,17.3,2314.14,2926.88,mortgage,107,1
88,2926.88,2331.44,9.66,2321.78,605.1,mortgage,107,1
89,605.1,2331.44,2.0,2329.44,-1724.34,mortgage,107,1
0,5000.0,333.0,36.0,297.0,4703.0,Car,107,2
1,4703.0,333.0,33.86,299.14,4403.86,Car,107,2
2,4403.86,333.0,31.71,301.29,4102.57,Car,107,2
3,4102.57,333.0,29.54,303.46,3799.11,Car,107,2
4,3799.11,333.0,27.35,305.65,3493.46,Car,107,2
5,3493.46,333.0,25.15,307.85,3185.61,Car,107,2
6,3185.61,333.0,22.94,310.06,2875.55,Car,107,2
7,2875.55,333.0,20.7,312.3,2563.25,Car,107,2
8,2563.25,333.0,18.46,314.54,2248.71,Car,107,2
9,2248.71,333.0,16.19,316.81,1931.9,Car,107,2
10,1931.9,333.0,13.91,319.09,1612.81,Car,107,2
11,1612.81,333.0,11.61,321.39,1291.42,Car,107,2
12,1291.42,333.0,9.3,323.7,967.72,Car,107,2
13,967.72,333.0,6.97,326.03,641.69,Car,107,2
14,641.69,333.0,4.62,328.38,313.31,Car,107,2
15,313.31,333.0,2.26,330.74,-17.43,Car,107,2
0,20000.0,191.04,108.0,83.04,19916.96,WellsFargo2,107,3
1,19916.96,191.04,107.55,83.49,19833.47,WellsFargo2,107,3
2,19833.47,191.04,107.1,83.94,19749.53,WellsFargo2,107,3
3,19749.53,191.04,106.65,84.39,19665.14,WellsFargo2,107,3
4,19665.14,191.04,106.19,84.85,19580.29,WellsFargo2,107,3
5,19580.29,191.04,105.73,85.31,19494.98,WellsFargo2,107,3
6,19494.98,191.04,105.27,85.77,19409.21,WellsFargo2,107,3
7,19409.21,191.04,104.81,86.23,19322.98,WellsFargo2,107,3
8,19322.98,191.04,104.34,86.7,19236.28,WellsFargo2,107,3
9,19236.28,191.04,103.88,87.16,19149.12,WellsFargo2,107,3
10,19149.12,191.04,103.41,87.63,19061.49,WellsFargo2,107,3
11,19061.49,191.04,102.93,88.11,18973.38,WellsFargo2,107,3
12,18973.38,191.04,102.46,88.58,18884.8,WellsFargo2,107,3
13,18884.8,191.04,101.98,89.06,18795.74,WellsFargo2,107,3
14,18795.74,191.04,101.5,89.54,18706.2,WellsFargo2,107,3
15,18706.2,208.47,101.01,107.46,18598.74,WellsFargo2,107,3
16,18598.74,2855.48,100.43,2755.05,15843.69,WellsFargo2,107,3
17,15843.69,2855.48,85.56,2769.92,13073.77,WellsFargo2,107,3
18,13073.77,2855.48,70.6,2784.88,10288.89,WellsFargo2,107,3
19,10288.89,2855.48,55.56,2799.92,7488.97,WellsFargo2,107,3
20,7488.97,2855.48,40.44,2815.04,4673.93,WellsFargo2,107,3
21,4673.93,2855.48,25.24,2830.24,1843.69,WellsFargo2,107,3
22,1843.69,2855.48,9.96,2845.52,-1001.83,WellsFargo2,107,3
0,4000.0,70.0,16.0,54.0,3946.0,testing,107,4
1,3946.0,70.0,15.78,54.22,3891.78,testing,107,4
2,3891.78,70.0,15.57,54.43,3837.35,testing,107,4
3,3837.35,70.0,15.35,54.65,3782.7,testing,107,4
4,3782.7,70.0,15.13,54.87,3727.83,testing,107,4
5,3727.83,70.0,14.91,55.09,3672.74,testing,107,4
6,3672.74,70.0,14.69,55.31,3617.43,testing,107,4
7,3617.43,70.0,14.47,55.53,3561.9,testing,107,4
8,3561.9,70.0,14.25,55.75,3506.15,testing,107,4
9,3506.15,70.0,14.02,55.98,3450.17,testing,107,4
10,3450.17,70.0,13.8,56.2,3393.97,testing,107,4
11,3393.97,70.0,13.58,56.42,3337.55,testing,107,4
12,3337.55,70.0,13.35,56.65,3280.9,testing,107,4
13,3280.9,70.0,13.12,56.88,3224.02,testing,107,4
14,3224.02,70.0,12.9,57.1,3166.92,testing,107,4
15,3166.92,70.0,12.67,57.33,3109.59,testing,107,4
16,3109.59,70.0,12.44,57.56,3052.03,testing,107,4
17,3052.03,70.0,12.21,57.79,2994.24,testing,107,4
18,2994.24,70.0,11.98,58.02,2936.22,testing,107,4
19,2936.22,70.0,11.74,58.26,2877.96,testing,107,4
20,2877.96,70.0,11.51,58.49,2819.47,testing,107,4
21,2819.47,70.0,11.28,58.72,2760.75,testing,107,4
22,2760.75,1071.83,11.04,1060.79,1699.96,testing,107,4
23,1699.96,2925.48,6.8,2918.68,-1218.72,testing,107,4
0,8250.57,84.62,53.63,30.99,8219.58,WellsFargo1,107,5
1,8219.58,84.62,53.43,31.19,8188.39,WellsFargo1,107,5
2,8188.39,84.62,53.22,31.4,8156.99,WellsFargo1,107,5
3,8156.99,84.62,53.02,31.6,8125.39,WellsFargo1,107,5
4,8125.39,84.62,52.82,31.8,8093.59,WellsFargo1,107,5
5,8093.59,84.62,52.61,32.01,8061.58,WellsFargo1,107,5
6,8061.58,84.62,52.4,32.22,8029.36,WellsFargo1,107,5
7,8029.36,84.62,52.19,32.43,7996.93,WellsFargo1,107,5
8,7996.93,84.62,51.98,32.64,7964.29,WellsFargo1,107,5
9,7964.29,84.62,51.77,32.85,7931.44,WellsFargo1,107,5
10,7931.44,84.62,51.55,33.07,7898.37,WellsFargo1,107,5
11,7898.37,84.62,51.34,33.28,7865.09,WellsFargo1,107,5
12,7865.09,84.62,51.12,33.5,7831.59,WellsFargo1,107,5
13,7831.59,84.62,50.91,33.71,7797.88,WellsFargo1,107,5
14,7797.88,84.62,50.69,33.93,7763.95,WellsFargo1,107,5
15,7763.95,84.62,50.47,34.15,7729.8,WellsFargo1,107,5
16,7729.8,84.62,50.24,34.38,7695.42,WellsFargo1,107,5
17,7695.42,84.62,50.02,34.6,7660.82,WellsFargo1,107,5
18,7660.82,84.62,49.8,34.82,7626.0,WellsFargo1,107,5
19,7626.0,84.62,49.57,35.05,7590.95,WellsFargo1,107,5
20,7590.95,84.62,49.34,35.28,7555.67,WellsFargo1,107,5
21,7555.67,84.62,49.11,35.51,7520.16,WellsFargo1,107,5
22,7520.16,84.62,48.88,35.74,7484.42,WellsFargo1,107,5
23,7484.42,1303.34,48.65,1254.69,6229.73,WellsFargo1,107,5
24,6229.73,3010.1,40.49,2969.61,3260.12,WellsFargo1,107,5
25,3260.12,3010.1,21.19,2988.91,271.21,WellsFargo1,107,5
26,271.21,3010.1,1.76,3008.34,-2737.13,WellsFargo1,107,5
0,180000.0,2331.44,594.0,1737.44,178262.56,mortgage,108,1
1,178262.56,2331.44,588.27,1743.17,176519.39,mortgage,108,1
2,176519.39,2331.44,582.51,1748.93,174770.46,mortgage,108,1
3,174770.46,2331.44,576.74,1754.7,173015.76,mortgage,108,1
4,173015.76,2331.44,570.95,1760.49,171255.27,mortgage,108,1
5,171255.27,2331.44,565.14,1766.3,169488.97,mortgage,108,1
6,169488.97,2331.44,559.31,1772.13,167716.84,mortgage,108,1
7,167716.84,2331.44,553.47,1777.97,165938.87,mortgage,108,1
8,165938.87,2331.44,547.6,1783.84,164155.03,mortgage,108,1
9,164155.03,2331.44,541.71,1789.73,162365.3,mortgage,108,1
10,162365.3,2331.44,535.81,1795.63,160569.67,mortgage,108,1
11,160569.67,2331.44,529.88,1801.56,158768.11,mortgage,108,1
12,158768.11,2331.44,523.93,1807.51,156960.6,mortgage,108,1
13,156960.6,2331.44,517.97,1813.47,155147.13,mortgage,108,1
14,155147.13,2331.44,511.99,1819.45,153327.68,mortgage,108,1
15,153327.68,2331.44,505.98,1825.46,151502.22,mortgage,108,1
16,151502.22,2331.44,499.96,1831.48,149670.74,mortgage,108,1
17,149670.74,2331.44,493.91,1837.53,147833.21,mortgage,108,1
18,147833.21,2331.44,487.85,1843.59,145989.62,mortgage,108,1
19,145989.62,2331.44,481.77,1849.67,144139.95,mortgage,108,1
20,144139.95,2331.44,475.66,1855.78,142284.17,mortgage,108,1
21,142284.17,2331.44,469.54,1861.9,140422.27,mortgage,108,1
22,140422.27,2331.44,463.39,1868.05,138554.22,mortgage,108,1
23,138554.22,2331.44,457.23,1874.21,136680.01,mortgage,108,1
24,136680.01,2331.44,451.04,1880.4,134799.61,mortgage,108,1
25,134799.61,2331.44,444.84,1886.6,132913.01,mortgage,108,1
26,132913.01,2331.44,438.61,1892.83,131020.18,mortgage,108,1
27,131020.18,2331.44,432.37,1899.07,129121.11,mortgage,108,1
28,129121.11,2331.44,426.1,1905.34,127215.77,mortgage,108,1
29,127215.77,2331.44,419.81,1911.63,125304.14,mortgage,108,1
30,125304.14,2331.44,413.5,1917.94,123386.2,mortgage,108,1
31,123386.2,2331.44,407.17,1924.27,121461.93,mortgage,108,1
32,121461.93,2331.44,400.82,1930.62,119531.31,mortgage,108,1
33,119531.31,2331.44,394.45,1936.99,117594.32,mortgage,108,1
34,117594.32,2331.44,388.06,1943.38,115650.94,mortgage,108,1
35,115650.94,2331.44,381.65,1949.79,113701.15,mortgage,108,1
36,113701.15,2331.44,375.21,1956.23,111744.92,mortgage,108,1
37,111744.92,2331.44,368.76,1962.68,109782.24,mortgage,108,1
38,109782.24,2331.44,362.28,1969.16,107813.08,mortgage,108,1
39,107813.08,2331.44,355.78,1975.66,105837.42,mortgage,108,1
40,105837.42,2331.44,349.26,1982.18,103855.24,mortgage,108,1
41,103855.24,2331.44,342.72,1988.72,101866.52,mortgage,108,1
42,101866.52,2331.44,336.16,1995.28,99871.24,mortgage,108,1
43,99871.24,2331.44,329.58,2001.86,97869.38,mortgage,108,1
44,97869.38,2331.44,322.97,2008.47,95860.91,mortgage,108,1
45,95860.91,2331.44,316.34,2015.1,93845.81,mortgage,108,1
46,93845.81,2331.44,309.69,2021.75,91824.06,mortgage,108,1
47,91824.06,2331.44,303.02,2028.42,89795.64,mortgage,108,1
48,89795.64,2331.44,296.33,2035.11,87760.53,mortgage,108,1
49,87760.53,2331.44,289.61,2041.83,85718.7,mortgage,108,1
50,85718.7,2331.44,282.87,2048.57,83670.13,mortgage,108,1
51,83670.13,2331.44,276.11,2055.33,81614.8,mortgage,108,1
52,81614.8,2331.44,269.33,2062.11,79552.69,mortgage,108,1
53,79552.69,2331.44,262.52,2068.92,77483.77,mortgage,108,1
54,77483.77,2331.44,255.7,2075.74,75408.03,mortgage,108,1
55,75408.03,2331.44,248.85,2082.59,73325.44,mortgage,108,1
56,73325.44,2331.44,241.97,2089.47,71235.97,mortgage,108,1
57,71235.97,2331.44,235.08,2096.36,69139.61,mortgage,108,1
58,69139.61,2331.44,228.16,2103.28,67036.33,mortgage,108,1
59,67036.33,2331.44,221.22,2110.22,64926.11,mortgage,108,1
60,64926.11,2331.44,214.26,2117.18,62808.93,mortgage,108,1
61,62808.93,2331.44,207.27,2124.17,60684.76,mortgage,108,1
62,60684.76,2331.44,200.26,2131.18,58553.58,mortgage,108,1
63,58553.58,2331.44,193.23,2138.21,56415.37,mortgage,108,1
64,56415.37,2331.44,186.17,2145.27,54270.1,mortgage,108,1
65,54270.1,2331.44,179.09,2152.35,52117.75,mortgage,108,1
66,52117.75,2331.44,171.99,2159.45,49958.3,mortgage,108,1
67,49958.3,2331.44,164.86,2166.58,47791.72,mortgage,108,1
68,47791.72,2331.44,157.71,2173.73,45617.99,mortgage,108,1
69,45617.99,2331.44,150.54,2180.9,43437.09,mortgage,108,1
70,43437.09,2331.44,143.34,2188.1,41248.99,mortgage,108,1
71,41248.99,2331.44,136.12,2195.32,39053.67,mortgage,108,1
72,39053.67,2331.44,128.88,2202.56,36851.11,mortgage,108,1
73,36851.11,2331.44,121.61,2209.83,34641.28,mortgage,108,1
74,34641.28,2331.44,114.32,2217.12,32424.16,mortgage,108,1
75,32424.16,2331.44,107.0,2224.44,30199.72,mortgage,108,1
76,30199.72,2331.44,99.66,2231.78,27967.94,mortgage,108,1
77,27967.94,2331.44,92.29,2239.15,25728.79,mortgage,108,1
78,25728.79,2331.44,84.91,2246.53,23482.26,mortgage,108,1
79,23482.26,2331.44,77.49,2253.95,21228.31,mortgage,108,1
80,21228.31,2331.44,70.05,2261.39,18966.92,mortgage,108,1
81,18966.92,2331.44,62.59,2268.85,16698.07,mortgage,108,1
82,16698.07,2331.44,55.1,2276.34,14421.73,mortgage,108,1
83,14421.73,2331.44,47.59,2283.85,12137.88,mortgage,108,1
84,12137.88,2331.44,40.06,2291.38,9846.5,mortgage,108,1
85,9846.5,2331.44,32.49,2298.95,7547.55,mortgage,108,1
86,7547.55,2331.44,24.91,2306.53,5241.02,mortgage,108,1
87,5241.02,2331.44,17.3,2314.14,2926.88,mortgage,108,1
88,2926.88,2331.44,9.66,2321.78,605.1,mortgage,108,1
89,605.1,2331.44,2.0,2329.44,-1724.34,mortgage,108,1
0,5000.0,333.0,36.0,297.0,4703.0,Car,108,2
1,4703.0,333.0,33.86,299.14,4403.86,Car,108,2
2,4403.86,333.0,31.71,301.29,4102.57,Car,108,2
3,4102.57,333.0,29.54,303.46,3799.11,Car,108,2
4,3799.11,333.0,27.35,305.65,3493.46,Car,108,2
5,3493.46,333.0,25.15,307.85,3185.61,Car,108,2
6,3185.61,333.0,22.94,310.06,2875.55,Car,108,2
7,2875.55,333.0,20.7,312.3,2563.25,Car,108,2
8,2563.25,333.0,18.46,314.54,2248.71,Car,108,2
9,2248.71,333.0,16.19,316.81,1931.9,Car,108,2
10,1931.9,333.0,13.91,319.09,1612.81,Car,108,2
11,1612.81,333.0,11.61,321.39,1291.42,Car,108,2
12,1291.42,333.0,9.3,323.7,967.72,Car,108,2
13,967.72,333.0,6.97,326.03,641.69,Car,108,2
14,641.69,333.0,4.62,328.38,313.31,Car,108,2
15,313.31,333.0,2.26,330.74,-17.43,Car,108,2
0,20000.0,191.04,108.0,83.04,19916.96,WellsFargo2,108,3
1,19916.96,191.04,107.55,83.49,19833.47,WellsFargo2,108,3
2,19833.47,191.04,107.1,83.94,19749.53,WellsFargo2,108,3
3,19749.53,191.04,106.65,84.39,19665.14,WellsFargo2,108,3
4,19665.14,191.04,106.19,84.85,19580.29,WellsFargo2,108,3
5,19580.29,191.04,105.73,85.31,19494.98,WellsFargo2,108,3
6,19494.98,191.04,105.27,85.77,19409.21,WellsFargo2,108,3
7,19409.21,191.04,104.81,86.23,19322.98,WellsFargo2,108,3
8,19322.98,191.04,104.34,86.7,19236.28,WellsFargo2,108,3
9,19236.28,191.04,103.88,87.16,19149.12,WellsFargo2,108,3
10,19149.12,191.04,103.41,87.63,19061.49,WellsFargo2,108,3
11,19061.49,191.04,102.93,88.11,18973.38,WellsFargo2,108,3
12,18973.38,191.04,102.46,88.58,18884.8,WellsFargo2,108,3
13,18884.8,191.04,101.98,89.06,18795.74,WellsFargo2,108,3
14,18795.74,191.04,101.5,89.54,18706.2,WellsFargo2,108,3
15,18706.2,208.47,101.01,107.46,18598.74,WellsFargo2,108,3
16,18598.74,2855.48,100.43,2755.05,15843.69,WellsFargo2,108,3
17,15843.69,2855.48,85.56,2769.92,13073.77,WellsFargo2,108,3
18,13073.77,2855.48,70.6,2784.88,10288.89,WellsFargo2,108,3
19,10288.89,2855.48,55.56,2799.92,7488.97,WellsFargo2,108,3
20,7488.97,2855.48,40.44,2815.04,4673.93,WellsFargo2,108,3
21,4673.93,2855.48,25.24,2830.24,1843.69,WellsFargo2,108,3
22,1843.69,2855.48,9.96,2845.52,-1001.83,WellsFargo2,108,3
0,8250.57,84.62,53.63,30.99,8219.58,WellsFargo1,108,4
1,8219.58,84.62,53.43,31.19,8188.39,WellsFargo1,108,4
2,8188.39,84.62,53.22,31.4,8156.99,WellsFargo1,108,4
3,8156.99,84.62,53.02,31.6,8125.39,WellsFargo1,108,4
4,8125.39,84.62,52.82,31.8,8093.59,WellsFargo1,108,4
5,8093.59,84.62,52.61,32.01,8061.58,WellsFargo1,108,4
6,8061.58,84.62,52.4,32.22,8029.36,WellsFargo1,108,4
7,8029.36,84.62,52.19,32.43,7996.93,WellsFargo1,108,4
8,7996.93,84.62,51.98,32.64,7964.29,WellsFargo1,108,4
9,7964.29,84.62,51.77,32.85,7931.44,WellsFargo1,108,4
10,7931.44,84.62,51.55,33.07,7898.37,WellsFargo1,108,4
11,7898.37,84.62,51.34,33.28,7865.09,WellsFargo1,108,4
12,7865.09,84.62,51.12,33.5,7831.59,WellsFargo1,108,4
13,7831.59,84.62,50.91,33.71,7797.88,WellsFargo1,108,4
14,7797.88,84.62,50.69,33.93,7763.95,WellsFargo1,108,4
15,7763.95,84.62,50.47,34.15,7729.8,WellsFargo1,108,4
16,7729.8,84.62,50.24,34.38,7695.42,WellsFargo1,108,4
17,7695.42,84.62,50.02,34.6,7660.82,WellsFargo1,108,4
18,7660.82,84.62,49.8,34.82,7626.0,WellsFargo1,108,4
19,7626.0,84.62,49.57,35.05,7590.95,WellsFargo1,108,4
20,7590.95,84.62,49.34,35.28,7555.67,WellsFargo1,108,4
21,7555.67,84.62,49.11,35.51,7520.16,WellsFargo1,108,4
22,7520.16,1086.45,48.88,1037.57,6482.59,WellsFargo1,108,4
23,6482.59,2940.1,42.14,2897.96,3584.63,WellsFargo1,108,4
24,3584.63,2940.1,23.3,2916.8,667.83,WellsFargo1,108,4
25,667.83,2940.1,4.34,2935.76,-2267.93,WellsFargo1,108,4
0,4000.0,70.0,16.0,54.0,3946.0,testing,108,5
1,3946.0,70.0,15.78,54.22,3891.78,testing,108,5
2,3891.78,70.0,15.57,54.43,3837.35,testing,108,5
3,3837.35,70.0,15.35,54.65,3782.7,testing,108,5
4,3782.7,70.0,15.13,54.87,3727.83,testing,108,5
5,3727.83,70.0,14.91,55.09,3672.74,testing,108,5
6,3672.74,70.0,14.69,55.31,3617.43,testing,108,5
7,3617.43,70.0,14.47,55.53,3561.9,testing,108,5
8,3561.9,70.0,14.25,55.75,3506.15,testing,108,5
9,3506.15,70.0,14.02,55.98,3450.17,testing,108,5
10,3450.17,70.0,13.8,56.2,3393.97,testing,108,5
11,3393.97,70.0,13.58,56.42,3337.55,testing,108,5
12,3337.55,70.0,13.35,56.65,3280.9,testing,108,5
13,3280.9,70.0,13.12,56.88,3224.02,testing,108,5
14,3224.02,70.0,12.9,57.1,3166.92,testing,108,5
15,3166.92,70.0,12.67,57.33,3109.59,testing,108,5
16,3109.59,70.0,12.44,57.56,3052.03,testing,108,5
17,3052.03,70.0,12.21,57.79,2994.24,testing,108,5
18,2994.24,70.0,11.98,58.02,2936.22,testing,108,5
19,2936.22,70.0,11.74,58.26,2877.96,testing,108,5
20,2877.96,70.0,11.51,58.49,2819.47,testing,108,5
21,2819.47,70.0,11.28,58.72,2760.75,testing,108,5
22,2760.75,70.0,11.04,58.96,2701.79,testing,108,5
23,2701.79,70.0,10.81,59.19,2642.6,testing,108,5
24,2642.6,70.0,10.57,59.43,2583.17,testing,108,5
25,2583.17,2337.93,10.33,2327.6,255.57,testing,108,5
26,255.57,3010.1,1.02,3009.08,-2753.51,testing,108,5
0,180000.0,2331.44,594.0,1737.44,178262.56,mortgage,109,1
1,178262.56,2331.44,588.27,1743.17,176519.39,mortgage,109,1
2,176519.39,2331.44,582.51,1748.93,174770.46,mortgage,109,1
3,174770.46,2331.44,576.74,1754.7,173015.76,mortgage,109,1
4,173015.76,2331.44,570.95,1760.49,171255.27,mortgage,109,1
5,171255.27,2331.44,565.14,1766.3,169488.97,mortgage,109,1
6,169488.97,2331.44,559.31,1772.13,167716.84,mortgage,109,1
7,167716.84,2331.44,553.47,1777.97,165938.87,mortgage,109,1
8,165938.87,2331.44,547.6,1783.84,164155.03,mortgage,109,1
9,164155.03,2331.44,541.71,1789.73,162365.3,mortgage,109,1
10,162365.3,2331.44,535.81,1795.63,160569.67,mortgage,109,1
11,160569.67,2331.44,529.88,1801.56,158768.11,mortgage,109,1
12,158768.11,2331.44,523.93,1807.51,156960.6,mortgage,109,1
13,156960.6,2331.44,517.97,1813.47,155147.13,mortgage,109,1
14,155147.13,2331.44,511.99,1819.45,153327.68,mortgage,109,1
15,153327.68,2331.44,505.98,1825.46,151502.22,mortgage,109,1
16,151502.22,2331.44,499.96,1831.48,149670.74,mortgage,109,1
17,149670.74,2331.44,493.91,1837.53,147833.21,mortgage,109,1
18,147833.21,2331.44,487.85,1843.59,145989.62,mortgage,109,1
19,145989.62,2331.44,481.77,1849.67,144139.95,mortgage,109,1
20,144139.95,2331.44,475.66,1855.78,142284.17,mortgage,109,1
21,142284.17,2331.44,469.54,1861.9,140422.27,mortgage,109,1
22,140422.27,2331.44,463.39,1868.05,138554.22,mortgage,109,1
23,138554.22,2331.44,457.23,1874.21,136680.01,mortgage,109,1
24,136680.01,2331.44,451.04,1880.4,134799.61,mortgage,109,1
25,134799.61,2331.44,444.84,1886.6,132913.01,mortgage,109,1
26,132913.01,2331.44,438.61,1892.83,131020.18,mortgage,109,1
27,131020.18,2331.44,432.37,1899.07,129121.11,mortgage,109,1
28,129121.11,2331.44,426.1,1905.34,127215.77,mortgage,109,1
29,127215.77,2331.44,419.81,1911.63,125304.14,mortgage,109,1
30,125304.14,2331.44,413.5,1917.94,123386.2,mortgage,109,1
31,123386.2,2331.44,407.17,1924.27,121461.93,mortgage,109,1
32,121461.93,2331.44,400.82,1930.62,119531.31,mortgage,109,1
33,119531.31,2331.44,394.45,1936.99,117594.32,mortgage,109,1
34,117594.32,2331.44,388.06,1943.38,115650.94,mortgage,109,1
35,115650.94,2331.44,381.65,1949.79,113701.15,mortgage,109,1
36,113701.15,2331.44,375.21,1956.23,111744.92,mortgage,109,1
37,111744.92,2331.44,368.76,1962.68,109782.24,mortgage,109,1
38,109782.24,2331.44,362.28,1969.16,107813.08,mortgage,109,1
39,107813.08,2331.44,355.78,1975.66,105837.42,mortgage,109,1
40,105837.42,2331.44,349.26,1982.18,103855.24,mortgage,109,1
41,103855.24,2331.44,342.72,1988.72,101866.52,mortgage,109,1
42,101866.52,2331.44,336.16,1995.28,99871.24,mortgage,109,1
43,99871.24,2331.44,329.58,2001.86,97869.38,mortgage,109,1
44,97869.38,2331.44,322.97,2008.47,95860.91,mortgage,109,1
45,95860.91,2331.44,316.34,2015.1,93845.81,mortgage,109,1
46,93845.81,2331.44,309.69,2021.75,91824.06,mortgage,109,1
47,91824.06,2331.44,303.02,2028.42,89795.64,mortgage,109,1
48,89795.64,2331.44,296.33,2035.11,87760.53,mortgage,109,1
49,87760.53,2331.44,289.61,2041.83,85718.7,mortgage,109,1
50,85718.7,2331.44,282.87,2048.57,83670.13,mortgage,109,1
51,83670.13,2331.44,276.11,2055.33,81614.8,mortgage,109,1
52,81614.8,2331.44,269.33,2062.11,79552.69,mortgage,109,1
53,79552.69,2331.44,262.52,2068.92,77483.77,mortgage,109,1
54,77483.77,2331.44,255.7,2075.74,75408.03,mortgage,109,1
55,75408.03,2331.44,248.85,2082.59,73325.44,mortgage,109,1
56,73325.44,2331.44,241.97,2089.47,71235.97,mortgage,109,1
57,71235.97,2331.44,235.08,2096.36,69139.61,mortgage,109,1
58,69139.61,2331.44,228.16,2103.28,67036.33,mortgage,109,1
59,67036.33,2331.44,221.22,2110.22,64926.11,mortgage,109,1
60,64926.11,2331.44,214.26,2117.18,62808.93,mortgage,109,1
61,62808.93,2331.44,207.27,2124.17,60684.76,mortgage,109,1
62,60684.76,2331.44,200.26,2131.18,58553.58,mortgage,109,1
63,58553.58,2331.44,193.23,2138.21,56415.37,mortgage,109,1
64,56415.37,2331.44,186.17,2145.27,54270.1,mortgage,109,1
65,54270.1,2331.44,179.09,2152.35,52117.75,mortgage,109,1
66,52117.75,2331.44,171.99,2159.45,49958.3,mortgage,109,1
67,49958.3,2331.44,164.86,2166.58,47791.72,mortgage,109,1
68,47791.72,2331.44,157.71,2173.73,45617.99,mortgage,109,1
69,45617.99,2331.44,150.54,2180.9,43437.09,mortgage,109,1
70,43437.09,2331.44,143.34,2188.1,41248.99,mortgage,109,1
71,41248.99,2331.44,136.12,2195.32,39053.67,mortgage,109,1
72,39053.67,2331.44,128.88,2202.56,36851.11,mortgage,109,1
73,36851.11,2331.44,121.61,2209.83,34641.28,mortgage,109,1
74,34641.28,2331.44,114.32,2217.12,32424.16,mortgage,109,1
75,32424.16,2331.44,107.0,2224.44,30199.72,mortgage,109,1
76,30199.72,2331.44,99.66,2231.78,27967.94,mortgage,109,1
77,27967.94,2331.44,92.29,2239.15,25728.79,mortgage,109,1
78,25728.79,2331.44,84.91,2246.53,23482.26,mortgage,109,1
79,23482.26,2331.44,77.49,2253.95,21228.31,mortgage,109,1
80,21228.31,2331.44,70.05,2261.39,18966.92,mortgage,109,1
81,18966.92,2331.44,62.59,2268.85,16698.07,mortgage,109,1
82,16698.07,2331.44,55.1,2276.34,14421.73,mortgage,109,1
83,14421.73,2331.44,47.59,2283.85,12137.88,mortgage,109,1
84,12137.88,2331.44,40.06,2291.38,9846.5,mortgage,109,1
85,9846.5,2331.44,32.49,2298.95,7547.55,mortgage,109,1
86,7547.55,2331.44,24.91,2306.53,5241.02,mortgage,109,1
87,5241.02,2331.44,17.3,2314.14,2926.88,mortgage,109,1
88,2926.88,2331.44,9.66,2321.78,605.1,mortgage,109,1
89,605.1,2331.44,2.0,2329.44,-1724.34,mortgage,109,1
0,8250.57,84.62,53.63,30.99,8219.58,WellsFargo1,109,2
1,8219.58,84.62,53.43,31.19,8188.39,WellsFargo1,109,2
2,8188.39,84.62,53.22,31.4,8156.99,WellsFargo1,109,2
3,8156.99,84.62,53.02,31.6,8125.39,WellsFargo1,109,2
4,8125.39,84.62,52.82,31.8,8093.59,WellsFargo1,109,2
5,8093.59,84.62,52.61,32.01,8061.58,WellsFargo1,109,2
6,8061.58,84.62,52.4,32.22,8029.36,WellsFargo1,109,2
7,8029.36,84.62,52.19,32.43,7996.93,WellsFargo1,109,2
8,7996.93,84.62,51.98,32.64,7964.29,WellsFargo1,109,2
9,7964.29,84.62,51.77,32.85,7931.44,WellsFargo1,109,2
10,7931.44,84.62,51.55,33.07,7898.37,WellsFargo1,109,2
11,7898.37,84.62,51.34,33.28,7865.09,WellsFargo1,109,2
12,7865.09,84.62,51.12,33.5,7831.59,WellsFargo1,109,2
13,7831.59,84.62,50.91,33.71,7797.88,WellsFargo1,109,2
14,7797.88,84.62,50.69,33.93,7763.95,WellsFargo1,109,2
15,7763.95,84.62,50.47,34.15,7729.8,WellsFargo1,109,2
16,7729.8,84.62,50.24,34.38,7695.42,WellsFargo1,109,2
17,7695.42,84.62,50.02,34.6,7660.82,WellsFargo1,109,2
18,7660.82,84.62,49.8,34.82,7626.0,WellsFargo1,109,2
19,7626.0,84.62,49.57,35.05,7590.95,WellsFargo1,109,2
20,7590.95,84.62,49.34,35.28,7555.67,WellsFargo1,109,2
21,7555.67,84.62,49.11,35.51,7520.16,WellsFargo1,109,2
22,7520.16,84.62,48.88,35.74,7484.42,WellsFargo1,109,2
23,7484.42,84.62,48.65,35.97,7448.45,WellsFargo1,109,2
24,7448.45,84.62,48.41,36.21,7412.24,WellsFargo1,109,2
25,7412.24,84.62,48.18,36.44,7375.8,WellsFargo1,109,2
26,7375.8,84.62,47.94,36.68,7339.12,WellsFargo1,109,2
27,7339.12,84.62,47.7,36.92,7302.2,WellsFargo1,109,2
28,7302.2,84.62,47.46,37.16,7265.04,WellsFargo1,109,2
29,7265.04,84.62,47.22,37.4,7227.64,WellsFargo1,109,2
30,7227.64,84.62,46.98,37.64,7190.0,WellsFargo1,109,2
31,7190.0,84.62,46.73,37.89,7152.11,WellsFargo1,109,2
32,7152.11,84.62,46.49,38.13,7113.98,WellsFargo1,109,2
33,7113.98,84.62,46.24,38.38,7075.6,WellsFargo1,109,2
34,7075.6,84.62,45.99,38.63,7036.97,WellsFargo1,109,2
35,7036.97,84.62,45.74,38.88,6998.09,WellsFargo1,109,2
36,6998.09,84.62,45.49,39.13,6958.96,WellsFargo1,109,2
37,6958.96,84.62,45.23,39.39,6919.57,WellsFargo1,109,2
38,6919.57,84.62,44.98,39.64,6879.93,WellsFargo1,109,2
39,6879.93,84.62,44.72,39.9,6840.03,WellsFargo1,109,2
40,6840.03,84.62,44.46,40.16,6799.87,WellsFargo1,109,2
41,6799.87,84.62,44.2,40.42,6759.45,WellsFargo1,109,2
42,6759.45,84.62,43.94,40.68,6718.77,WellsFargo1,109,2
43,6718.77,84.62,43.67,40.95,6677.82,WellsFargo1,109,2
44,6677.82,84.62,43.41,41.21,6636.61,WellsFargo1,109,2
45,6636.61,84.62,43.14,41.48,6595.13,WellsFargo1,109,2
46,6595.13,84.62,42.87,41.75,6553.38,WellsFargo1,109,2
47,6553.38,84.62,42.6,42.02,6511.36,WellsFargo1,109,2
48,6511.36,84.62,42.32,42.3,6469.06,WellsFargo1,109,2
49,6469.06,84.62,42.05,42.57,6426.49,WellsFargo1,109,2
50,6426.49,84.62,41.77,42.85,6383.64,WellsFargo1,109,2
51,6383.64,84.62,41.49,43.13,6340.51,WellsFargo1,109,2
52,6340.51,84.62,41.21,43.41,6297.1,WellsFargo1,109,2
53,6297.1,84.62,40.93,43.69,6253.41,WellsFargo1,109,2
54,6253.41,84.62,40.65,43.97,6209.44,WellsFargo1,109,2
55,6209.44,84.62,40.36,44.26,6165.18,WellsFargo1,109,2
56,6165.18,84.62,40.07,44.55,6120.63,WellsFargo1,109,2
57,6120.63,84.62,39.78,44.84,6075.79,WellsFargo1,109,2
58,6075.79,84.62,39.49,45.13,6030.66,WellsFargo1,109,2
59,6030.66,84.62,39.2,45.42,5985.24,WellsFargo1,109,2
60,5985.24,84.62,38.9,45.72,5939.52,WellsFargo1,109,2
61,5939.52,84.62,38.61,46.01,5893.51,WellsFargo1,109,2
62,5893.51,84.62,38.31,46.31,5847.2,WellsFargo1,109,2
63,5847.2,84.62,38.01,46.61,5800.59,WellsFargo1,109,2
64,5800.59,84.62,37.7,46.92,5753.67,WellsFargo1,109,2
65,5753.67,84.62,37.4,47.22,5706.45,WellsFargo1,109,2
66,5706.45,84.62,37.09,47.53,5658.92,WellsFargo1,109,2
67,5658.92,84.62,36.78,47.84,5611.08,WellsFargo1,109,2
68,5611.08,84.62,36.47,48.15,5562.93,WellsFargo1,109,2
69,5562.93,84.62,36.16,48.46,5514.47,WellsFargo1,109,2
70,5514.47,84.62,35.84,48.78,5465.69,WellsFargo1,109,2
71,5465.69,84.62,35.53,49.09,5416.6,WellsFargo1,109,2
72,5416.6,84.62,35.21,49.41,5367.19,WellsFargo1,109,2
73,5367.19,84.62,34.89,49.73,5317.46,WellsFargo1,109,2
74,5317.46,84.62,34.56,50.06,5267.4,WellsFargo1,109,2
75,5267.4,84.62,34.24,50.38,5217.02,WellsFargo1,109,2
76,5217.02,84.62,33.91,50.71,5166.31,WellsFargo1,109,2
77,5166.31,84.62,33.58,51.04,5115.27,WellsFargo1,109,2
78,5115.27,84.62,33.25,51.37,5063.9,WellsFargo1,109,2
79,5063.9,84.62,32.92,51.7,5012.2,WellsFargo1,109,2
80,5012.2,84.62,32.58,52.04,4960.16,WellsFargo1,109,2
81,4960.16,84.62,32.24,52.38,4907.78,WellsFargo1,109,2
82,4907.78,84.62,31.9,52.72,4855.06,WellsFargo1,109,2
83,4855.06,84.62,31.56,53.06,4802.0,WellsFargo1,109,2
84,4802.0,84.62,31.21,53.41,4748.59,WellsFargo1,109,2
85,4748.59,84.62,30.87,53.75,4694.84,WellsFargo1,109,2
86,4694.84,84.62,30.52,54.1,4640.74,WellsFargo1,109,2
87,4640.74,84.62,30.16,54.46,4586.28,WellsFargo1,109,2
88,4586.28,84.62,29.81,54.81,4531.47,WellsFargo1,109,2
89,4531.47,1808.96,29.45,1779.51,2751.96,WellsFargo1,109,2
90,2751.96,2416.06,17.89,2398.17,353.79,WellsFargo1,109,2
91,353.79,2416.06,2.3,2413.76,-2059.97,WellsFargo1,109,2
0,4000.0,70.0,16.0,54.0,3946.0,testing,109,3
1,3946.0,70.0,15.78,54.22,3891.78,testing,109,3
2,3891.78,70.0,15.57,54.43,3837.35,testing,109,3
3,3837.35,70.0,15.35,54.65,3782.7,testing,109,3
4,3782.7,70.0,15.13,54.87,3727.83,testing,109,3
5,3727.83,70.0,14.91,55.09,3672.74,testing,109,3
6,3672.74,70.0,14.69,55.31,3617.43,testing,109,3
7,3617.43,70.0,14.47,55.53,3561.9,testing,109,3
8,3561.9,70.0,14.25,55.75,3506.15,testing,109,3
9,3506.15,70.0,14.02,55.98,3450.17,testing,109,3
10,3450.17,70.0,13.8,56.2,3393.97,testing,109,3
11,3393.97,70.0,13.58,56.42,3337.55,testing,109,3
12,3337.55,70.0,13.35,56.65,3280.9,testing,109,3
13,3280.9,70.0,13.12,56.88,3224.02,testing,109,3
14,3224.02,70.0,12.9,57.1,3166.92,testing,109,3
15,3166.92,70.0,12.67,57.33,3109.59,testing,109,3
16,3109.59,70.0,12.44,57.56,3052.03,testing,109,3
17,3052.03,70.0,12.21,57.79,2994.24,testing,109,3
18,2994.24,70.0,11.98,58.02,2936.22,testing,109,3
19,2936.22,70.0,11.74,58.26,2877.96,testing,109,3
20,2877.96,70.0,11.51,58.49,2819.47,testing,109,3
21,2819.47,70.0,11.28,58.72,2760.75,testing,109,3
22,2760.75,70.0,11.04,58.96,2701.79,testing,109,3
23,2701.79,70.0,10.81,59.19,2642.6,testing,109,3
24,2642.6,70.0,10.57,59.43,2583.17,testing,109,3
25,2583.17,70.0,10.33,59.67,2523.5,testing,109,3
26,2523.5,70.0,10.09,59.91,2463.59,testing,109,3
27,2463.59,70.0,9.85,60.15,2403.44,testing,109,3
28,2403.44,70.0,9.61,60.39,2343.05,testing,109,3
29,2343.05,70.0,9.37,60.63,2282.42,testing,109,3
30,2282.42,70.0,9.13,60.87,2221.55,testing,109,3
31,2221.55,70.0,8.89,61.11,2160.44,testing,109,3
32,2160.44,70.0,8.64,61.36,2099.08,testing,109,3
33,2099.08,70.0,8.4,61.6,2037.48,testing,109,3
34,2037.48,70.0,8.15,61.85,1975.63,testing,109,3
35,1975.63,70.0,7.9,62.1,1913.53,testing,109,3
36,1913.53,70.0,7.65,62.35,1851.18,testing,109,3
37,1851.18,70.0,7.4,62.6,1788.58,testing,109,3
38,1788.58,70.0,7.15,62.85,1725.73,testing,109,3
39,1725.73,70.0,6.9,63.1,1662.63,testing,109,3
40,1662.63,70.0,6.65,63.35,1599.28,testing,109,3
41,1599.28,70.0,6.4,63.6,1535.68,testing,109,3
42,1535.68,70.0,6.14,63.86,1471.82,testing,109,3
43,1471.82,70.0,5.89,64.11,1407.71,testing,109,3
44,1407.71,70.0,5.63,64.37,1343.34,testing,109,3
45,1343.34,70.0,5.37,64.63,1278.71,testing,109,3
46,1278.71,70.0,5.11,64.89,1213.82,testing,109,3
47,1213.82,70.0,4.86,65.14,1148.68,testing,109,3
48,1148.68,70.0,4.59,65.41,1083.27,testing,109,3
49,1083.27,70.0,4.33,65.67,1017.6,testing,109,3
50,1017.6,70.0,4.07,65.93,951.67,testing,109,3
51,951.67,70.0,3.81,66.19,885.48,testing,109,3
52,885.48,70.0,3.54,66.46,819.02,testing,109,3
53,819.02,70.0,3.28,66.72,752.3,testing,109,3
54,752.3,70.0,3.01,66.99,685.31,testing,109,3
55,685.31,70.0,2.74,67.26,618.05,testing,109,3
56,618.05,70.0,2.47,67.53,550.52,testing,109,3
57,550.52,70.0,2.2,67.8,482.72,testing,109,3
58,482.72,70.0,1.93,68.07,414.65,testing,109,3
59,414.65,70.0,1.66,68.34,346.31,testing,109,3
60,346.31,70.0,1.39,68.61,277.7,testing,109,3
61,277.7,70.0,1.11,68.89,208.81,testing,109,3
62,208.81,70.0,0.84,69.16,139.65,testing,109,3
63,139.65,70.0,0.56,69.44,70.21,testing,109,3
64,70.21,70.0,0.28,69.72,0.49,testing,109,3
65,0.49,70.0,0.0,70.0,-69.51,testing,109,3
0,5000.0,333.0,36.0,297.0,4703.0,Car,109,4
1,4703.0,333.0,33.86,299.14,4403.86,Car,109,4
2,4403.86,333.0,31.71,301.29,4102.57,Car,109,4
3,4102.57,333.0,29.54,303.46,3799.11,Car,109,4
4,3799.11,333.0,27.35,305.65,3493.46,Car,109,4
5,3493.46,333.0,25.15,307.85,3185.61,Car,109,4
6,3185.61,333.0,22.94,310.06,2875.55,Car,109,4
7,2875.55,333.0,20.7,312.3,2563.25,Car,109,4
8,2563.25,333.0,18.46,314.54,2248.71,Car,109,4
9,2248.71,333.0,16.19,316.81,1931.9,Car,109,4
10,1931.9,333.0,13.91,319.09,1612.81,Car,109,4
11,1612.81,333.0,11.61,321.39,1291.42,Car,109,4
12,1291.42,333.0,9.3,323.7,967.72,Car,109,4
13,967.72,333.0,6.97,326.03,641.69,Car,109,4
14,641.69,333.0,4.62,328.38,313.31,Car,109,4
15,313.31,333.0,2.26,330.74,-17.43,Car,109,4
0,20000.0,191.04,108.0,83.04,19916.96,WellsFargo2,109,5
1,19916.96,191.04,107.55,83.49,19833.47,WellsFargo2,109,5
2,19833.47,191.04,107.1,83.94,19749.53,WellsFargo2,109,5
3,19749.53,191.04,106.65,84.39,19665.14,WellsFargo2,109,5
4,19665.14,191.04,106.19,84.85,19580.29,WellsFargo2,109,5
5,19580.29,191.04,105.73,85.31,19494.98,WellsFargo2,109,5
6,19494.98,191.04,105.27,85.77,19409.21,WellsFargo2,109,5
7,19409.21,191.04,104.81,86.23,19322.98,WellsFargo2,109,5
8,19322.98,191.04,104.34,86.7,19236.28,WellsFargo2,109,5
9,19236.28,191.04,103.88,87.16,19149.12,WellsFargo2,109,5
10,19149.12,191.04,103.41,87.63,19061.49,WellsFargo2,109,5
11,19061.49,191.04,102.93,88.11,18973.38,WellsFargo2,109,5
12,18973.38,191.04,102.46,88.58,18884.8,WellsFargo2,109,5
13,18884.8,191.04,101.98,89.06,18795.74,WellsFargo2,109,5
14,18795.74,191.04,101.5,89.54,18706.2,WellsFargo2,109,5
15,18706.2,208.47,101.01,107.46,18598.74,WellsFargo2,109,5
16,18598.74,3010.1,100.43,2909.67,15689.07,WellsFargo2,109,5
17,15689.07,3010.1,84.72,2925.38,12763.69,WellsFargo2,109,5
18,12763.69,3010.1,68.92,2941.18,9822.51,WellsFargo2,109,5
19,9822.51,3010.1,53.04,2957.06,6865.45,WellsFargo2,109,5
20,6865.45,3010.1,37.07,2973.03,3892.42,WellsFargo2,109,5
21,3892.42,3010.1,21.02,2989.08,903.34,WellsFargo2,109,5
22,903.34,3010.1,4.88,3005.22,-2101.88,WellsFargo2,109,5
0,180000.0,2331.44,594.0,1737.44,178262.56,mortgage,110,1
1,178262.56,2331.44,588.27,1743.17,176519.39,mortgage,110,1
2,176519.39,2331.44,582.51,1748.93,174770.46,mortgage,110,1
3,174770.46,2331.44,576.74,1754.7,173015.76,mortgage,110,1
4,173015.76,2331.44,570.95,1760.49,171255.27,mortgage,110,1
5,171255.27,2331.44,565.14,1766.3,169488.97,mortgage,110,1
6,169488.97,2331.44,559.31,1772.13,167716.84,mortgage,110,1
7,167716.84,2331.44,553.47,1777.97,165938.87,mortgage,110,1
8,165938.87,2331.44,547.6,1783.84,164155.03,mortgage,110,1
9,164155.03,2331.44,541.71,1789.73,162365.3,mortgage,110,1
10,162365.3,2331.44,535.81,1795.63,160569.67,mortgage,110,1
11,160569.67,2331.44,529.88,1801.56,158768.11,mortgage,110,1
12,158768.11,2331.44,523.93,1807.51,156960.6,mortgage,110,1
13,156960.6,2331.44,517.97,1813.47,155147.13,mortgage,110,1
14,155147.13,2331.44,511.99,1819.45,153327.68,mortgage,110,1
15,153327.68,2331.44,505.98,1825.46,151502.22,mortgage,110,1
16,151502.22,2331.44,499.96,1831.48,149670.74,mortgage,110,1
17,149670.74,2331.44,493.91,1837.53,147833.21,mortgage,110,1
18,147833.21,2331.44,487.85,1843.59,145989.62,mortgage,110,1
19,145989.62,2331.44,481.77,1849.67,144139.95,mortgage,110,1
20,144139.95,2331.44,475.66,1855.78,142284.17,mortgage,110,1
21,142284.17,2331.44,469.54,1861.9,140422.27,mortgage,110,1
22,140422.27,2331.44,463.39,1868.05,138554.22,mortgage,110,1
23,138554.22,2331.44,457.23,1874.21,136680.01,mortgage,110,1
24,136680.01,2331.44,451.04,1880.4,134799.61,mortgage,110,1
25,134799.61,2331.44,444.84,1886.6,132913.01,mortgage,110,1
26,132913.01,2331.44,438.61,1892.83,131020.18,mortgage,110,1
27,131020.18,2331.44,432.37,1899.07,129121.11,mortgage,110,1
28,129121.11,2331.44,426.1,1905.34,127215.77,mortgage,110,1
29,127215.77,2331.44,419.81,1911.63,125304.14,mortgage,110,1
30,125304.14,2331.44,413.5,1917.94,123386.2,mortgage,110,1
31,123386.2,2331.44,407.17,1924.27,121461.93,mortgage,110,1
32,121461.93,2331.44,400.82,1930.62,119531.31,mortgage,110,1
33,119531.31,2331.44,394.45,1936.99,117594.32,mortgage,110,1
34,117594.32,2331.44,388.06,1943.38,115650.94,mortgage,110,1
35,115650.94,2331.44,381.65,1949.79,113701.15,mortgage,110,1
36,113701.15,2331.44,375.21,1956.23,111744.92,mortgage,110,1
37,111744.92,2331.44,368.76,1962.68,109782.24,mortgage,110,1
38,109782.24,2331.44,362.28,1969.16,107813.08,mortgage,110,1
39,107813.08,2331.44,355.78,1975.66,105837.42,mortgage,110,1
40,105837.42,2331.44,349.26,1982.18,103855.24,mortgage,110,1
41,103855.24,2331.44,342.72,1988.72,101866.52,mortgage,110,1
42,101866.52,2331.44,336.16,1995.28,99871.24,mortgage,110,1
43,99871.24,2331.44,329.58,2001.86,97869.38,mortgage,110,1
44,97869.38,2331.44,322.97,2008.47,95860.91,mortgage,110,1
45,95860.91,2331.44,316.34,2015.1,93845.81,mortgage,110,1
46,93845.81,2331.44,309.69,2021.75,91824.06,mortgage,110,1
47,91824.06,2331.44,303.02,2028.42,89795.64,mortgage,110,1
48,89795.64,2331.44,296.33,2035.11,87760.53,mortgage,110,1
49,87760.53,2331.44,289.61,2041.83,85718.7,mortgage,110,1
50,85718.7,2331.44,282.87,2048.57,83670.13,mortgage,110,1
51,83670.13,2331.44,276.11,2055.33,81614.8,mortgage,110,1
52,81614.8,2331.44,269.33,2062.11,79552.69,mortgage,110,1
53,79552.69,2331.44,262.52,2068.92,77483.77,mortgage,110,1
54,77483.77,2331.44,255.7,2075.74,75408.03,mortgage,110,1
55,75408.03,2331.44,248.85,2082.59,73325.44,mortgage,110,1
56,73325.44,2331.44,241.97,2089.47,71235.97,mortgage,110,1
57,71235.97,2331.44,235.08,2096.36,69139.61,mortgage,110,1
58,69139.61,2331.44,228.16,2103.28,67036.33,mortgage,110,1
59,67036.33,2331.44,221.22,2110.22,64926.11,mortgage,110,1
60,64926.11,2331.44,214.26,2117.18,62808.93,mortgage,110,1
61,62808.93,2331.44,207.27,2124.17,60684.76,mortgage,110,1
62,60684.76,2331.44,200.26,2131.18,58553.58,mortgage,110,1
63,58553.58,2331.44,193.23,2138.21,56415.37,mortgage,110,1
64,56415.37,2331.44,186.17,2145.27,54270.1,mortgage,110,1
65,54270.1,2331.44,179.09,2152.35,52117.75,mortgage,110,1
66,52117.75,2331.44,171.99,2159.45,49958.3,mortgage,110,1
67,49958.3,2331.44,164.86,2166.58,47791.72,mortgage,110,1
68,47791.72,2331.44,157.71,2173.73,45617.99,mortgage,110,1
69,45617.99,2331.44,150.54,2180.9,43437.09,mortgage,110,1
70,43437.09,2331.44,143.34,2188.1,41248.99,mortgage,110,1
71,41248.99,2331.44,136.12,2195.32,39053.67,mortgage,110,1
72,39053.67,2331.44,128.88,2202.56,36851.11,mortgage,110,1
73,36851.11,2331.44,121.61,2209.83,34641.28,mortgage,110,1
74,34641.28,2331.44,114.32,2217.12,32424.16,mortgage,110,1
75,32424.16,2331.44,107.0,2224.44,30199.72,mortgage,110,1
76,30199.72,2331.44,99.66,2231.78,27967.94,mortgage,110,1
77,27967.94,2331.44,92.29,2239.15,25728.79,mortgage,110,1
78,25728.79,2331.44,84.91,2246.53,23482.26,mortgage,110,1
79,23482.26,2331.44,77.49,2253.95,21228.31,mortgage,110,1
80,21228.31,2331.44,70.05,2261.39,18966.92,mortgage,110,1
81,18966.92,2331.44,62.59,2268.85,16698.07,mortgage,110,1
82,16698.07,2331.44,55.1,2276.34,14421.73,mortgage,110,1
83,14421.73,2331.44,47.59,2283.85,12137.88,mortgage,110,1
84,12137.88,2331.44,40.06,2291.38,9846.5,mortgage,110,1
85,9846.5,2331.44,32.49,2298.95,7547.55,mortgage,110,1
86,7547.55,2331.44,24.91,2306.53,5241.02,mortgage,110,1
87,5241.02,2331.44,17.3,2314.14,2926.88,mortgage,110,1
88,2926.88,2331.44,9.66,2321.78,605.1,mortgage,110,1
89,605.1,2331.44,2.0,2329.44,-1724.34,mortgage,110,1
0,8250.57,84.62,53.63,30.99,8219.58,WellsFargo1,110,2
1,8219.58,84.62,53.43,31.19,8188.39,WellsFargo1,110,2
2,8188.39,84.62,53.22,31.4,8156.99,WellsFargo1,110,2
3,8156.99,84.62,53.02,31.6,8125.39,WellsFargo1,110,2
4,8125.39,84.62,52.82,31.8,8093.59,WellsFargo1,110,2
5,8093.59,84.62,52.61,32.01,8061.58,WellsFargo1,110,2
6,8061.58,84.62,52.4,32.22,8029.36,WellsFargo1,110,2
7,8029.36,84.62,52.19,32.43,7996.93,WellsFargo1,110,2
8,7996.93,84.62,51.98,32.64,7964.29,WellsFargo1,110,2
9,7964.29,84.62,51.77,32.85,7931.44,WellsFargo1,110,2
10,7931.44,84.62,51.55,33.07,7898.37,WellsFargo1,110,2
11,7898.37,84.62,51.34,33.28,7865.09,WellsFargo1,110,2
12,7865.09,84.62,51.12,33.5,7831.59,WellsFargo1,110,2
13,7831.59,84.62,50.91,33.71,7797.88,WellsFargo1,110,2
14,7797.88,84.62,50.69,33.93,7763.95,WellsFargo1,110,2
15,7763.95,84.62,50.47,34.15,7729.8,WellsFargo1,110,2
16,7729.8,84.62,50.24,34.38,7695.42,WellsFargo1,110,2
17,7695.42,84.62,50.02,34.6,7660.82,WellsFargo1,110,2
18,7660.82,84.62,49.8,34.82,7626.0,WellsFargo1,110,2
19,7626.0,84.62,49.57,35.05,7590.95,WellsFargo1,110,2
20,7590.95,84.62,49.34,35.28,7555.67,WellsFargo1,110,2
21,7555.67,84.62,49.11,35.51,7520.16,WellsFargo1,110,2
22,7520.16,84.62,48.88,35.74,7484.42,WellsFargo1,110,2
23,7484.42,84.62,48.65,35.97,7448.45,WellsFargo1,110,2
24,7448.45,84.62,48.41,36.21,7412.24,WellsFargo1,110,2
25,7412.24,84.62,48.18,36.44,7375.8,WellsFargo1,110,2
26,7375.8,84.62,47.94,36.68,7339.12,WellsFargo1,110,2
27,7339.12,84.62,47.7,36.92,7302.2,WellsFargo1,110,2
28,7302.2,84.62,47.46,37.16,7265.04,WellsFargo1,110,2
29,7265.04,84.62,47.22,37.4,7227.64,WellsFargo1,110,2
30,7227.64,84.62,46.98,37.64,7190.0,WellsFargo1,110,2
31,7190.0,84.62,46.73,37.89,7152.11,WellsFargo1,110,2
32,7152.11,84.62,46.49,38.13,7113.98,WellsFargo1,110,2
33,7113.98,84.62,46.24,38.38,7075.6,WellsFargo1,110,2
34,7075.6,84.62,45.99,38.63,7036.97,WellsFargo1,110,2
35,7036.97,84.62,45.74,38.88,6998.09,WellsFargo1,110,2
36,6998.09,84.62,45.49,39.13,6958.96,WellsFargo1,110,2
37,6958.96,84.62,45.23,39.39,6919.57,WellsFargo1,110,2
38,6919.57,84.62,44.98,39.64,6879.93,WellsFargo1,110,2
39,6879.93,84.62,44.72,39.9,6840.03,WellsFargo1,110,2
40,6840.03,84.62,44.46,40.16,6799.87,WellsFargo1,110,2
41,6799.87,84.62,44.2,40.42,6759.45,WellsFargo1,110,2
42,6759.45,84.62,43.94,40.68,6718.77,WellsFargo1,110,2
43,6718.77,84.62,43.67,40.95,6677.82,WellsFargo1,110,2
44,6677.82,84.62,43.41,41.21,6636.61,WellsFargo1,110,2
45,6636.61,84.62,43.14,41.48,6595.13,WellsFargo1,110,2
46,6595.13,84.62,42.87,41.75,6553.38,WellsFargo1,110,2
47,6553.38,84.62,42.6,42.02,6511.36,WellsFargo1,110,2
48,6511.36,84.62,42.32,42.3,6469.06,WellsFargo1,110,2
49,6469.06,84.62,42.05,42.57,6426.49,WellsFargo1,110,2
50,6426.49,84.62,41.77,42.85,6383.64,WellsFargo1,110,2
51,6383.64,84.62,41.49,43.13,6340.51,WellsFargo1,110,2
52,6340.51,84.62,41.21,43.41,6297.1,WellsFargo1,110,2
53,6297.1,84.62,40.93,43.69,6253.41,WellsFargo1,110,2
54,6253.41,84.62,40.65,43.97,6209.44,WellsFargo1,110,2
55,6209.44,84.62,40.36,44.26,6165.18,WellsFargo1,110,2
56,6165.18,84.62,40.07,44.55,6120.63,WellsFargo1,110,2
57,6120.63,84.62,39.78,44.84,6075.79,WellsFargo1,110,2
58,6075.79,84.62,39.49,45.13,6030.66,WellsFargo1,110,2
59,6030.66,84.62,39.2,45.42,5985.24,WellsFargo1,110,2
60,5985.24,84.62,38.9,45.72,5939.52,WellsFargo1,110,2
61,5939.52,84.62,38.61,46.01,5893.51,WellsFargo1,110,2
62,5893.51,84.62,38.31,46.31,5847.2,WellsFargo1,110,2
63,5847.2,84.62,38.01,46.61,5800.59,WellsFargo1,110,2
64,5800.59,84.62,37.7,46.92,5753.67,WellsFargo1,110,2
65,5753.67,84.62,37.4,47.22,5706.45,WellsFargo1,110,2
66,5706.45,84.62,37.09,47.53,5658.92,WellsFargo1,110,2
67,5658.92,84.62,36.78,47.84,5611.08,WellsFargo1,110,2
68,5611.08,84.62,36.47,48.15,5562.93,WellsFargo1,110,2
69,5562.93,84.62,36.16,48.46,5514.47,WellsFargo1,110,2
70,5514.47,84.62,35.84,48.78,5465.69,WellsFargo1,110,2
71,5465.69,84.62,35.53,49.09,5416.6,WellsFargo1,110,2
72,5416.6,84.62,35.21,49.41,5367.19,WellsFargo1,110,2
73,5367.19,84.62,34.89,49.73,5317.46,WellsFargo1,110,2
74,5317.46,84.62,34.56,50.06,5267.4,WellsFargo1,110,2
75,5267.4,84.62,34.24,50.38,5217.02,WellsFargo1,110,2
76,5217.02,84.62,33.91,50.71,5166.31,WellsFargo1,110,2
77,5166.31,84.62,33.58,51.04,5115.27,WellsFargo1,110,2
78,5115.27,84.62,33.25,51.37,5063.9,WellsFargo1,110,2
79,5063.9,84.62,32.92,51.7,5012.2,WellsFargo1,110,2
80,5012.2,84.62,32.58,52.04,4960.16,WellsFargo1,110,2
81,4960.16,84.62,32.24,52.38,4907.78,WellsFargo1,110,2
82,4907.78,84.62,31.9,52.72,4855.06,WellsFargo1,110,2
83,4855.06,84.62,31.56,53.06,4802.0,WellsFargo1,110,2
84,4802.0,84.62,31.21,53.41,4748.59,WellsFargo1,110,2
85,4748.59,84.62,30.87,53.75,4694.84,WellsFargo1,110,2
86,4694.84,84.62,30.52,54.1,4640.74,WellsFargo1,110,2
87,4640.74,84.62,30.16,54.46,4586.28,WellsFargo1,110,2
88,4586.28,84.62,29.81,54.81,4531.47,WellsFargo1,110,2
89,4531.47,1808.96,29.45,1779.51,2751.96,WellsFargo1,110,2
90,2751.96,2416.06,17.89,2398.17,353.79,WellsFargo1,110,2
91,353.79,2416.06,2.3,2413.76,-2059.97,WellsFargo1,110,2
0,4000.0,70.0,16.0,54.0,3946.0,testing,110,3
1,3946.0,70.0,15.78,54.22,3891.78,testing,110,3
2,3891.78,70.0,15.57,54.43,3837.35,testing,110,3
3,3837.35,70.0,15.35,54.65,3782.7,testing,110,3
4,3782.7,70.0,15.13,54.87,3727.83,testing,110,3
5,3727.83,70.0,14.91,55.09,3672.74,testing,110,3
6,3672.74,70.0,14.69,55.31,3617.43,testing,110,3
7,3617.43,70.0,14.47,55.53,3561.9,testing,110,3
8,3561.9,70.0,14.25,55.75,3506.15,testing,110,3
9,3506.15,70.0,14.02,55.98,3450.17,testing,110,3
10,3450.17,70.0,13.8,56.2,3393.97,testing,110,3
11,3393.97,70.0,13.58,56.42,3337.55,testing,110,3
12,3337.55,70.0,13.35,56.65,3280.9,testing,110,3
13,3280.9,70.0,13.12,56.88,3224.02,testing,110,3
14,3224.02,70.0,12.9,57.1,3166.92,testing,110,3
15,3166.92,70.0,12.67,57.33,3109.59,testing,110,3
16,3109.59,70.0,12.44,57.56,3052.03,testing,110,3
17,3052.03,70.0,12.21,57.79,2994.24,testing,110,3
18,2994.24,70.0,11.98,58.02,2936.22,testing,110,3
19,2936.22,70.0,11.74,58.26,2877.96,testing,110,3
20,2877.96,70.0,11.51,58.49,2819.47,testing,110,3
21,2819.47,70.0,11.28,58.72,2760.75,testing,110,3
22,2760.75,70.0,11.04,58.96,2701.79,testing,110,3
23,2701.79,70.0,10.81,59.19,2642.6,testing,110,3
24,2642.6,70.0,10.57,59.43,2583.17,testing,110,3
25,2583.17,70.0,10.33,59.67,2523.5,testing,110,3
26,2523.5,70.0,10.09,59.91,2463.59,testing,110,3
27,2463.59,70.0,9.85,60.15,2403.44,testing,110,3
28,2403.44,70.0,9.61,60.39,2343.05,testing,110,3
29,2343.05,70.0,9.37,60.63,2282.42,testing,110,3
30,2282.42,70.0,9.13,60.87,2221.55,testing,110,3
31,2221.55,70.0,8.89,61.11,2160.44,testing,110,3
32,2160.44,70.0,8.64,61.36,2099.08,testing,110,3
33,2099.08,70.0,8.4,61.6,2037.48,testing,110,3
34,2037.48,70.0,8.15,61.85,1975.63,testing,110,3
35,1975.63,70.0,7.9,62.1,1913.53,testing,110,3
36,1913.53,70.0,7.65,62.35,1851.18,testing,110,3
37,1851.18,70.0,7.4,62.6,1788.58,testing,110,3
38,1788.58,70.0,7.15,62.85,1725.73,testing,110,3
39,1725.73,70.0,6.9,63.1,1662.63,testing,110,3
40,1662.63,70.0,6.65,63.35,1599.28,testing,110,3
41,1599.28,70.0,6.4,63.6,1535.68,testing,110,3
42,1535.68,70.0,6.14,63.86,1471.82,testing,110,3
43,1471.82,70.0,5.89,64.11,1407.71,testing,110,3
44,1407.71,70.0,5.63,64.37,1343.34,testing,110,3
45,1343.34,70.0,5.37,64.63,1278.71,testing,110,3
46,1278.71,70.0,5.11,64.89,1213.82,testing,110,3
47,1213.82,70.0,4.86,65.14,1148.68,testing,110,3
48,1148.68,70.0,4.59,65.41,1083.27,testing,110,3
49,1083.27,70.0,4.33,65.67,1017.6,testing,110,3
50,1017.6,70.0,4.07,65.93,951.67,testing,110,3
51,951.67,70.0,3.81,66.19,885.48,testing,110,3
52,885.48,70.0,3.54,66.46,819.02,testing,110,3
53,819.02,70.0,3.28,66.72,752.3,testing,110,3
54,752.3,70.0,3.01,66.99,685.31,testing,110,3
55,685.31,70.0,2.74,67.26,618.05,testing,110,3
56,618.05,70.0,2.47,67.53,550.52,testing,110,3
57,550.52,70.0,2.2,67.8,482.72,testing,110,3
58,482.72,70.0,1.93,68.07,414.65,testing,110,3
59,414.65,70.0,1.66,68.34,346.31,testing,110,3
60,346.31,70.0,1.39,68.61,277.7,testing,110,3
61,277.7,70.0,1.11,68.89,208.81,testing,110,3
62,208.81,70.0,0.84,69.16,139.65,testing,110,3
63,139.65,70.0,0.56,69.44,70.21,testing,110,3
64,70.21,70.0,0.28,69.72,0.49,testing,110,3
65,0.49,70.0,0.0,70.0,-69.51,testing,110,3
0,20000.0,191.04,108.0,83.04,19916.96,WellsFargo2,110,4
1,19916.96,191.04,107.55,83.49,19833.47,WellsFargo2,110,4
2,19833.47,191.04,107.1,83.94,19749.53,WellsFargo2,110,4
3,19749.53,191.04,106.65,84.39,19665.14,WellsFargo2,110,4
4,19665.14,191.04,106.19,84.85,19580.29,WellsFargo2,110,4
5,19580.29,191.04,105.73,85.31,19494.98,WellsFargo2,110,4
6,19494.98,191.04,105.27,85.77,19409.21,WellsFargo2,110,4
7,19409.21,191.04,104.81,86.23,19322.98,WellsFargo2,110,4
8,19322.98,191.04,104.34,86.7,19236.28,WellsFargo2,110,4
9,19236.28,191.04,103.88,87.16,19149.12,WellsFargo2,110,4
10,19149.12,191.04,103.41,87.63,19061.49,WellsFargo2,110,4
11,19061.49,191.04,102.93,88.11,18973.38,WellsFargo2,110,4
12,18973.38,191.04,102.46,88.58,18884.8,WellsFargo2,110,4
13,18884.8,191.04,101.98,89.06,18795.74,WellsFargo2,110,4
14,18795.74,191.04,101.5,89.54,18706.2,WellsFargo2,110,4
15,18706.2,191.04,101.01,90.03,18616.17,WellsFargo2,110,4
16,18616.17,191.04,100.53,90.51,18525.66,WellsFargo2,110,4
17,18525.66,191.04,100.04,91.0,18434.66,WellsFargo2,110,4
18,18434.66,191.04,99.55,91.49,18343.17,WellsFargo2,110,4
19,18343.17,191.04,99.05,91.99,18251.18,WellsFargo2,110,4
20,18251.18,191.04,98.56,92.48,18158.7,WellsFargo2,110,4
21,18158.7,191.04,98.06,92.98,18065.72,WellsFargo2,110,4
22,18065.72,191.04,97.55,93.49,17972.23,WellsFargo2,110,4
23,17972.23,191.04,97.05,93.99,17878.24,WellsFargo2,110,4
24,17878.24,191.04,96.54,94.5,17783.74,WellsFargo2,110,4
25,17783.74,191.04,96.03,95.01,17688.73,WellsFargo2,110,4
26,17688.73,191.04,95.52,95.52,17593.21,WellsFargo2,110,4
27,17593.21,191.04,95.0,96.04,17497.17,WellsFargo2,110,4
28,17497.17,191.04,94.48,96.56,17400.61,WellsFargo2,110,4
29,17400.61,191.04,93.96,97.08,17303.53,WellsFargo2,110,4
30,17303.53,191.04,93.44,97.6,17205.93,WellsFargo2,110,4
31,17205.93,191.04,92.91,98.13,17107.8,WellsFargo2,110,4
32,17107.8,191.04,92.38,98.66,17009.14,WellsFargo2,110,4
33,17009.14,191.04,91.85,99.19,16909.95,WellsFargo2,110,4
34,16909.95,191.04,91.31,99.73,16810.22,WellsFargo2,110,4
35,16810.22,191.04,90.78,100.26,16709.96,WellsFargo2,110,4
36,16709.96,191.04,90.23,100.81,16609.15,WellsFargo2,110,4
37,16609.15,191.04,89.69,101.35,16507.8,WellsFargo2,110,4
38,16507.8,191.04,89.14,101.9,16405.9,WellsFargo2,110,4
39,16405.9,191.04,88.59,102.45,16303.45,WellsFargo2,110,4
40,16303.45,191.04,88.04,103.0,16200.45,WellsFargo2,110,4
41,16200.45,191.04,87.48,103.56,16096.89,WellsFargo2,110,4
42,16096.89,191.04,86.92,104.12,15992.77,WellsFargo2,110,4
43,15992.77,191.04,86.36,104.68,15888.09,WellsFargo2,110,4
44,15888.09,191.04,85.8,105.24,15782.85,WellsFargo2,110,4
45,15782.85,191.04,85.23,105.81,15677.04,WellsFargo2,110,4
46,15677.04,191.04,84.66,106.38,15570.66,WellsFargo2,110,4
47,15570.66,191.04,84.08,106.96,15463.7,WellsFargo2,110,4
48,15463.7,191.04,83.5,107.54,15356.16,WellsFargo2,110,4
49,15356.16,191.04,82.92,108.12,15248.04,WellsFargo2,110,4
50,15248.04,191.04,82.34,108.7,15139.34,WellsFargo2,110,4
51,15139.34,191.04,81.75,109.29,15030.05,WellsFargo2,110,4
52,15030.05,191.04,81.16,109.88,14920.17,WellsFargo2,110,4
53,14920.17,191.04,80.57,110.47,14809.7,WellsFargo2,110,4
54,14809.7,191.04,79.97,111.07,14698.63,WellsFargo2,110,4
55,14698.63,191.04,79.37,111.67,14586.96,WellsFargo2,110,4
56,14586.96,191.04,78.77,112.27,14474.69,WellsFargo2,110,4
57,14474.69,191.04,78.16,112.88,14361.81,WellsFargo2,110,4
58,14361.81,191.04,77.55,113.49,14248.32,WellsFargo2,110,4
59,14248.32,191.04,76.94,114.1,14134.22,WellsFargo2,110,4
60,14134.22,191.04,76.32,114.72,14019.5,WellsFargo2,110,4
61,14019.5,191.04,75.71,115.33,13904.17,WellsFargo2,110,4
62,13904.17,191.04,75.08,115.96,13788.21,WellsFargo2,110,4
63,13788.21,191.04,74.46,116.58,13671.63,WellsFargo2,110,4
64,13671.63,191.04,73.83,117.21,13554.42,WellsFargo2,110,4
65,13554.42,260.55,73.19,187.36,13367.06,WellsFargo2,110,4
66,13367.06,2677.1,72.18,2604.92,10762.14,WellsFargo2,110,4
67,10762.14,2677.1,58.12,2618.98,8143.16,WellsFargo2,110,4
68,8143.16,2677.1,43.97,2633.13,5510.03,WellsFargo2,110,4
69,5510.03,2677.1,29.75,2647.35,2862.68,WellsFargo2,110,4
70,2862.68,2677.1,15.46,2661.64,201.04,WellsFargo2,110,4
71,201.04,2677.1,1.09,2676.01,-2474.97,WellsFargo2,110,4
0,5000.0,333.0,36.0,297.0,4703.0,Car,110,5
1,4703.0,333.0,33.86,299.14,4403.86,Car,110,5
2,4403.86,333.0,31.71,301.29,4102.57,Car,110,5
3,4102.57,333.0,29.54,303.46,3799.11,Car,110,5
4,3799.11,333.0,27.35,305.65,3493.46,Car,110,5
5,3493.46,333.0,25.15,307.85,3185.61,Car,110,5
6,3185.61,333.0,22.94,310.06,2875.55,Car,110,5
7,2875.55,333.0,20.7,312.3,2563.25,Car,110,5
8,2563.25,333.0,18.46,314.54,2248.71,Car,110,5
9,2248.71,333.0,16.19,316.81,1931.9,Car,110,5
10,1931.9,333.0,13.91,319.09,1612.81,Car,110,5
11,1612.81,333.0,11.61,321.39,1291.42,Car,110,5
12,1291.42,333.0,9.3,323.7,967.72,Car,110,5
13,967.72,333.0,6.97,326.03,641.69,Car,110,5
14,641.69,333.0,4.62,328.38,313.31,Car,110,5
15,313.31,333.0,2.26,330.74,-17.43,Car,110,5
0,180000.0,2331.44,594.0,1737.44,178262.56,mortgage,111,1
1,178262.56,2331.44,588.27,1743.17,176519.39,mortgage,111,1
2,176519.39,2331.44,582.51,1748.93,174770.46,mortgage,111,1
3,174770.46,2331.44,576.74,1754.7,173015.76,mortgage,111,1
4,173015.76,2331.44,570.95,1760.49,171255.27,mortgage,111,1
5,171255.27,2331.44,565.14,1766.3,169488.97,mortgage,111,1
6,169488.97,2331.44,559.31,1772.13,167716.84,mortgage,111,1
7,167716.84,2331.44,553.47,1777.97,165938.87,mortgage,111,1
8,165938.87,2331.44,547.6,1783.84,164155.03,mortgage,111,1
9,164155.03,2331.44,541.71,1789.73,162365.3,mortgage,111,1
10,162365.3,2331.44,535.81,1795.63,160569.67,mortgage,111,1
11,160569.67,2331.44,529.88,1801.56,158768.11,mortgage,111,1
12,158768.11,2331.44,523.93,1807.51,156960.6,mortgage,111,1
13,156960.6,2331.44,517.97,1813.47,155147.13,mortgage,111,1
14,155147.13,2331.44,511.99,1819.45,153327.68,mortgage,111,1
15,153327.68,2331.44,505.98,1825.46,151502.22,mortgage,111,1
16,151502.22,2331.44,499.96,1831.48,149670.74,mortgage,111,1
17,149670.74,2331.44,493.91,1837.53,147833.21,mortgage,111,1
18,147833.21,2331.44,487.85,1843.59,145989.62,mortgage,111,1
19,145989.62,2331.44,481.77,1849.67,144139.95,mortgage,111,1
20,144139.95,2331.44,475.66,1855.78,142284.17,mortgage,111,1
21,142284.17,2331.44,469.54,1861.9,140422.27,mortgage,111,1
22,140422.27,2331.44,463.39,1868.05,138554.22,mortgage,111,1
23,138554.22,2331.44,457.23,1874.21,136680.01,mortgage,111,1
24,136680.01,2331.44,451.04,1880.4,134799.61,mortgage,111,1
25,134799.61,2331.44,444.84,1886.6,132913.01,mortgage,111,1
26,132913.01,2331.44,438.61,1892.83,131020.18,mortgage,111,1
27,131020.18,2331.44,432.37,1899.07,129121.11,mortgage,111,1
28,129121.11,2331.44,426.1,1905.34,127215.77,mortgage,111,1
29,127215.77,2331.44,419.81,1911.63,125304.14,mortgage,111,1
30,125304.14,2331.44,413.5,1917.94,123386.2,mortgage,111,1
31,123386.2,2331.44,407.17,1924.27,121461.93,mortgage,111,1
32,121461.93,2331.44,400.82,1930.62,119531.31,mortgage,111,1
33,119531.31,2331.44,394.45,1936.99,117594.32,mortgage,111,1
34,117594.32,2331.44,388.06,1943.38,115650.94,mortgage,111,1
35,115650.94,2331.44,381.65,1949.79,113701.15,mortgage,111,1
36,113701.15,2331.44,375.21,1956.23,111744.92,mortgage,111,1
37,111744.92,2331.44,368.76,1962.68,109782.24,mortgage,111,1
38,109782.24,2331.44,362.28,1969.16,107813.08,mortgage,111,1
39,107813.08,2331.44,355.78,1975.66,105837.42,mortgage,111,1
40,105837.42,2331.44,349.26,1982.18,103855.24,mortgage,111,1
41,103855.24,2331.44,342.72,1988.72,101866.52,mortgage,111,1
42,101866.52,2331.44,336.16,1995.28,99871.24,mortgage,111,1
43,99871.24,2331.44,329.58,2001.86,97869.38,mortgage,111,1
44,97869.38,2331.44,322.97,2008.47,95860.91,mortgage,111,1
45,95860.91,2331.44,316.34,2015.1,93845.81,mortgage,111,1
46,93845.81,2331.44,309.69,2021.75,91824.06,mortgage,111,1
47,91824.06,2331.44,303.02,2028.42,89795.64,mortgage,111,1
48,89795.64,2331.44,296.33,2035.11,87760.53,mortgage,111,1
49,87760.53,2331.44,289.61,2041.83,85718.7,mortgage,111,1
50,85718.7,2331.44,282.87,2048.57,83670.13,mortgage,111,1
51,83670.13,2331.44,276.11,2055.33,81614.8,mortgage,111,1
52,81614.8,2331.44,269.33,2062.11,79552.69,mortgage,111,1
53,79552.69,2331.44,262.52,2068.92,77483.77,mortgage,111,1
54,77483.77,2331.44,255.7,2075.74,75408.03,mortgage,111,1
55,75408.03,2331.44,248.85,2082.59,73325.44,mortgage,111,1
56,73325.44,2331.44,241.97,2089.47,71235.97,mortgage,111,1
57,71235.97,2331.44,235.08,2096.36,69139.61,mortgage,111,1
58,69139.61,2331.44,228.16,2103.28,67036.33,mortgage,111,1
59,67036.33,2331.44,221.22,2110.22,64926.11,mortgage,111,1
60,64926.11,2331.44,214.26,2117.18,62808.93,mortgage,111,1
61,62808.93,2331.44,207.27,2124.17,60684.76,mortgage,111,1
62,60684.76,2331.44,200.26,2131.18,58553.58,mortgage,111,1
63,58553.58,2331.44,193.23,2138.21,56415.37,mortgage,111,1
64,56415.37,2331.44,186.17,2145.27,54270.1,mortgage,111,1
65,54270.1,2331.44,179.09,2152.35,52117.75,mortgage,111,1
66,52117.75,2331.44,171.99,2159.45,49958.3,mortgage,111,1
67,49958.3,2331.44,164.86,2166.58,47791.72,mortgage,111,1
68,47791.72,2331.44,157.71,2173.73,45617.99,mortgage,111,1
69,45617.99,2331.44,150.54,2180.9,43437.09,mortgage,111,1
70,43437.09,2331.44,143.34,2188.1,41248.99,mortgage,111,1
71,41248.99,2331.44,136.12,2195.32,39053.67,mortgage,111,1
72,39053.67,2331.44,128.88,2202.56,36851.11,mortgage,111,1
73,36851.11,2331.44,121.61,2209.83,34641.28,mortgage,111,1
74,34641.28,2331.44,114.32,2217.12,32424.16,mortgage,111,1
75,32424.16,2331.44,107.0,2224.44,30199.72,mortgage,111,1
76,30199.72,2331.44,99.66,2231.78,27967.94,mortgage,111,1
77,27967.94,2331.44,92.29,2239.15,25728.79,mortgage,111,1
78,25728.79,2331.44,84.91,2246.53,23482.26,mortgage,111,1
79,23482.26,2331.44,77.49,2253.95,21228.31,mortgage,111,1
80,21228.31,2331.44,70.05,2261.39,18966.92,mortgage,111,1
81,18966.92,2331.44,62.59,2268.85,16698.07,mortgage,111,1
82,16698.07,2331.44,55.1,2276.34,14421.73,mortgage,111,1
83,14421.73,2331.44,47.59,2283.85,12137.88,mortgage,111,1
84,12137.88,2331.44,40.06,2291.38,9846.5,mortgage,111,1
85,9846.5,2331.44,32.49,2298.95,7547.55,mortgage,111,1
86,7547.55,2331.44,24.91,2306.53,5241.02,mortgage,111,1
87,5241.02,2331.44,17.3,2314.14,2926.88,mortgage,111,1
88,2926.88,2331.44,9.66,2321.78,605.1,mortgage,111,1
89,605.1,2331.44,2.0,2329.44,-1724.34,mortgage,111,1
0,8250.57,84.62,53.63,30.99,8219.58,WellsFargo1,111,2
1,8219.58,84.62,53.43,31.19,8188.39,WellsFargo1,111,2
2,8188.39,84.62,53.22,31.4,8156.99,WellsFargo1,111,2
3,8156.99,84.62,53.02,31.6,8125.39,WellsFargo1,111,2
4,8125.39,84.62,52.82,31.8,8093.59,WellsFargo1,111,2
5,8093.59,84.62,52.61,32.01,8061.58,WellsFargo1,111,2
6,8061.58,84.62,52.4,32.22,8029.36,WellsFargo1,111,2
7,8029.36,84.62,52.19,32.43,7996.93,WellsFargo1,111,2
8,7996.93,84.62,51.98,32.64,7964.29,WellsFargo1,111,2
9,7964.29,84.62,51.77,32.85,7931.44,WellsFargo1,111,2
10,7931.44,84.62,51.55,33.07,7898.37,WellsFargo1,111,2
11,7898.37,84.62,51.34,33.28,7865.09,WellsFargo1,111,2
12,7865.09,84.62,51.12,33.5,7831.59,WellsFargo1,111,2
13,7831.59,84.62,50.91,33.71,7797.88,WellsFargo1,111,2
14,7797.88,84.62,50.69,33.93,7763.95,WellsFargo1,111,2
15,7763.95,84.62,50.47,34.15,7729.8,WellsFargo1,111,2
16,7729.8,84.62,50.24,34.38,7695.42,WellsFargo1,111,2
17,7695.42,84.62,50.02,34.6,7660.82,WellsFargo1,111,2
18,7660.82,84.62,49.8,34.82,7626.0,WellsFargo1,111,2
19,7626.0,84.62,49.57,35.05,7590.95,WellsFargo1,111,2
20,7590.95,84.62,49.34,35.28,7555.67,WellsFargo1,111,2
21,7555.67,84.62,49.11,35.51,7520.16,WellsFargo1,111,2
22,7520.16,84.62,48.88,35.74,7484.42,WellsFargo1,111,2
23,7484.42,84.62,48.65,35.97,7448.45,WellsFargo1,111,2
24,7448.45,84.62,48.41,36.21,7412.24,WellsFargo1,111,2
25,7412.24,84.62,48.18,36.44,7375.8,WellsFargo1,111,2
26,7375.8,84.62,47.94,36.68,7339.12,WellsFargo1,111,2
27,7339.12,84.62,47.7,36.92,7302.2,WellsFargo1,111,2
28,7302.2,84.62,47.46,37.16,7265.04,WellsFargo1,111,2
29,7265.04,84.62,47.22,37.4,7227.64,WellsFargo1,111,2
30,7227.64,84.62,46.98,37.64,7190.0,WellsFargo1,111,2
31,7190.0,84.62,46.73,37.89,7152.11,WellsFargo1,111,2
32,7152.11,84.62,46.49,38.13,7113.98,WellsFargo1,111,2
33,7113.98,84.62,46.24,38.38,7075.6,WellsFargo1,111,2
34,7075.6,84.62,45.99,38.63,7036.97,WellsFargo1,111,2
35,7036.97,84.62,45.74,38.88,6998.09,WellsFargo1,111,2
36,6998.09,84.62,45.49,39.13,6958.96,WellsFargo1,111,2
37,6958.96,84.62,45.23,39.39,6919.57,WellsFargo1,111,2
38,6919.57,84.62,44.98,39.64,6879.93,WellsFargo1,111,2
39,6879.93,84.62,44.72,39.9,6840.03,WellsFargo1,111,2
40,6840.03,84.62,44.46,40.16,6799.87,WellsFargo1,111,2
41,6799.87,84.62,44.2,40.42,6759.45,WellsFargo1,111,2
42,6759.45,84.62,43.94,40.68,6718.77,WellsFargo1,111,2
43,6718.77,84.62,43.67,40.95,6677.82,WellsFargo1,111,2
44,6677.82,84.62,43.41,41.21,6636.61,WellsFargo1,111,2
45,6636.61,84.62,43.14,41.48,6595.13,WellsFargo1,111,2
46,6595.13,84.62,42.87,41.75,6553.38,WellsFargo1,111,2
47,6553.38,84.62,42.6,42.02,6511.36,WellsFargo1,111,2
48,6511.36,84.62,42.32,42.3,6469.06,WellsFargo1,111,2
49,6469.06,84.62,42.05,42.57,6426.49,WellsFargo1,111,2
50,6426.49,84.62,41.77,42.85,6383.64,WellsFargo1,111,2
51,6383.64,84.62,41.49,43.13,6340.51,WellsFargo1,111,2
52,6340.51,84.62,41.21,43.41,6297.1,WellsFargo1,111,2
53,6297.1,84.62,40.93,43.69,6253.41,WellsFargo1,111,2
54,6253.41,84.62,40.65,43.97,6209.44,WellsFargo1,111,2
55,6209.44,84.62,40.36,44.26,6165.18,WellsFargo1,111,2
56,6165.18,84.62,40.07,44.55,6120.63,WellsFargo1,111,2
57,6120.63,84.62,39.78,44.84,6075.79,WellsFargo1,111,2
58,6075.79,84.62,39.49,45.13,6030.66,WellsFargo1,111,2
59,6030.66,84.62,39.2,45.42,5985.24,WellsFargo1,111,2
60,5985.24,84.62,38.9,45.72,5939.52,WellsFargo1,111,2
61,5939.52,84.62,38.61,46.01,5893.51,WellsFargo1,111,2
62,5893.51,84.62,38.31,46.31,5847.2,WellsFargo1,111,2
63,5847.2,84.62,38.01,46.61,5800.59,WellsFargo1,111,2
64,5800.59,84.62,37.7,46.92,5753.67,WellsFargo1,111,2
65,5753.67,84.62,37.4,47.22,5706.45,WellsFargo1,111,2
66,5706.45,84.62,37.09,47.53,5658.92,WellsFargo1,111,2
67,5658.92,84.62,36.78,47.84,5611.08,WellsFargo1,111,2
68,5611.08,84.62,36.47,48.15,5562.93,WellsFargo1,111,2
69,5562.93,84.62,36.16,48.46,5514.47,WellsFargo1,111,2
70,5514.47,84.62,35.84,48.78,5465.69,WellsFargo1,111,2
71,5465.69,84.62,35.53,49.09,5416.6,WellsFargo1,111,2
72,5416.6,84.62,35.21,49.41,5367.19,WellsFargo1,111,2
73,5367.19,84.62,34.89,49.73,5317.46,WellsFargo1,111,2
74,5317.46,84.62,34.56,50.06,5267.4,WellsFargo1,111,2
75,5267.4,84.62,34.24,50.38,5217.02,WellsFargo1,111,2
76,5217.02,84.62,33.91,50.71,5166.31,WellsFargo1,111,2
77,5166.31,84.62,33.58,51.04,5115.27,WellsFargo1,111,2
78,5115.27,84.62,33.25,51.37,5063.9,WellsFargo1,111,2
79,5063.9,84.62,32.92,51.7,5012.2,WellsFargo1,111,2
80,5012.2,84.62,32.58,52.04,4960.16,WellsFargo1,111,2
81,4960.16,84.62,32.24,52.38,4907.78,WellsFargo1,111,2
82,4907.78,84.62,31.9,52.72,4855.06,WellsFargo1,111,2
83,4855.06,84.62,31.56,53.06,4802.0,WellsFargo1,111,2
84,4802.0,84.62,31.21,53.41,4748.59,WellsFargo1,111,2
85,4748.59,84.62,30.87,53.75,4694.84,WellsFargo1,111,2
86,4694.84,84.62,30.52,54.1,4640.74,WellsFargo1,111,2
87,4640.74,84.62,30.16,54.46,4586.28,WellsFargo1,111,2
88,4586.28,84.62,29.81,54.81,4531.47,WellsFargo1,111,2
89,4531.47,1808.96,29.45,1779.51,2751.96,WellsFargo1,111,2
90,2751.96,2416.06,17.89,2398.17,353.79,WellsFargo1,111,2
91,353.79,2416.06,2.3,2413.76,-2059.97,WellsFargo1,111,2
0,5000.0,333.0,36.0,297.0,4703.0,Car,111,3
1,4703.0,333.0,33.86,299.14,4403.86,Car,111,3
2,4403.86,333.0,31.71,301.29,4102.57,Car,111,3
3,4102.57,333.0,29.54,303.46,3799.11,Car,111,3
4,3799.11,333.0,27.35,305.65,3493.46,Car,111,3
5,3493.46,333.0,25.15,307.85,3185.61,Car,111,3
6,3185.61,333.0,22.94,310.06,2875.55,Car,111,3
7,2875.55,333.0,20.7,312.3,2563.25,Car,111,3
8,2563.25,333.0,18.46,314.54,2248.71,Car,111,3
9,2248.71,333.0,16.19,316.81,1931.9,Car,111,3
10,1931.9,333.0,13.91,319.09,1612.81,Car,111,3
11,1612.81,333.0,11.61,321.39,1291.42,Car,111,3
12,1291.42,333.0,9.3,323.7,967.72,Car,111,3
13,967.72,333.0,6.97,326.03,641.69,Car,111,3
14,641.69,333.0,4.62,328.38,313.31,Car,111,3
15,313.31,333.0,2.26,330.74,-17.43,Car,111,3
0,4000.0,70.0,16.0,54.0,3946.0,testing,111,4
1,3946.0,70.0,15.78,54.22,3891.78,testing,111,4
2,3891.78,70.0,15.57,54.43,3837.35,testing,111,4
3,3837.35,70.0,15.35,54.65,3782.7,testing,111,4
4,3782.7,70.0,15.13,54.87,3727.83,testing,111,4
5,3727.83,70.0,14.91,55.09,3672.74,testing,111,4
6,3672.74,70.0,14.69,55.31,3617.43,testing,111,4
7,3617.43,70.0,14.47,55.53,3561.9,testing,111,4
8,3561.9,70.0,14.25,55.75,3506.15,testing,111,4
9,3506.15,70.0,14.02,55.98,3450.17,testing,111,4
10,3450.17,70.0,13.8,56.2,3393.97,testing,111,4
11,3393.97,70.0,13.58,56.42,3337.55,testing,111,4
12,3337.55,70.0,13.35,56.65,3280.9,testing,111,4
13,3280.9,70.0,13.12,56.88,3224.02,testing,111,4
14,3224.02,70.0,12.9,57.1,3166.92,testing,111,4
15,3166.92,87.43,12.67,74.76,3092.16,testing,111,4
16,3092.16,2819.06,12.37,2806.69,285.47,testing,111,4
17,285.47,2819.06,1.14,2817.92,-2532.45,testing,111,4
0,20000.0,191.04,108.0,83.04,19916.96,WellsFargo2,111,5
1,19916.96,191.04,107.55,83.49,19833.47,WellsFargo2,111,5
2,19833.47,191.04,107.1,83.94,19749.53,WellsFargo2,111,5
3,19749.53,191.04,106.65,84.39,19665.14,WellsFargo2,111,5
4,19665.14,191.04,106.19,84.85,19580.29,WellsFargo2,111,5
5,19580.29,191.04,105.73,85.31,19494.98,WellsFargo2,111,5
6,19494.98,191.04,105.27,85.77,19409.21,WellsFargo2,111,5
7,19409.21,191.04,104.81,86.23,19322.98,WellsFargo2,111,5
8,19322.98,191.04,104.34,86.7,19236.28,WellsFargo2,111,5
9,19236.28,191.04,103.88,87.16,19149.12,WellsFargo2,111,5
10,19149.12,191.04,103.41,87.63,19061.49,WellsFargo2,111,5
11,19061.49,191.04,102.93,88.11,18973.38,WellsFargo2,111,5
12,18973.38,191.04,102.46,88.58,18884.8,WellsFargo2,111,5
13,18884.8,191.04,101.98,89.06,18795.74,WellsFargo2,111,5
14,18795.74,191.04,101.5,89.54,18706.2,WellsFargo2,111,5
15,18706.2,191.04,101.01,90.03,18616.17,WellsFargo2,111,5
16,18616.17,191.04,100.53,90.51,18525.66,WellsFargo2,111,5
17,18525.66,2723.49,100.04,2623.45,15902.21,WellsFargo2,111,5
18,15902.21,3010.1,85.87,2924.23,12977.98,WellsFargo2,111,5
19,12977.98,3010.1,70.08,2940.02,10037.96,WellsFargo2,111,5
20,10037.96,3010.1,54.2,2955.9,7082.06,WellsFargo2,111,5
21,7082.06,3010.1,38.24,2971.86,4110.2,WellsFargo2,111,5
22,4110.2,3010.1,22.2,2987.9,1122.3,WellsFargo2,111,5
23,1122.3,3010.1,6.06,3004.04,-1881.74,WellsFargo2,111,5
0,180000.0,2331.44,594.0,1737.44,178262.56,mortgage,112,1
1,178262.56,2331.44,588.27,1743.17,176519.39,mortgage,112,1
2,176519.39,2331.44,582.51,1748.93,174770.46,mortgage,112,1
3,174770.46,2331.44,576.74,1754.7,173015.76,mortgage,112,1
4,173015.76,2331.44,570.95,1760.49,171255.27,mortgage,112,1
5,171255.27,2331.44,565.14,1766.3,169488.97,mortgage,112,1
6,169488.97,2331.44,559.31,1772.13,167716.84,mortgage,112,1
7,167716.84,2331.44,553.47,1777.97,165938.87,mortgage,112,1
8,165938.87,2331.44,547.6,1783.84,164155.03,mortgage,112,1
9,164155.03,2331.44,541.71,1789.73,162365.3,mortgage,112,1
10,162365.3,2331.44,535.81,1795.63,160569.67,mortgage,112,1
11,160569.67,2331.44,529.88,1801.56,158768.11,mortgage,112,1
12,158768.11,2331.44,523.93,1807.51,156960.6,mortgage,112,1
13,156960.6,2331.44,517.97,1813.47,155147.13,mortgage,112,1
14,155147.13,2331.44,511.99,1819.45,153327.68,mortgage,112,1
15,153327.68,2331.44,505.98,1825.46,151502.22,mortgage,112,1
16,151502.22,2331.44,499.96,1831.48,149670.74,mortgage,112,1
17,149670.74,2331.44,493.91,1837.53,147833.21,mortgage,112,1
18,147833.21,2331.44,487.85,1843.59,145989.62,mortgage,112,1
19,145989.62,2331.44,481.77,1849.67,144139.95,mortgage,112,1
20,144139.95,2331.44,475.66,1855.78,142284.17,mortgage,112,1
21,142284.17,2331.44,469.54,1861.9,140422.27,mortgage,112,1
22,140422.27,2331.44,463.39,1868.05,138554.22,mortgage,112,1
23,138554.22,2331.44,457.23,1874.21,136680.01,mortgage,112,1
24,136680.01,2331.44,451.04,1880.4,134799.61,mortgage,112,1
25,134799.61,2331.44,444.84,1886.6,132913.01,mortgage,112,1
26,132913.01,2331.44,438.61,1892.83,131020.18,mortgage,112,1
27,131020.18,2331.44,432.37,1899.07,129121.11,mortgage,112,1
28,129121.11,2331.44,426.1,1905.34,127215.77,mortgage,112,1
29,127215.77,2331.44,419.81,1911.63,125304.14,mortgage,112,1
30,125304.14,2331.44,413.5,1917.94,123386.2,mortgage,112,1
31,123386.2,2331.44,407.17,1924.27,121461.93,mortgage,112,1
32,121461.93,2331.44,400.82,1930.62,119531.31,mortgage,112,1
33,119531.31,2331.44,394.45,1936.99,117594.32,mortgage,112,1
34,117594.32,2331.44,388.06,1943.38,115650.94,mortgage,112,1
35,115650.94,2331.44,381.65,1949.79,113701.15,mortgage,112,1
36,113701.15,2331.44,375.21,1956.23,111744.92,mortgage,112,1
37,111744.92,2331.44,368.76,1962.68,109782.24,mortgage,112,1
38,109782.24,2331.44,362.28,1969.16,107813.08,mortgage,112,1
39,107813.08,2331.44,355.78,1975.66,105837.42,mortgage,112,1
40,105837.42,2331.44,349.26,1982.18,103855.24,mortgage,112,1
41,103855.24,2331.44,342.72,1988.72,101866.52,mortgage,112,1
42,101866.52,2331.44,336.16,1995.28,99871.24,mortgage,112,1
43,99871.24,2331.44,329.58,2001.86,97869.38,mortgage,112,1
44,97869.38,2331.44,322.97,2008.47,95860.91,mortgage,112,1
45,95860.91,2331.44,316.34,2015.1,93845.81,mortgage,112,1
46,93845.81,2331.44,309.69,2021.75,91824.06,mortgage,112,1
47,91824.06,2331.44,303.02,2028.42,89795.64,mortgage,112,1
48,89795.64,2331.44,296.33,2035.11,87760.53,mortgage,112,1
49,87760.53,2331.44,289.61,2041.83,85718.7,mortgage,112,1
50,85718.7,2331.44,282.87,2048.57,83670.13,mortgage,112,1
51,83670.13,2331.44,276.11,2055.33,81614.8,mortgage,112,1
52,81614.8,2331.44,269.33,2062.11,79552.69,mortgage,112,1
53,79552.69,2331.44,262.52,2068.92,77483.77,mortgage,112,1
54,77483.77,2331.44,255.7,2075.74,75408.03,mortgage,112,1
55,75408.03,2331.44,248.85,2082.59,73325.44,mortgage,112,1
56,73325.44,2331.44,241.97,2089.47,71235.97,mortgage,112,1
57,71235.97,2331.44,235.08,2096.36,69139.61,mortgage,112,1
58,69139.61,2331.44,228.16,2103.28,67036.33,mortgage,112,1
59,67036.33,2331.44,221.22,2110.22,64926.11,mortgage,112,1
60,64926.11,2331.44,214.26,2117.18,62808.93,mortgage,112,1
61,62808.93,2331.44,207.27,2124.17,60684.76,mortgage,112,1
62,60684.76,2331.44,200.26,2131.18,58553.58,mortgage,112,1
63,58553.58,2331.44,193.23,2138.21,56415.37,mortgage,112,1
64,56415.37,2331.44,186.17,2145.27,54270.1,mortgage,112,1
65,54270.1,2331.44,179.09,2152.35,52117.75,mortgage,112,1
66,52117.75,2331.44,171.99,2159.45,49958.3,mortgage,112,1
67,49958.3,2331.44,164.86,2166.58,47791.72,mortgage,112,1
68,47791.72,2331.44,157.71,2173.73,45617.99,mortgage,112,1
69,45617.99,2331.44,150.54,2180.9,43437.09,mortgage,112,1
70,43437.09,2331.44,143.34,2188.1,41248.99,mortgage,112,1
71,41248.99,2331.44,136.12,2195.32,39053.67,mortgage,112,1
72,39053.67,2331.44,128.88,2202.56,36851.11,mortgage,112,1
73,36851.11,2331.44,121.61,2209.83,34641.28,mortgage,112,1
74,34641.28,2331.44,114.32,2217.12,32424.16,mortgage,112,1
75,32424.16,2331.44,107.0,2224.44,30199.72,mortgage,112,1
76,30199.72,2331.44,99.66,2231.78,27967.94,mortgage,112,1
77,27967.94,2331.44,92.29,2239.15,25728.79,mortgage,112,1
78,25728.79,2331.44,84.91,2246.53,23482.26,mortgage,112,1
79,23482.26,2331.44,77.49,2253.95,21228.31,mortgage,112,1
80,21228.31,2331.44,70.05,2261.39,18966.92,mortgage,112,1
81,18966.92,2331.44,62.59,2268.85,16698.07,mortgage,112,1
82,16698.07,2331.44,55.1,2276.34,14421.73,mortgage,112,1
83,14421.73,2331.44,47.59,2283.85,12137.88,mortgage,112,1
84,12137.88,2331.44,40.06,2291.38,9846.5,mortgage,112,1
85,9846.5,2331.44,32.49,2298.95,7547.55,mortgage,112,1
86,7547.55,2331.44,24.91,2306.53,5241.02,mortgage,112,1
87,5241.02,2331.44,17.3,2314.14,2926.88,mortgage,112,1
88,2926.88,2331.44,9.66,2321.78,605.1,mortgage,112,1
89,605.1,2331.44,2.0,2329.44,-1724.34,mortgage,112,1
0,8250.57,84.62,53.63,30.99,8219.58,WellsFargo1,112,2
1,8219.58,84.62,53.43,31.19,8188.39,WellsFargo1,112,2
2,8188.39,84.62,53.22,31.4,8156.99,WellsFargo1,112,2
3,8156.99,84.62,53.02,31.6,8125.39,WellsFargo1,112,2
4,8125.39,84.62,52.82,31.8,8093.59,WellsFargo1,112,2
5,8093.59,84.62,52.61,32.01,8061.58,WellsFargo1,112,2
6,8061.58,84.62,52.4,32.22,8029.36,WellsFargo1,112,2
7,8029.36,84.62,52.19,32.43,7996.93,WellsFargo1,112,2
8,7996.93,84.62,51.98,32.64,7964.29,WellsFargo1,112,2
9,7964.29,84.62,51.77,32.85,7931.44,WellsFargo1,112,2
10,7931.44,84.62,51.55,33.07,7898.37,WellsFargo1,112,2
11,7898.37,84.62,51.34,33.28,7865.09,WellsFargo1,112,2
12,7865.09,84.62,51.12,33.5,7831.59,WellsFargo1,112,2
13,7831.59,84.62,50.91,33.71,7797.88,WellsFargo1,112,2
14,7797.88,84.62,50.69,33.93,7763.95,WellsFargo1,112,2
15,7763.95,84.62,50.47,34.15,7729.8,WellsFargo1,112,2
16,7729.8,84.62,50.24,34.38,7695.42,WellsFargo1,112,2
17,7695.42,84.62,50.02,34.6,7660.82,WellsFargo1,112,2
18,7660.82,84.62,49.8,34.82,7626.0,WellsFargo1,112,2
19,7626.0,84.62,49.57,35.05,7590.95,WellsFargo1,112,2
20,7590.95,84.62,49.34,35.28,7555.67,WellsFargo1,112,2
21,7555.67,84.62,49.11,35.51,7520.16,WellsFargo1,112,2
22,7520.16,84.62,48.88,35.74,7484.42,WellsFargo1,112,2
23,7484.42,84.62,48.65,35.97,7448.45,WellsFargo1,112,2
24,7448.45,84.62,48.41,36.21,7412.24,WellsFargo1,112,2
25,7412.24,84.62,48.18,36.44,7375.8,WellsFargo1,112,2
26,7375.8,84.62,47.94,36.68,7339.12,WellsFargo1,112,2
27,7339.12,84.62,47.7,36.92,7302.2,WellsFargo1,112,2
28,7302.2,84.62,47.46,37.16,7265.04,WellsFargo1,112,2
29,7265.04,84.62,47.22,37.4,7227.64,WellsFargo1,112,2
30,7227.64,84.62,46.98,37.64,7190.0,WellsFargo1,112,2
31,7190.0,84.62,46.73,37.89,7152.11,WellsFargo1,112,2
32,7152.11,84.62,46.49,38.13,7113.98,WellsFargo1,112,2
33,7113.98,84.62,46.24,38.38,7075.6,WellsFargo1,112,2
34,7075.6,84.62,45.99,38.63,7036.97,WellsFargo1,112,2
35,7036.97,84.62,45.74,38.88,6998.09,WellsFargo1,112,2
36,6998.09,84.62,45.49,39.13,6958.96,WellsFargo1,112,2
37,6958.96,84.62,45.23,39.39,6919.57,WellsFargo1,112,2
38,6919.57,84.62,44.98,39.64,6879.93,WellsFargo1,112,2
39,6879.93,84.62,44.72,39.9,6840.03,WellsFargo1,112,2
40,6840.03,84.62,44.46,40.16,6799.87,WellsFargo1,112,2
41,6799.87,84.62,44.2,40.42,6759.45,WellsFargo1,112,2
42,6759.45,84.62,43.94,40.68,6718.77,WellsFargo1,112,2
43,6718.77,84.62,43.67,40.95,6677.82,WellsFargo1,112,2
44,6677.82,84.62,43.41,41.21,6636.61,WellsFargo1,112,2
45,6636.61,84.62,43.14,41.48,6595.13,WellsFargo1,112,2
46,6595.13,84.62,42.87,41.75,6553.38,WellsFargo1,112,2
47,6553.38,84.62,42.6,42.02,6511.36,WellsFargo1,112,2
48,6511.36,84.62,42.32,42.3,6469.06,WellsFargo1,112,2
49,6469.06,84.62,42.05,42.57,6426.49,WellsFargo1,112,2
50,6426.49,84.62,41.77,42.85,6383.64,WellsFargo1,112,2
51,6383.64,84.62,41.49,43.13,6340.51,WellsFargo1,112,2
52,6340.51,84.62,41.21,43.41,6297.1,WellsFargo1,112,2
53,6297.1,84.62,40.93,43.69,6253.41,WellsFargo1,112,2
54,6253.41,84.62,40.65,43.97,6209.44,WellsFargo1,112,2
55,6209.44,84.62,40.36,44.26,6165.18,WellsFargo1,112,2
56,6165.18,84.62,40.07,44.55,6120.63,WellsFargo1,112,2
57,6120.63,84.62,39.78,44.84,6075.79,WellsFargo1,112,2
58,6075.79,84.62,39.49,45.13,6030.66,WellsFargo1,112,2
59,6030.66,84.62,39.2,45.42,5985.24,WellsFargo1,112,2
60,5985.24,84.62,38.9,45.72,5939.52,WellsFargo1,112,2
61,5939.52,84.62,38.61,46.01,5893.51,WellsFargo1,112,2
62,5893.51,84.62,38.31,46.31,5847.2,WellsFargo1,112,2
63,5847.2,84.62,38.01,46.61,5800.59,WellsFargo1,112,2
64,5800.59,84.62,37.7,46.92,5753.67,WellsFargo1,112,2
65,5753.67,84.62,37.4,47.22,5706.45,WellsFargo1,112,2
66,5706.45,84.62,37.09,47.53,5658.92,WellsFargo1,112,2
67,5658.92,84.62,36.78,47.84,5611.08,WellsFargo1,112,2
68,5611.08,84.62,36.47,48.15,5562.93,WellsFargo1,112,2
69,5562.93,84.62,36.16,48.46,5514.47,WellsFargo1,112,2
70,5514.47,84.62,35.84,48.78,5465.69,WellsFargo1,112,2
71,5465.69,84.62,35.53,49.09,5416.6,WellsFargo1,112,2
72,5416.6,84.62,35.21,49.41,5367.19,WellsFargo1,112,2
73,5367.19,84.62,34.89,49.73,5317.46,WellsFargo1,112,2
74,5317.46,84.62,34.56,50.06,5267.4,WellsFargo1,112,2
75,5267.4,84.62,34.24,50.38,5217.02,WellsFargo1,112,2
76,5217.02,84.62,33.91,50.71,5166.31,WellsFargo1,112,2
77,5166.31,84.62,33.58,51.04,5115.27,WellsFargo1,112,2
78,5115.27,84.62,33.25,51.37,5063.9,WellsFargo1,112,2
79,5063.9,84.62,32.92,51.7,5012.2,WellsFargo1,112,2
80,5012.2,84.62,32.58,52.04,4960.16,WellsFargo1,112,2
81,4960.16,84.62,32.24,52.38,4907.78,WellsFargo1,112,2
82,4907.78,84.62,31.9,52.72,4855.06,WellsFargo1,112,2
83,4855.06,84.62,31.56,53.06,4802.0,WellsFargo1,112,2
84,4802.0,84.62,31.21,53.41,4748.59,WellsFargo1,112,2
85,4748.59,84.62,30.87,53.75,4694.84,WellsFargo1,112,2
86,4694.84,84.62,30.52,54.1,4640.74,WellsFargo1,112,2
87,4640.74,84.62,30.16,54.46,4586.28,WellsFargo1,112,2
88,4586.28,84.62,29.81,54.81,4531.47,WellsFargo1,112,2
89,4531.47,1808.96,29.45,1779.51,2751.96,WellsFargo1,112,2
90,2751.96,2416.06,17.89,2398.17,353.79,WellsFargo1,112,2
91,353.79,2416.06,2.3,2413.76,-2059.97,WellsFargo1,112,2
0,5000.0,333.0,36.0,297.0,4703.0,Car,112,3
1,4703.0,333.0,33.86,299.14,4403.86,Car,112,3
2,4403.86,333.0,31.71,301.29,4102.57,Car,112,3
3,4102.57,333.0,29.54,303.46,3799.11,Car,112,3
4,3799.11,333.0,27.35,305.65,3493.46,Car,112,3
5,3493.46,333.0,25.15,307.85,3185.61,Car,112,3
6,3185.61,333.0,22.94,310.06,2875.55,Car,112,3
7,2875.55,333.0,20.7,312.3,2563.25,Car,112,3
8,2563.25,333.0,18.46,314.54,2248.71,Car,112,3
9,2248.71,333.0,16.19,316.81,1931.9,Car,112,3
10,1931.9,333.0,13.91,319.09,1612.81,Car,112,3
11,1612.81,333.0,11.61,321.39,1291.42,Car,112,3
12,1291.42,333.0,9.3,323.7,967.72,Car,112,3
13,967.72,333.0,6.97,326.03,641.69,Car,112,3
14,641.69,333.0,4.62,328.38,313.31,Car,112,3
15,313.31,333.0,2.26,330.74,-17.43,Car,112,3
0,20000.0,191.04,108.0,83.04,19916.96,WellsFargo2,112,4
1,19916.96,191.04,107.55,83.49,19833.47,WellsFargo2,112,4
2,19833.47,191.04,107.1,83.94,19749.53,WellsFargo2,112,4
3,19749.53,191.04,106.65,84.39,19665.14,WellsFargo2,112,4
4,19665.14,191.04,106.19,84.85,19580.29,WellsFargo2,112,4
5,19580.29,191.04,105.73,85.31,19494.98,WellsFargo2,112,4
6,19494.98,191.04,105.27,85.77,19409.21,WellsFargo2,112,4
7,19409.21,191.04,104.81,86.23,19322.98,WellsFargo2,112,4
8,19322.98,191.04,104.34,86.7,19236.28,WellsFargo2,112,4
9,19236.28,191.04,103.88,87.16,19149.12,WellsFargo2,112,4
10,19149.12,191.04,103.41,87.63,19061.49,WellsFargo2,112,4
11,19061.49,191.04,102.93,88.11,18973.38,WellsFargo2,112,4
12,18973.38,191.04,102.46,88.58,18884.8,WellsFargo2,112,4
13,18884.8,191.04,101.98,89.06,18795.74,WellsFargo2,112,4
14,18795.74,191.04,101.5,89.54,18706.2,WellsFargo2,112,4
15,18706.2,208.47,101.01,107.46,18598.74,WellsFargo2,112,4
16,18598.74,2940.1,100.43,2839.67,15759.07,WellsFargo2,112,4
17,15759.07,2940.1,85.1,2855.0,12904.07,WellsFargo2,112,4
18,12904.07,2940.1,69.68,2870.42,10033.65,WellsFargo2,112,4
19,10033.65,2940.1,54.18,2885.92,7147.73,WellsFargo2,112,4
20,7147.73,2940.1,38.6,2901.5,4246.23,WellsFargo2,112,4
21,4246.23,2940.1,22.93,2917.17,1329.06,WellsFargo2,112,4
22,1329.06,2940.1,7.18,2932.92,-1603.86,WellsFargo2,112,4
0,4000.0,70.0,16.0,54.0,3946.0,testing,112,5
1,3946.0,70.0,15.78,54.22,3891.78,testing,112,5
2,3891.78,70.0,15.57,54.43,3837.35,testing,112,5
3,3837.35,70.0,15.35,54.65,3782.7,testing,112,5
4,3782.7,70.0,15.13,54.87,3727.83,testing,112,5
5,3727.83,70.0,14.91,55.09,3672.74,testing,112,5
6,3672.74,70.0,14.69,55.31,3617.43,testing,112,5
7,3617.43,70.0,14.47,55.53,3561.9,testing,112,5
8,3561.9,70.0,14.25,55.75,3506.15,testing,112,5
9,3506.15,70.0,14.02,55.98,3450.17,testing,112,5
10,3450.17,70.0,13.8,56.2,3393.97,testing,112,5
11,3393.97,70.0,13.58,56.42,3337.55,testing,112,5
12,3337.55,70.0,13.35,56.65,3280.9,testing,112,5
13,3280.9,70.0,13.12,56.88,3224.02,testing,112,5
14,3224.02,70.0,12.9,57.1,3166.92,testing,112,5
15,3166.92,70.0,12.67,57.33,3109.59,testing,112,5
16,3109.59,70.0,12.44,57.56,3052.03,testing,112,5
17,3052.03,70.0,12.21,57.79,2994.24,testing,112,5
18,2994.24,70.0,11.98,58.02,2936.22,testing,112,5
19,2936.22,70.0,11.74,58.26,2877.96,testing,112,5
20,2877.96,70.0,11.51,58.49,2819.47,testing,112,5
21,2819.47,70.0,11.28,58.72,2760.75,testing,112,5
22,2760.75,1673.86,11.04,1662.82,1097.93,testing,112,5
23,1097.93,3010.1,4.39,3005.71,-1907.78,testing,112,5
0,180000.0,2331.44,594.0,1737.44,178262.56,mortgage,113,1
1,178262.56,2331.44,588.27,1743.17,176519.39,mortgage,113,1
2,176519.39,2331.44,582.51,1748.93,174770.46,mortgage,113,1
3,174770.46,2331.44,576.74,1754.7,173015.76,mortgage,113,1
4,173015.76,2331.44,570.95,1760.49,171255.27,mortgage,113,1
5,171255.27,2331.44,565.14,1766.3,169488.97,mortgage,113,1
6,169488.97,2331.44,559.31,1772.13,167716.84,mortgage,113,1
7,167716.84,2331.44,553.47,1777.97,165938.87,mortgage,113,1
8,165938.87,2331.44,547.6,1783.84,164155.03,mortgage,113,1
9,164155.03,2331.44,541.71,1789.73,162365.3,mortgage,113,1
10,162365.3,2331.44,535.81,1795.63,160569.67,mortgage,113,1
11,160569.67,2331.44,529.88,1801.56,158768.11,mortgage,113,1
12,158768.11,2331.44,523.93,1807.51,156960.6,mortgage,113,1
13,156960.6,2331.44,517.97,1813.47,155147.13,mortgage,113,1
14,155147.13,2331.44,511.99,1819.45,153327.68,mortgage,113,1
15,153327.68,2331.44,505.98,1825.46,151502.22,mortgage,113,1
16,151502.22,2331.44,499.96,1831.48,149670.74,mortgage,113,1
17,149670.74,2331.44,493.91,1837.53,147833.21,mortgage,113,1
18,147833.21,2331.44,487.85,1843.59,145989.62,mortgage,113,1
19,145989.62,2331.44,481.77,1849.67,144139.95,mortgage,113,1
20,144139.95,2331.44,475.66,1855.78,142284.17,mortgage,113,1
21,142284.17,2331.44,469.54,1861.9,140422.27,mortgage,113,1
22,140422.27,2331.44,463.39,1868.05,138554.22,mortgage,113,1
23,138554.22,2331.44,457.23,1874.21,136680.01,mortgage,113,1
24,136680.01,2331.44,451.04,1880.4,134799.61,mortgage,113,1
25,134799.61,2331.44,444.84,1886.6,132913.01,mortgage,113,1
26,132913.01,2331.44,438.61,1892.83,131020.18,mortgage,113,1
27,131020.18,2331.44,432.37,1899.07,129121.11,mortgage,113,1
28,129121.11,2331.44,426.1,1905.34,127215.77,mortgage,113,1
29,127215.77,2331.44,419.81,1911.63,125304.14,mortgage,113,1
30,125304.14,2331.44,413.5,1917.94,123386.2,mortgage,113,1
31,123386.2,2331.44,407.17,1924.27,121461.93,mortgage,113,1
32,121461.93,2331.44,400.82,1930.62,119531.31,mortgage,113,1
33,119531.31,2331.44,394.45,1936.99,117594.32,mortgage,113,1
34,117594.32,2331.44,388.06,1943.38,115650.94,mortgage,113,1
35,115650.94,2331.44,381.65,1949.79,113701.15,mortgage,113,1
36,113701.15,2331.44,375.21,1956.23,111744.92,mortgage,113,1
37,111744.92,2331.44,368.76,1962.68,109782.24,mortgage,113,1
38,109782.24,2331.44,362.28,1969.16,107813.08,mortgage,113,1
39,107813.08,2331.44,355.78,1975.66,105837.42,mortgage,113,1
40,105837.42,2331.44,349.26,1982.18,103855.24,mortgage,113,1
41,103855.24,2331.44,342.72,1988.72,101866.52,mortgage,113,1
42,101866.52,2331.44,336.16,1995.28,99871.24,mortgage,113,1
43,99871.24,2331.44,329.58,2001.86,97869.38,mortgage,113,1
44,97869.38,2331.44,322.97,2008.47,95860.91,mortgage,113,1
45,95860.91,2331.44,316.34,2015.1,93845.81,mortgage,113,1
46,93845.81,2331.44,309.69,2021.75,91824.06,mortgage,113,1
47,91824.06,2331.44,303.02,2028.42,89795.64,mortgage,113,1
48,89795.64,2331.44,296.33,2035.11,87760.53,mortgage,113,1
49,87760.53,2331.44,289.61,2041.83,85718.7,mortgage,113,1
50,85718.7,2331.44,282.87,2048.57,83670.13,mortgage,113,1
51,83670.13,2331.44,276.11,2055.33,81614.8,mortgage,113,1
52,81614.8,2331.44,269.33,2062.11,79552.69,mortgage,113,1
53,79552.69,2331.44,262.52,2068.92,77483.77,mortgage,113,1
54,77483.77,2331.44,255.7,2075.74,75408.03,mortgage,113,1
55,75408.03,2331.44,248.85,2082.59,73325.44,mortgage,113,1
56,73325.44,2331.44,241.97,2089.47,71235.97,mortgage,113,1
57,71235.97,2331.44,235.08,2096.36,69139.61,mortgage,113,1
58,69139.61,2331.44,228.16,2103.28,67036.33,mortgage,113,1
59,67036.33,2331.44,221.22,2110.22,64926.11,mortgage,113,1
60,64926.11,2331.44,214.26,2117.18,62808.93,mortgage,113,1
61,62808.93,2331.44,207.27,2124.17,60684.76,mortgage,113,1
62,60684.76,2331.44,200.26,2131.18,58553.58,mortgage,113,1
63,58553.58,2331.44,193.23,2138.21,56415.37,mortgage,113,1
64,56415.37,2331.44,186.17,2145.27,54270.1,mortgage,113,1
65,54270.1,2331.44,179.09,2152.35,52117.75,mortgage,113,1
66,52117.75,2331.44,171.99,2159.45,49958.3,mortgage,113,1
67,49958.3,2331.44,164.86,2166.58,47791.72,mortgage,113,1
68,47791.72,2331.44,157.71,2173.73,45617.99,mortgage,113,1
69,45617.99,2331.44,150.54,2180.9,43437.09,mortgage,113,1
70,43437.09,2331.44,143.34,2188.1,41248.99,mortgage,113,1
71,41248.99,2331.44,136.12,2195.32,39053.67,mortgage,113,1
72,39053.67,2331.44,128.88,2202.56,36851.11,mortgage,113,1
73,36851.11,2331.44,121.61,2209.83,34641.28,mortgage,113,1
74,34641.28,2331.44,114.32,2217.12,32424.16,mortgage,113,1
75,32424.16,2331.44,107.0,2224.44,30199.72,mortgage,113,1
76,30199.72,2331.44,99.66,2231.78,27967.94,mortgage,113,1
77,27967.94,2331.44,92.29,2239.15,25728.79,mortgage,113,1
78,25728.79,2331.44,84.91,2246.53,23482.26,mortgage,113,1
79,23482.26,2331.44,77.49,2253.95,21228.31,mortgage,113,1
80,21228.31,2331.44,70.05,2261.39,18966.92,mortgage,113,1
81,18966.92,2331.44,62.59,2268.85,16698.07,mortgage,113,1
82,16698.07,2331.44,55.1,2276.34,14421.73,mortgage,113,1
83,14421.73,2331.44,47.59,2283.85,12137.88,mortgage,113,1
84,12137.88,2331.44,40.06,2291.38,9846.5,mortgage,113,1
85,9846.5,2331.44,32.49,2298.95,7547.55,mortgage,113,1
86,7547.55,2331.44,24.91,2306.53,5241.02,mortgage,113,1
87,5241.02,2331.44,17.3,2314.14,2926.88,mortgage,113,1
88,2926.88,2331.44,9.66,2321.78,605.1,mortgage,113,1
89,605.1,2331.44,2.0,2329.44,-1724.34,mortgage,113,1
0,8250.57,84.62,53.63,30.99,8219.58,WellsFargo1,113,2
1,8219.58,84.62,53.43,31.19,8188.39,WellsFargo1,113,2
2,8188.39,84.62,53.22,31.4,8156.99,WellsFargo1,113,2
3,8156.99,84.62,53.02,31.6,8125.39,WellsFargo1,113,2
4,8125.39,84.62,52.82,31.8,8093.59,WellsFargo1,113,2
5,8093.59,84.62,52.61,32.01,8061.58,WellsFargo1,113,2
6,8061.58,84.62,52.4,32.22,8029.36,WellsFargo1,113,2
7,8029.36,84.62,52.19,32.43,7996.93,WellsFargo1,113,2
8,7996.93,84.62,51.98,32.64,7964.29,WellsFargo1,113,2
9,7964.29,84.62,51.77,32.85,7931.44,WellsFargo1,113,2
10,7931.44,84.62,51.55,33.07,7898.37,WellsFargo1,113,2
11,7898.37,84.62,51.34,33.28,7865.09,WellsFargo1,113,2
12,7865.09,84.62,51.12,33.5,7831.59,WellsFargo1,113,2
13,7831.59,84.62,50.91,33.71,7797.88,WellsFargo1,113,2
14,7797.88,84.62,50.69,33.93,7763.95,WellsFargo1,113,2
15,7763.95,84.62,50.47,34.15,7729.8,WellsFargo1,113,2
16,7729.8,84.62,50.24,34.38,7695.42,WellsFargo1,113,2
17,7695.42,84.62,50.02,34.6,7660.82,WellsFargo1,113,2
18,7660.82,84.62,49.8,34.82,7626.0,WellsFargo1,113,2
19,7626.0,84.62,49.57,35.05,7590.95,WellsFargo1,113,2
20,7590.95,84.62,49.34,35.28,7555.67,WellsFargo1,113,2
21,7555.67,84.62,49.11,35.51,7520.16,WellsFargo1,113,2
22,7520.16,84.62,48.88,35.74,7484.42,WellsFargo1,113,2
23,7484.42,84.62,48.65,35.97,7448.45,WellsFargo1,113,2
24,7448.45,84.62,48.41,36.21,7412.24,WellsFargo1,113,2
25,7412.24,84.62,48.18,36.44,7375.8,WellsFargo1,113,2
26,7375.8,84.62,47.94,36.68,7339.12,WellsFargo1,113,2
27,7339.12,84.62,47.7,36.92,7302.2,WellsFargo1,113,2
28,7302.2,84.62,47.46,37.16,7265.04,WellsFargo1,113,2
29,7265.04,84.62,47.22,37.4,7227.64,WellsFargo1,113,2
30,7227.64,84.62,46.98,37.64,7190.0,WellsFargo1,113,2
31,7190.0,84.62,46.73,37.89,7152.11,WellsFargo1,113,2
32,7152.11,84.62,46.49,38.13,7113.98,WellsFargo1,113,2
33,7113.98,84.62,46.24,38.38,7075.6,WellsFargo1,113,2
34,7075.6,84.62,45.99,38.63,7036.97,WellsFargo1,113,2
35,7036.97,84.62,45.74,38.88,6998.09,WellsFargo1,113,2
36,6998.09,84.62,45.49,39.13,6958.96,WellsFargo1,113,2
37,6958.96,84.62,45.23,39.39,6919.57,WellsFargo1,113,2
38,6919.57,84.62,44.98,39.64,6879.93,WellsFargo1,113,2
39,6879.93,84.62,44.72,39.9,6840.03,WellsFargo1,113,2
40,6840.03,84.62,44.46,40.16,6799.87,WellsFargo1,113,2
41,6799.87,84.62,44.2,40.42,6759.45,WellsFargo1,113,2
42,6759.45,84.62,43.94,40.68,6718.77,WellsFargo1,113,2
43,6718.77,84.62,43.67,40.95,6677.82,WellsFargo1,113,2
44,6677.82,84.62,43.41,41.21,6636.61,WellsFargo1,113,2
45,6636.61,84.62,43.14,41.48,6595.13,WellsFargo1,113,2
46,6595.13,84.62,42.87,41.75,6553.38,WellsFargo1,113,2
47,6553.38,84.62,42.6,42.02,6511.36,WellsFargo1,113,2
48,6511.36,84.62,42.32,42.3,6469.06,WellsFargo1,113,2
49,6469.06,84.62,42.05,42.57,6426.49,WellsFargo1,113,2
50,6426.49,84.62,41.77,42.85,6383.64,WellsFargo1,113,2
51,6383.64,84.62,41.49,43.13,6340.51,WellsFargo1,113,2
52,6340.51,84.62,41.21,43.41,6297.1,WellsFargo1,113,2
53,6297.1,84.62,40.93,43.69,6253.41,WellsFargo1,113,2
54,6253.41,84.62,40.65,43.97,6209.44,WellsFargo1,113,2
55,6209.44,84.62,40.36,44.26,6165.18,WellsFargo1,113,2
56,6165.18,84.62,40.07,44.55,6120.63,WellsFargo1,113,2
57,6120.63,84.62,39.78,44.84,6075.79,WellsFargo1,113,2
58,6075.79,84.62,39.49,45.13,6030.66,WellsFargo1,113,2
59,6030.66,84.62,39.2,45.42,5985.24,WellsFargo1,113,2
60,5985.24,84.62,38.9,45.72,5939.52,WellsFargo1,113,2
61,5939.52,84.62,38.61,46.01,5893.51,WellsFargo1,113,2
62,5893.51,84.62,38.31,46.31,5847.2,WellsFargo1,113,2
63,5847.2,84.62,38.01,46.61,5800.59,WellsFargo1,113,2
64,5800.59,84.62,37.7,46.92,5753.67,WellsFargo1,113,2
65,5753.67,84.62,37.4,47.22,5706.45,WellsFargo1,113,2
66,5706.45,84.62,37.09,47.53,5658.92,WellsFargo1,113,2
67,5658.92,84.62,36.78,47.84,5611.08,WellsFargo1,113,2
68,5611.08,84.62,36.47,48.15,5562.93,WellsFargo1,113,2
69,5562.93,84.62,36.16,48.46,5514.47,WellsFargo1,113,2
70,5514.47,84.62,35.84,48.78,5465.69,WellsFargo1,113,2
71,5465.69,84.62,35.53,49.09,5416.6,WellsFargo1,113,2
72,5416.6,84.62,35.21,49.41,5367.19,WellsFargo1,113,2
73,5367.19,84.62,34.89,49.73,5317.46,WellsFargo1,113,2
74,5317.46,84.62,34.56,50.06,5267.4,WellsFargo1,113,2
75,5267.4,84.62,34.24,50.38,5217.02,WellsFargo1,113,2
76,5217.02,84.62,33.91,50.71,5166.31,WellsFargo1,113,2
77,5166.31,84.62,33.58,51.04,5115.27,WellsFargo1,113,2
78,5115.27,84.62,33.25,51.37,5063.9,WellsFargo1,113,2
79,5063.9,84.62,32.92,51.7,5012.2,WellsFargo1,113,2
80,5012.2,84.62,32.58,52.04,4960.16,WellsFargo1,113,2
81,4960.16,84.62,32.24,52.38,4907.78,WellsFargo1,113,2
82,4907.78,84.62,31.9,52.72,4855.06,WellsFargo1,113,2
83,4855.06,84.62,31.56,53.06,4802.0,WellsFargo1,113,2
84,4802.0,84.62,31.21,53.41,4748.59,WellsFargo1,113,2
85,4748.59,84.62,30.87,53.75,4694.84,WellsFargo1,113,2
86,4694.84,84.62,30.52,54.1,4640.74,WellsFargo1,113,2
87,4640.74,84.62,30.16,54.46,4586.28,WellsFargo1,113,2
88,4586.28,84.62,29.81,54.81,4531.47,WellsFargo1,113,2
89,4531.47,1808.96,29.45,1779.51,2751.96,WellsFargo1,113,2
90,2751.96,2416.06,17.89,2398.17,353.79,WellsFargo1,113,2
91,353.79,2416.06,2.3,2413.76,-2059.97,WellsFargo1,113,2
0,20000.0,191.04,108.0,83.04,19916.96,WellsFargo2,113,3
1,19916.96,191.04,107.55,83.49,19833.47,WellsFargo2,113,3
2,19833.47,191.04,107.1,83.94,19749.53,WellsFargo2,113,3
3,19749.53,191.04,106.65,84.39,19665.14,WellsFargo2,113,3
4,19665.14,191.04,106.19,84.85,19580.29,WellsFargo2,113,3
5,19580.29,191.04,105.73,85.31,19494.98,WellsFargo2,113,3
6,19494.98,191.04,105.27,85.77,19409.21,WellsFargo2,113,3
7,19409.21,191.04,104.81,86.23,19322.98,WellsFargo2,113,3
8,19322.98,191.04,104.34,86.7,19236.28,WellsFargo2,113,3
9,19236.28,191.04,103.88,87.16,19149.12,WellsFargo2,113,3
10,19149.12,191.04,103.41,87.63,19061.49,WellsFargo2,113,3
11,19061.49,191.04,102.93,88.11,18973.38,WellsFargo2,113,3
12,18973.38,191.04,102.46,88.58,18884.8,WellsFargo2,113,3
13,18884.8,191.04,101.98,89.06,18795.74,WellsFargo2,113,3
14,18795.74,191.04,101.5,89.54,18706.2,WellsFargo2,113,3
15,18706.2,191.04,101.01,90.03,18616.17,WellsFargo2,113,3
16,18616.17,191.04,100.53,90.51,18525.66,WellsFargo2,113,3
17,18525.66,191.04,100.04,91.0,18434.66,WellsFargo2,113,3
18,18434.66,191.04,99.55,91.49,18343.17,WellsFargo2,113,3
19,18343.17,191.04,99.05,91.99,18251.18,WellsFargo2,113,3
20,18251.18,191.04,98.56,92.48,18158.7,WellsFargo2,113,3
21,18158.7,191.04,98.06,92.98,18065.72,WellsFargo2,113,3
22,18065.72,191.04,97.55,93.49,17972.23,WellsFargo2,113,3
23,17972.23,191.04,97.05,93.99,17878.24,WellsFargo2,113,3
24,17878.24,191.04,96.54,94.5,17783.74,WellsFargo2,113,3
25,17783.74,191.04,96.03,95.01,17688.73,WellsFargo2,113,3
26,17688.73,191.04,95.52,95.52,17593.21,WellsFargo2,113,3
27,17593.21,191.04,95.0,96.04,17497.17,WellsFargo2,113,3
28,17497.17,191.04,94.48,96.56,17400.61,WellsFargo2,113,3
29,17400.61,191.04,93.96,97.08,17303.53,WellsFargo2,113,3
30,17303.53,191.04,93.44,97.6,17205.93,WellsFargo2,113,3
31,17205.93,191.04,92.91,98.13,17107.8,WellsFargo2,113,3
32,17107.8,191.04,92.38,98.66,17009.14,WellsFargo2,113,3
33,17009.14,191.04,91.85,99.19,16909.95,WellsFargo2,113,3
34,16909.95,191.04,91.31,99.73,16810.22,WellsFargo2,113,3
35,16810.22,191.04,90.78,100.26,16709.96,WellsFargo2,113,3
36,16709.96,191.04,90.23,100.81,16609.15,WellsFargo2,113,3
37,16609.15,191.04,89.69,101.35,16507.8,WellsFargo2,113,3
38,16507.8,191.04,89.14,101.9,16405.9,WellsFargo2,113,3
39,16405.9,191.04,88.59,102.45,16303.45,WellsFargo2,113,3
40,16303.45,191.04,88.04,103.0,16200.45,WellsFargo2,113,3
41,16200.45,191.04,87.48,103.56,16096.89,WellsFargo2,113,3
42,16096.89,191.04,86.92,104.12,15992.77,WellsFargo2,113,3
43,15992.77,191.04,86.36,104.68,15888.09,WellsFargo2,113,3
44,15888.09,191.04,85.8,105.24,15782.85,WellsFargo2,113,3
45,15782.85,191.04,85.23,105.81,15677.04,WellsFargo2,113,3
46,15677.04,191.04,84.66,106.38,15570.66,WellsFargo2,113,3
47,15570.66,191.04,84.08,106.96,15463.7,WellsFargo2,113,3
48,15463.7,191.04,83.5,107.54,15356.16,WellsFargo2,113,3
49,15356.16,191.04,82.92,108.12,15248.04,WellsFargo2,113,3
50,15248.04,191.04,82.34,108.7,15139.34,WellsFargo2,113,3
51,15139.34,191.04,81.75,109.29,15030.05,WellsFargo2,113,3
52,15030.05,191.04,81.16,109.88,14920.17,WellsFargo2,113,3
53,14920.17,191.04,80.57,110.47,14809.7,WellsFargo2,113,3
54,14809.7,191.04,79.97,111.07,14698.63,WellsFargo2,113,3
55,14698.63,191.04,79.37,111.67,14586.96,WellsFargo2,113,3
56,14586.96,191.04,78.77,112.27,14474.69,WellsFargo2,113,3
57,14474.69,191.04,78.16,112.88,14361.81,WellsFargo2,113,3
58,14361.81,191.04,77.55,113.49,14248.32,WellsFargo2,113,3
59,14248.32,191.04,76.94,114.1,14134.22,WellsFargo2,113,3
60,14134.22,191.04,76.32,114.72,14019.5,WellsFargo2,113,3
61,14019.5,191.04,75.71,115.33,13904.17,WellsFargo2,113,3
62,13904.17,191.04,75.08,115.96,13788.21,WellsFargo2,113,3
63,13788.21,191.04,74.46,116.58,13671.63,WellsFargo2,113,3
64,13671.63,191.04,73.83,117.21,13554.42,WellsFargo2,113,3
65,13554.42,191.04,73.19,117.85,13436.57,WellsFargo2,113,3
66,13436.57,191.04,72.56,118.48,13318.09,WellsFargo2,113,3
67,13318.09,191.04,71.92,119.12,13198.97,WellsFargo2,113,3
68,13198.97,191.04,71.27,119.77,13079.2,WellsFargo2,113,3
69,13079.2,191.04,70.63,120.41,12958.79,WellsFargo2,113,3
70,12958.79,191.04,69.98,121.06,12837.73,WellsFargo2,113,3
71,12837.73,191.04,69.32,121.72,12716.01,WellsFargo2,113,3
72,12716.01,191.04,68.67,122.37,12593.64,WellsFargo2,113,3
73,12593.64,191.04,68.01,123.03,12470.61,WellsFargo2,113,3
74,12470.61,191.04,67.34,123.7,12346.91,WellsFargo2,113,3
75,12346.91,191.04,66.67,124.37,12222.54,WellsFargo2,113,3
76,12222.54,191.04,66.0,125.04,12097.5,WellsFargo2,113,3
77,12097.5,191.04,65.33,125.71,11971.79,WellsFargo2,113,3
78,11971.79,191.04,64.65,126.39,11845.4,WellsFargo2,113,3
79,11845.4,191.04,63.97,127.07,11718.33,WellsFargo2,113,3
80,11718.33,191.04,63.28,127.76,11590.57,WellsFargo2,113,3
81,11590.57,191.04,62.59,128.45,11462.12,WellsFargo2,113,3
82,11462.12,191.04,61.9,129.14,11332.98,WellsFargo2,113,3
83,11332.98,191.04,61.2,129.84,11203.14,WellsFargo2,113,3
84,11203.14,191.04,60.5,130.54,11072.6,WellsFargo2,113,3
85,11072.6,191.04,59.79,131.25,10941.35,WellsFargo2,113,3
86,10941.35,191.04,59.08,131.96,10809.39,WellsFargo2,113,3
87,10809.39,191.04,58.37,132.67,10676.72,WellsFargo2,113,3
88,10676.72,191.04,57.65,133.39,10543.33,WellsFargo2,113,3
89,10543.33,191.04,56.93,134.11,10409.22,WellsFargo2,113,3
90,10409.22,191.04,56.21,134.83,10274.39,WellsFargo2,113,3
91,10274.39,2251.01,55.48,2195.53,8078.86,WellsFargo2,113,3
92,8078.86,2607.1,43.63,2563.47,5515.39,WellsFargo2,113,3
93,5515.39,2607.1,29.78,2577.32,2938.07,WellsFargo2,113,3
94,2938.07,2607.1,15.87,2591.23,346.84,WellsFargo2,113,3
95,346.84,2607.1,1.87,2605.23,-2258.39,WellsFargo2,113,3
0,4000.0,70.0,16.0,54.0,3946.0,testing,113,4
1,3946.0,70.0,15.78,54.22,3891.78,testing,113,4
2,3891.78,70.0,15.57,54.43,3837.35,testing,113,4
3,3837.35,70.0,15.35,54.65,3782.7,testing,113,4
4,3782.7,70.0,15.13,54.87,3727.83,testing,113,4
5,3727.83,70.0,14.91,55.09,3672.74,testing,113,4
6,3672.74,70.0,14.69,55.31,3617.43,testing,113,4
7,3617.43,70.0,14.47,55.53,3561.9,testing,113,4
8,3561.9,70.0,14.25,55.75,3506.15,testing,113,4
9,3506.15,70.0,14.02,55.98,3450.17,testing,113,4
10,3450.17,70.0,13.8,56.2,3393.97,testing,113,4
11,3393.97,70.0,13.58,56.42,3337.55,testing,113,4
12,3337.55,70.0,13.35,56.65,3280.9,testing,113,4
13,3280.9,70.0,13.12,56.88,3224.02,testing,113,4
14,3224.02,70.0,12.9,57.1,3166.92,testing,113,4
15,3166.92,70.0,12.67,57.33,3109.59,testing,113,4
16,3109.59,70.0,12.44,57.56,3052.03,testing,113,4
17,3052.03,70.0,12.21,57.79,2994.24,testing,113,4
18,2994.24,70.0,11.98,58.02,2936.22,testing,113,4
19,2936.22,70.0,11.74,58.26,2877.96,testing,113,4
20,2877.96,70.0,11.51,58.49,2819.47,testing,113,4
21,2819.47,70.0,11.28,58.72,2760.75,testing,113,4
22,2760.75,70.0,11.04,58.96,2701.79,testing,113,4
23,2701.79,70.0,10.81,59.19,2642.6,testing,113,4
24,2642.6,70.0,10.57,59.43,2583.17,testing,113,4
25,2583.17,70.0,10.33,59.67,2523.5,testing,113,4
26,2523.5,70.0,10.09,59.91,2463.59,testing,113,4
27,2463.59,70.0,9.85,60.15,2403.44,testing,113,4
28,2403.44,70.0,9.61,60.39,2343.05,testing,113,4
29,2343.05,70.0,9.37,60.63,2282.42,testing,113,4
30,2282.42,70.0,9.13,60.87,2221.55,testing,113,4
31,2221.55,70.0,8.89,61.11,2160.44,testing,113,4
32,2160.44,70.0,8.64,61.36,2099.08,testing,113,4
33,2099.08,70.0,8.4,61.6,2037.48,testing,113,4
34,2037.48,70.0,8.15,61.85,1975.63,testing,113,4
35,1975.63,70.0,7.9,62.1,1913.53,testing,113,4
36,1913.53,70.0,7.65,62.35,1851.18,testing,113,4
37,1851.18,70.0,7.4,62.6,1788.58,testing,113,4
38,1788.58,70.0,7.15,62.85,1725.73,testing,113,4
39,1725.73,70.0,6.9,63.1,1662.63,testing,113,4
40,1662.63,70.0,6.65,63.35,1599.28,testing,113,4
41,1599.28,70.0,6.4,63.6,1535.68,testing,113,4
42,1535.68,70.0,6.14,63.86,1471.82,testing,113,4
43,1471.82,70.0,5.89,64.11,1407.71,testing,113,4
44,1407.71,70.0,5.63,64.37,1343.34,testing,113,4
45,1343.34,70.0,5.37,64.63,1278.71,testing,113,4
46,1278.71,70.0,5.11,64.89,1213.82,testing,113,4
47,1213.82,70.0,4.86,65.14,1148.68,testing,113,4
48,1148.68,70.0,4.59,65.41,1083.27,testing,113,4
49,1083.27,70.0,4.33,65.67,1017.6,testing,113,4
50,1017.6,70.0,4.07,65.93,951.67,testing,113,4
51,951.67,70.0,3.81,66.19,885.48,testing,113,4
52,885.48,70.0,3.54,66.46,819.02,testing,113,4
53,819.02,70.0,3.28,66.72,752.3,testing,113,4
54,752.3,70.0,3.01,66.99,685.31,testing,113,4
55,685.31,70.0,2.74,67.26,618.05,testing,113,4
56,618.05,70.0,2.47,67.53,550.52,testing,113,4
57,550.52,70.0,2.2,67.8,482.72,testing,113,4
58,482.72,70.0,1.93,68.07,414.65,testing,113,4
59,414.65,70.0,1.66,68.34,346.31,testing,113,4
60,346.31,70.0,1.39,68.61,277.7,testing,113,4
61,277.7,70.0,1.11,68.89,208.81,testing,113,4
62,208.81,70.0,0.84,69.16,139.65,testing,113,4
63,139.65,70.0,0.56,69.44,70.21,testing,113,4
64,70.21,70.0,0.28,69.72,0.49,testing,113,4
65,0.49,70.0,0.0,70.0,-69.51,testing,113,4
0,5000.0,333.0,36.0,297.0,4703.0,Car,113,5
1,4703.0,333.0,33.86,299.14,4403.86,Car,113,5
2,4403.86,333.0,31.71,301.29,4102.57,Car,113,5
3,4102.57,333.0,29.54,303.46,3799.11,Car,113,5
4,3799.11,333.0,27.35,305.65,3493.46,Car,113,5
5,3493.46,333.0,25.15,307.85,3185.61,Car,113,5
6,3185.61,333.0,22.94,310.06,2875.55,Car,113,5
7,2875.55,333.0,20.7,312.3,2563.25,Car,113,5
8,2563.25,333.0,18.46,314.54,2248.71,Car,113,5
9,2248.71,333.0,16.19,316.81,1931.9,Car,113,5
10,1931.9,333.0,13.91,319.09,1612.81,Car,113,5
11,1612.81,333.0,11.61,321.39,1291.42,Car,113,5
12,1291.42,333.0,9.3,323.7,967.72,Car,113,5
13,967.72,333.0,6.97,326.03,641.69,Car,113,5
14,641.69,333.0,4.62,328.38,313.31,Car,113,5
15,313.31,333.0,2.26,330.74,-17.43,Car,113,5
0,180000.0,2331.44,594.0,1737.44,178262.56,mortgage,114,1
1,178262.56,2331.44,588.27,1743.17,176519.39,mortgage,114,1
2,176519.39,2331.44,582.51,1748.93,174770.46,mortgage,114,1
3,174770.46,2331.44,576.74,1754.7,173015.76,mortgage,114,1
4,173015.76,2331.44,570.95,1760.49,171255.27,mortgage,114,1
5,171255.27,2331.44,565.14,1766.3,169488.97,mortgage,114,1
6,169488.97,2331.44,559.31,1772.13,167716.84,mortgage,114,1
7,167716.84,2331.44,553.47,1777.97,165938.87,mortgage,114,1
8,165938.87,2331.44,547.6,1783.84,164155.03,mortgage,114,1
9,164155.03,2331.44,541.71,1789.73,162365.3,mortgage,114,1
10,162365.3,2331.44,535.81,1795.63,160569.67,mortgage,114,1
11,160569.67,2331.44,529.88,1801.56,158768.11,mortgage,114,1
12,158768.11,2331.44,523.93,1807.51,156960.6,mortgage,114,1
13,156960.6,2331.44,517.97,1813.47,155147.13,mortgage,114,1
14,155147.13,2331.44,511.99,1819.45,153327.68,mortgage,114,1
15,153327.68,2331.44,505.98,1825.46,151502.22,mortgage,114,1
16,151502.22,2331.44,499.96,1831.48,149670.74,mortgage,114,1
17,149670.74,2331.44,493.91,1837.53,147833.21,mortgage,114,1
18,147833.21,2331.44,487.85,1843.59,145989.62,mortgage,114,1
19,145989.62,2331.44,481.77,1849.67,144139.95,mortgage,114,1
20,144139.95,2331.44,475.66,1855.78,142284.17,mortgage,114,1
21,142284.17,2331.44,469.54,1861.9,140422.27,mortgage,114,1
22,140422.27,2331.44,463.39,1868.05,138554.22,mortgage,114,1
23,138554.22,2331.44,457.23,1874.21,136680.01,mortgage,114,1
24,136680.01,2331.44,451.04,1880.4,134799.61,mortgage,114,1
25,134799.61,2331.44,444.84,1886.6,132913.01,mortgage,114,1
26,132913.01,2331.44,438.61,1892.83,131020.18,mortgage,114,1
27,131020.18,2331.44,432.37,1899.07,129121.11,mortgage,114,1
28,129121.11,2331.44,426.1,1905.34,127215.77,mortgage,114,1
29,127215.77,2331.44,419.81,1911.63,125304.14,mortgage,114,1
30,125304.14,2331.44,413.5,1917.94,123386.2,mortgage,114,1
31,123386.2,2331.44,407.17,1924.27,121461.93,mortgage,114,1
32,121461.93,2331.44,400.82,1930.62,119531.31,mortgage,114,1
33,119531.31,2331.44,394.45,1936.99,117594.32,mortgage,114,1
34,117594.32,2331.44,388.06,1943.38,115650.94,mortgage,114,1
35,115650.94,2331.44,381.65,1949.79,113701.15,mortgage,114,1
36,113701.15,2331.44,375.21,1956.23,111744.92,mortgage,114,1
37,111744.92,2331.44,368.76,1962.68,109782.24,mortgage,114,1
38,109782.24,2331.44,362.28,1969.16,107813.08,mortgage,114,1
39,107813.08,2331.44,355.78,1975.66,105837.42,mortgage,114,1
40,105837.42,2331.44,349.26,1982.18,103855.24,mortgage,114,1
41,103855.24,2331.44,342.72,1988.72,101866.52,mortgage,114,1
42,101866.52,2331.44,336.16,1995.28,99871.24,mortgage,114,1
43,99871.24,2331.44,329.58,2001.86,97869.38,mortgage,114,1
44,97869.38,2331.44,322.97,2008.47,95860.91,mortgage,114,1
45,95860.91,2331.44,316.34,2015.1,93845.81,mortgage,114,1
46,93845.81,2331.44,309.69,2021.75,91824.06,mortgage,114,1
47,91824.06,2331.44,303.02,2028.42,89795.64,mortgage,114,1
48,89795.64,2331.44,296.33,2035.11,87760.53,mortgage,114,1
49,87760.53,2331.44,289.61,2041.83,85718.7,mortgage,114,1
50,85718.7,2331.44,282.87,2048.57,83670.13,mortgage,114,1
51,83670.13,2331.44,276.11,2055.33,81614.8,mortgage,114,1
52,81614.8,2331.44,269.33,2062.11,79552.69,mortgage,114,1
53,79552.69,2331.44,262.52,2068.92,77483.77,mortgage,114,1
54,77483.77,2331.44,255.7,2075.74,75408.03,mortgage,114,1
55,75408.03,2331.44,248.85,2082.59,73325.44,mortgage,114,1
56,73325.44,2331.44,241.97,2089.47,71235.97,mortgage,114,1
57,71235.97,2331.44,235.08,2096.36,69139.61,mortgage,114,1
58,69139.61,2331.44,228.16,2103.28,67036.33,mortgage,114,1
59,67036.33,2331.44,221.22,2110.22,64926.11,mortgage,114,1
60,64926.11,2331.44,214.26,2117.18,62808.93,mortgage,114,1
61,62808.93,2331.44,207.27,2124.17,60684.76,mortgage,114,1
62,60684.76,2331.44,200.26,2131.18,58553.58,mortgage,114,1
63,58553.58,2331.44,193.23,2138.21,56415.37,mortgage,114,1
64,56415.37,2331.44,186.17,2145.27,54270.1,mortgage,114,1
65,54270.1,2331.44,179.09,2152.35,52117.75,mortgage,114,1
66,52117.75,2331.44,171.99,2159.45,49958.3,mortgage,114,1
67,49958.3,2331.44,164.86,2166.58,47791.72,mortgage,114,1
68,47791.72,2331.44,157.71,2173.73,45617.99,mortgage,114,1
69,45617.99,2331.44,150.54,2180.9,43437.09,mortgage,114,1
70,43437.09,2331.44,143.34,2188.1,41248.99,mortgage,114,1
71,41248.99,2331.44,136.12,2195.32,39053.67,mortgage,114,1
72,39053.67,2331.44,128.88,2202.56,36851.11,mortgage,114,1
73,36851.11,2331.44,121.61,2209.83,34641.28,mortgage,114,1
74,34641.28,2331.44,114.32,2217.12,32424.16,mortgage,114,1
75,32424.16,2331.44,107.0,2224.44,30199.72,mortgage,114,1
76,30199.72,2331.44,99.66,2231.78,27967.94,mortgage,114,1
77,27967.94,2331.44,92.29,2239.15,25728.79,mortgage,114,1
78,25728.79,2331.44,84.91,2246.53,23482.26,mortgage,114,1
79,23482.26,2331.44,77.49,2253.95,21228.31,mortgage,114,1
80,21228.31,2331.44,70.05,2261.39,18966.92,mortgage,114,1
81,18966.92,2331.44,62.59,2268.85,16698.07,mortgage,114,1
82,16698.07,2331.44,55.1,2276.34,14421.73,mortgage,114,1
83,14421.73,2331.44,47.59,2283.85,12137.88,mortgage,114,1
84,12137.88,2331.44,40.06,2291.38,9846.5,mortgage,114,1
85,9846.5,2331.44,32.49,2298.95,7547.55,mortgage,114,1
86,7547.55,2331.44,24.91,2306.53,5241.02,mortgage,114,1
87,5241.02,2331.44,17.3,2314.14,2926.88,mortgage,114,1
88,2926.88,2331.44,9.66,2321.78,605.1,mortgage,114,1
89,605.1,2331.44,2.0,2329.44,-1724.34,mortgage,114,1
0,8250.57,84.62,53.63,30.99,8219.58,WellsFargo1,114,2
1,8219.58,84.62,53.43,31.19,8188.39,WellsFargo1,114,2
2,8188.39,84.62,53.22,31.4,8156.99,WellsFargo1,114,2
3,8156.99,84.62,53.02,31.6,8125.39,WellsFargo1,114,2
4,8125.39,84.62,52.82,31.8,8093.59,WellsFargo1,114,2
5,8093.59,84.62,52.61,32.01,8061.58,WellsFargo1,114,2
6,8061.58,84.62,52.4,32.22,8029.36,WellsFargo1,114,2
7,8029.36,84.62,52.19,32.43,7996.93,WellsFargo1,114,2
8,7996.93,84.62,51.98,32.64,7964.29,WellsFargo1,114,2
9,7964.29,84.62,51.77,32.85,7931.44,WellsFargo1,114,2
10,7931.44,84.62,51.55,33.07,7898.37,WellsFargo1,114,2
11,7898.37,84.62,51.34,33.28,7865.09,WellsFargo1,114,2
12,7865.09,84.62,51.12,33.5,7831.59,WellsFargo1,114,2
13,7831.59,84.62,50.91,33.71,7797.88,WellsFargo1,114,2
14,7797.88,84.62,50.69,33.93,7763.95,WellsFargo1,114,2
15,7763.95,84.62,50.47,34.15,7729.8,WellsFargo1,114,2
16,7729.8,84.62,50.24,34.38,7695.42,WellsFargo1,114,2
17,7695.42,84.62,50.02,34.6,7660.82,WellsFargo1,114,2
18,7660.82,84.62,49.8,34.82,7626.0,WellsFargo1,114,2
19,7626.0,84.62,49.57,35.05,7590.95,WellsFargo1,114,2
20,7590.95,84.62,49.34,35.28,7555.67,WellsFargo1,114,2
21,7555.67,84.62,49.11,35.51,7520.16,WellsFargo1,114,2
22,7520.16,84.62,48.88,35.74,7484.42,WellsFargo1,114,2
23,7484.42,84.62,48.65,35.97,7448.45,WellsFargo1,114,2
24,7448.45,84.62,48.41,36.21,7412.24,WellsFargo1,114,2
25,7412.24,84.62,48.18,36.44,7375.8,WellsFargo1,114,2
26,7375.8,84.62,47.94,36.68,7339.12,WellsFargo1,114,2
27,7339.12,84.62,47.7,36.92,7302.2,WellsFargo1,114,2
28,7302.2,84.62,47.46,37.16,7265.04,WellsFargo1,114,2
29,7265.04,84.62,47.22,37.4,7227.64,WellsFargo1,114,2
30,7227.64,84.62,46.98,37.64,7190.0,WellsFargo1,114,2
31,7190.0,84.62,46.73,37.89,7152.11,WellsFargo1,114,2
32,7152.11,84.62,46.49,38.13,7113.98,WellsFargo1,114,2
33,7113.98,84.62,46.24,38.38,7075.6,WellsFargo1,114,2
34,7075.6,84.62,45.99,38.63,7036.97,WellsFargo1,114,2
35,7036.97,84.62,45.74,38.88,6998.09,WellsFargo1,114,2
36,6998.09,84.62,45.49,39.13,6958.96,WellsFargo1,114,2
37,6958.96,84.62,45.23,39.39,6919.57,WellsFargo1,114,2
38,6919.57,84.62,44.98,39.64,6879.93,WellsFargo1,114,2
39,6879.93,84.62,44.72,39.9,6840.03,WellsFargo1,114,2
40,6840.03,84.62,44.46,40.16,6799.87,WellsFargo1,114,2
41,6799.87,84.62,44.2,40.42,6759.45,WellsFargo1,114,2
42,6759.45,84.62,43.94,40.68,6718.77,WellsFargo1,114,2
43,6718.77,84.62,43.67,40.95,6677.82,WellsFargo1,114,2
44,6677.82,84.62,43.41,41.21,6636.61,WellsFargo1,114,2
45,6636.61,84.62,43.14,41.48,6595.13,WellsFargo1,114,2
46,6595.13,84.62,42.87,41.75,6553.38,WellsFargo1,114,2
47,6553.38,84.62,42.6,42.02,6511.36,WellsFargo1,114,2
48,6511.36,84.62,42.32,42.3,6469.06,WellsFargo1,114,2
49,6469.06,84.62,42.05,42.57,6426.49,WellsFargo1,114,2
50,6426.49,84.62,41.77,42.85,6383.64,WellsFargo1,114,2
51,6383.64,84.62,41.49,43.13,6340.51,WellsFargo1,114,2
52,6340.51,84.62,41.21,43.41,6297.1,WellsFargo1,114,2
53,6297.1,84.62,40.93,43.69,6253.41,WellsFargo1,114,2
54,6253.41,84.62,40.65,43.97,6209.44,WellsFargo1,114,2
55,6209.44,84.62,40.36,44.26,6165.18,WellsFargo1,114,2
56,6165.18,84.62,40.07,44.55,6120.63,WellsFargo1,114,2
57,6120.63,84.62,39.78,44.84,6075.79,WellsFargo1,114,2
58,6075.79,84.62,39.49,45.13,6030.66,WellsFargo1,114,2
59,6030.66,84.62,39.2,45.42,5985.24,WellsFargo1,114,2
60,5985.24,84.62,38.9,45.72,5939.52,WellsFargo1,114,2
61,5939.52,84.62,38.61,46.01,5893.51,WellsFargo1,114,2
62,5893.51,84.62,38.31,46.31,5847.2,WellsFargo1,114,2
63,5847.2,84.62,38.01,46.61,5800.59,WellsFargo1,114,2
64,5800.59,84.62,37.7,46.92,5753.67,WellsFargo1,114,2
65,5753.67,84.62,37.4,47.22,5706.45,WellsFargo1,114,2
66,5706.45,84.62,37.09,47.53,5658.92,WellsFargo1,114,2
67,5658.92,84.62,36.78,47.84,5611.08,WellsFargo1,114,2
68,5611.08,84.62,36.47,48.15,5562.93,WellsFargo1,114,2
69,5562.93,84.62,36.16,48.46,5514.47,WellsFargo1,114,2
70,5514.47,84.62,35.84,48.78,5465.69,WellsFargo1,114,2
71,5465.69,84.62,35.53,49.09,5416.6,WellsFargo1,114,2
72,5416.6,84.62,35.21,49.41,5367.19,WellsFargo1,114,2
73,5367.19,84.62,34.89,49.73,5317.46,WellsFargo1,114,2
74,5317.46,84.62,34.56,50.06,5267.4,WellsFargo1,114,2
75,5267.4,84.62,34.24,50.38,5217.02,WellsFargo1,114,2
76,5217.02,84.62,33.91,50.71,5166.31,WellsFargo1,114,2
77,5166.31,84.62,33.58,51.04,5115.27,WellsFargo1,114,2
78,5115.27,84.62,33.25,51.37,5063.9,WellsFargo1,114,2
79,5063.9,84.62,32.92,51.7,5012.2,WellsFargo1,114,2
80,5012.2,84.62,32.58,52.04,4960.16,WellsFargo1,114,2
81,4960.16,84.62,32.24,52.38,4907.78,WellsFargo1,114,2
82,4907.78,84.62,31.9,52.72,4855.06,WellsFargo1,114,2
83,4855.06,84.62,31.56,53.06,4802.0,WellsFargo1,114,2
84,4802.0,84.62,31.21,53.41,4748.59,WellsFargo1,114,2
85,4748.59,84.62,30.87,53.75,4694.84,WellsFargo1,114,2
86,4694.84,84.62,30.52,54.1,4640.74,WellsFargo1,114,2
87,4640.74,84.62,30.16,54.46,4586.28,WellsFargo1,114,2
88,4586.28,84.62,29.81,54.81,4531.47,WellsFargo1,114,2
89,4531.47,1808.96,29.45,1779.51,2751.96,WellsFargo1,114,2
90,2751.96,2416.06,17.89,2398.17,353.79,WellsFargo1,114,2
91,353.79,2416.06,2.3,2413.76,-2059.97,WellsFargo1,114,2
0,20000.0,191.04,108.0,83.04,19916.96,WellsFargo2,114,3
1,19916.96,191.04,107.55,83.49,19833.47,WellsFargo2,114,3
2,19833.47,191.04,107.1,83.94,19749.53,WellsFargo2,114,3
3,19749.53,191.04,106.65,84.39,19665.14,WellsFargo2,114,3
4,19665.14,191.04,106.19,84.85,19580.29,WellsFargo2,114,3
5,19580.29,191.04,105.73,85.31,19494.98,WellsFargo2,114,3
6,19494.98,191.04,105.27,85.77,19409.21,WellsFargo2,114,3
7,19409.21,191.04,104.81,86.23,19322.98,WellsFargo2,114,3
8,19322.98,191.04,104.34,86.7,19236.28,WellsFargo2,114,3
9,19236.28,191.04,103.88,87.16,19149.12,WellsFargo2,114,3
10,19149.12,191.04,103.41,87.63,19061.49,WellsFargo2,114,3
11,19061.49,191.04,102.93,88.11,18973.38,WellsFargo2,114,3
12,18973.38,191.04,102.46,88.58,18884.8,WellsFargo2,114,3
13,18884.8,191.04,101.98,89.06,18795.74,WellsFargo2,114,3
14,18795.74,191.04,101.5,89.54,18706.2,WellsFargo2,114,3
15,18706.2,191.04,101.01,90.03,18616.17,WellsFargo2,114,3
16,18616.17,191.04,100.53,90.51,18525.66,WellsFargo2,114,3
17,18525.66,191.04,100.04,91.0,18434.66,WellsFargo2,114,3
18,18434.66,191.04,99.55,91.49,18343.17,WellsFargo2,114,3
19,18343.17,191.04,99.05,91.99,18251.18,WellsFargo2,114,3
20,18251.18,191.04,98.56,92.48,18158.7,WellsFargo2,114,3
21,18158.7,191.04,98.06,92.98,18065.72,WellsFargo2,114,3
22,18065.72,191.04,97.55,93.49,17972.23,WellsFargo2,114,3
23,17972.23,191.04,97.05,93.99,17878.24,WellsFargo2,114,3
24,17878.24,191.04,96.54,94.5,17783.74,WellsFargo2,114,3
25,17783.74,191.04,96.03,95.01,17688.73,WellsFargo2,114,3
26,17688.73,191.04,95.52,95.52,17593.21,WellsFargo2,114,3
27,17593.21,191.04,95.0,96.04,17497.17,WellsFargo2,114,3
28,17497.17,191.04,94.48,96.56,17400.61,WellsFargo2,114,3
29,17400.61,191.04,93.96,97.08,17303.53,WellsFargo2,114,3
30,17303.53,191.04,93.44,97.6,17205.93,WellsFargo2,114,3
31,17205.93,191.04,92.91,98.13,17107.8,WellsFargo2,114,3
32,17107.8,191.04,92.38,98.66,17009.14,WellsFargo2,114,3
33,17009.14,191.04,91.85,99.19,16909.95,WellsFargo2,114,3
34,16909.95,191.04,91.31,99.73,16810.22,WellsFargo2,114,3
35,16810.22,191.04,90.78,100.26,16709.96,WellsFargo2,114,3
36,16709.96,191.04,90.23,100.81,16609.15,WellsFargo2,114,3
37,16609.15,191.04,89.69,101.35,16507.8,WellsFargo2,114,3
38,16507.8,191.04,89.14,101.9,16405.9,WellsFargo2,114,3
39,16405.9,191.04,88.59,102.45,16303.45,WellsFargo2,114,3
40,16303.45,191.04,88.04,103.0,16200.45,WellsFargo2,114,3
41,16200.45,191.04,87.48,103.56,16096.89,WellsFargo2,114,3
42,16096.89,191.04,86.92,104.12,15992.77,WellsFargo2,114,3
43,15992.77,191.04,86.36,104.68,15888.09,WellsFargo2,114,3
44,15888.09,191.04,85.8,105.24,15782.85,WellsFargo2,114,3
45,15782.85,191.04,85.23,105.81,15677.04,WellsFargo2,114,3
46,15677.04,191.04,84.66,106.38,15570.66,WellsFargo2,114,3
47,15570.66,191.04,84.08,106.96,15463.7,WellsFargo2,114,3
48,15463.7,191.04,83.5,107.54,15356.16,WellsFargo2,114,3
49,15356.16,191.04,82.92,108.12,15248.04,WellsFargo2,114,3
50,15248.04,191.04,82.34,108.7,15139.34,WellsFargo2,114,3
51,15139.34,191.04,81.75,109.29,15030.05,WellsFargo2,114,3
52,15030.05,191.04,81.16,109.88,14920.17,WellsFargo2,114,3
53,14920.17,191.04,80.57,110.47,14809.7,WellsFargo2,114,3
54,14809.7,191.04,79.97,111.07,14698.63,WellsFargo2,114,3
55,14698.63,191.04,79.37,111.67,14586.96,WellsFargo2,114,3
56,14586.96,191.04,78.77,112.27,14474.69,WellsFargo2,114,3
57,14474.69,191.04,78.16,112.88,14361.81,WellsFargo2,114,3
58,14361.81,191.04,77.55,113.49,14248.32,WellsFargo2,114,3
59,14248.32,191.04,76.94,114.1,14134.22,WellsFargo2,114,3
60,14134.22,191.04,76.32,114.72,14019.5,WellsFargo2,114,3
61,14019.5,191.04,75.71,115.33,13904.17,WellsFargo2,114,3
62,13904.17,191.04,75.08,115.96,13788.21,WellsFargo2,114,3
63,13788.21,191.04,74.46,116.58,13671.63,WellsFargo2,114,3
64,13671.63,191.04,73.83,117.21,13554.42,WellsFargo2,114,3
65,13554.42,191.04,73.19,117.85,13436.57,WellsFargo2,114,3
66,13436.57,191.04,72.56,118.48,13318.09,WellsFargo2,114,3
67,13318.09,191.04,71.92,119.12,13198.97,WellsFargo2,114,3
68,13198.97,191.04,71.27,119.77,13079.2,WellsFargo2,114,3
69,13079.2,191.04,70.63,120.41,12958.79,WellsFargo2,114,3
70,12958.79,191.04,69.98,121.06,12837.73,WellsFargo2,114,3
71,12837.73,191.04,69.32,121.72,12716.01,WellsFargo2,114,3
72,12716.01,191.04,68.67,122.37,12593.64,WellsFargo2,114,3
73,12593.64,191.04,68.01,123.03,12470.61,WellsFargo2,114,3
74,12470.61,191.04,67.34,123.7,12346.91,WellsFargo2,114,3
75,12346.91,191.04,66.67,124.37,12222.54,WellsFargo2,114,3
76,12222.54,191.04,66.0,125.04,12097.5,WellsFargo2,114,3
77,12097.5,191.04,65.33,125.71,11971.79,WellsFargo2,114,3
78,11971.79,191.04,64.65,126.39,11845.4,WellsFargo2,114,3
79,11845.4,191.04,63.97,127.07,11718.33,WellsFargo2,114,3
80,11718.33,191.04,63.28,127.76,11590.57,WellsFargo2,114,3
81,11590.57,191.04,62.59,128.45,11462.12,WellsFargo2,114,3
82,11462.12,191.04,61.9,129.14,11332.98,WellsFargo2,114,3
83,11332.98,191.04,61.2,129.84,11203.14,WellsFargo2,114,3
84,11203.14,191.04,60.5,130.54,11072.6,WellsFargo2,114,3
85,11072.6,191.04,59.79,131.25,10941.35,WellsFargo2,114,3
86,10941.35,191.04,59.08,131.96,10809.39,WellsFargo2,114,3
87,10809.39,191.04,58.37,132.67,10676.72,WellsFargo2,114,3
88,10676.72,191.04,57.65,133.39,10543.33,WellsFargo2,114,3
89,10543.33,191.04,56.93,134.11,10409.22,WellsFargo2,114,3
90,10409.22,191.04,56.21,134.83,10274.39,WellsFargo2,114,3
91,10274.39,2251.01,55.48,2195.53,8078.86,WellsFargo2,114,3
92,8078.86,2607.1,43.63,2563.47,5515.39,WellsFargo2,114,3
93,5515.39,2607.1,29.78,2577.32,2938.07,WellsFargo2,114,3
94,2938.07,2607.1,15.87,2591.23,346.84,WellsFargo2,114,3
95,346.84,2607.1,1.87,2605.23,-2258.39,WellsFargo2,114,3
0,5000.0,333.0,36.0,297.0,4703.0,Car,114,4
1,4703.0,333.0,33.86,299.14,4403.86,Car,114,4
2,4403.86,333.0,31.71,301.29,4102.57,Car,114,4
3,4102.57,333.0,29.54,303.46,3799.11,Car,114,4
4,3799.11,333.0,27.35,305.65,3493.46,Car,114,4
5,3493.46,333.0,25.15,307.85,3185.61,Car,114,4
6,3185.61,333.0,22.94,310.06,2875.55,Car,114,4
7,2875.55,333.0,20.7,312.3,2563.25,Car,114,4
8,2563.25,333.0,18.46,314.54,2248.71,Car,114,4
9,2248.71,333.0,16.19,316.81,1931.9,Car,114,4
10,1931.9,333.0,13.91,319.09,1612.81,Car,114,4
11,1612.81,333.0,11.61,321.39,1291.42,Car,114,4
12,1291.42,333.0,9.3,323.7,967.72,Car,114,4
13,967.72,333.0,6.97,326.03,641.69,Car,114,4
14,641.69,333.0,4.62,328.38,313.31,Car,114,4
15,313.31,333.0,2.26,330.74,-17.43,Car,114,4
0,4000.0,70.0,16.0,54.0,3946.0,testing,114,5
1,3946.0,70.0,15.78,54.22,3891.78,testing,114,5
2,3891.78,70.0,15.57,54.43,3837.35,testing,114,5
3,3837.35,70.0,15.35,54.65,3782.7,testing,114,5
4,3782.7,70.0,15.13,54.87,3727.83,testing,114,5
5,3727.83,70.0,14.91,55.09,3672.74,testing,114,5
6,3672.74,70.0,14.69,55.31,3617.43,testing,114,5
7,3617.43,70.0,14.47,55.53,3561.9,testing,114,5
8,3561.9,70.0,14.25,55.75,3506.15,testing,114,5
9,3506.15,70.0,14.02,55.98,3450.17,testing,114,5
10,3450.17,70.0,13.8,56.2,3393.97,testing,114,5
11,3393.97,70.0,13.58,56.42,3337.55,testing,114,5
12,3337.55,70.0,13.35,56.65,3280.9,testing,114,5
13,3280.9,70.0,13.12,56.88,3224.02,testing,114,5
14,3224.02,70.0,12.9,57.1,3166.92,testing,114,5
15,3166.92,87.43,12.67,74.76,3092.16,testing,114,5
16,3092.16,3010.1,12.37,2997.73,94.43,testing,114,5
17,94.43,3010.1,0.38,3009.72,-2915.29,testing,114,5
0,180000.0,2331.44,594.0,1737.44,178262.56,mortgage,115,1
1,178262.56,2331.44,588.27,1743.17,176519.39,mortgage,115,1
2,176519.39,2331.44,582.51,1748.93,174770.46,mortgage,115,1
3,174770.46,2331.44,576.74,1754.7,173015.76,mortgage,115,1
4,173015.76,2331.44,570.95,1760.49,171255.27,mortgage,115,1
5,171255.27,2331.44,565.14,1766.3,169488.97,mortgage,115,1
6,169488.97,2331.44,559.31,1772.13,167716.84,mortgage,115,1
7,167716.84,2331.44,553.47,1777.97,165938.87,mortgage,115,1
8,165938.87,2331.44,547.6,1783.84,164155.03,mortgage,115,1
9,164155.03,2331.44,541.71,1789.73,162365.3,mortgage,115,1
10,162365.3,2331.44,535.81,1795.63,160569.67,mortgage,115,1
11,160569.67,2331.44,529.88,1801.56,158768.11,mortgage,115,1
12,158768.11,2331.44,523.93,1807.51,156960.6,mortgage,115,1
13,156960.6,2331.44,517.97,1813.47,155147.13,mortgage,115,1
14,155147.13,2331.44,511.99,1819.45,153327.68,mortgage,115,1
15,153327.68,2331.44,505.98,1825.46,151502.22,mortgage,115,1
16,151502.22,2331.44,499.96,1831.48,149670.74,mortgage,115,1
17,149670.74,2331.44,493.91,1837.53,147833.21,mortgage,115,1
18,147833.21,2331.44,487.85,1843.59,145989.62,mortgage,115,1
19,145989.62,2331.44,481.77,1849.67,144139.95,mortgage,115,1
20,144139.95,2331.44,475.66,1855.78,142284.17,mortgage,115,1
21,142284.17,2331.44,469.54,1861.9,140422.27,mortgage,115,1
22,140422.27,2331.44,463.39,1868.05,138554.22,mortgage,115,1
23,138554.22,2331.44,457.23,1874.21,136680.01,mortgage,115,1
24,136680.01,2331.44,451.04,1880.4,134799.61,mortgage,115,1
25,134799.61,2331.44,444.84,1886.6,132913.01,mortgage,115,1
26,132913.01,2331.44,438.61,1892.83,131020.18,mortgage,115,1
27,131020.18,2331.44,432.37,1899.07,129121.11,mortgage,115,1
28,129121.11,2331.44,426.1,1905.34,127215.77,mortgage,115,1
29,127215.77,2331.44,419.81,1911.63,125304.14,mortgage,115,1
30,125304.14,2331.44,413.5,1917.94,123386.2,mortgage,115,1
31,123386.2,2331.44,407.17,1924.27,121461.93,mortgage,115,1
32,121461.93,2331.44,400.82,1930.62,119531.31,mortgage,115,1
33,119531.31,2331.44,394.45,1936.99,117594.32,mortgage,115,1
34,117594.32,2331.44,388.06,1943.38,115650.94,mortgage,115,1
35,115650.94,2331.44,381.65,1949.79,113701.15,mortgage,115,1
36,113701.15,2331.44,375.21,1956.23,111744.92,mortgage,115,1
37,111744.92,2331.44,368.76,1962.68,109782.24,mortgage,115,1
38,109782.24,2331.44,362.28,1969.16,107813.08,mortgage,115,1
39,107813.08,2331.44,355.78,1975.66,105837.42,mortgage,115,1
40,105837.42,2331.44,349.26,1982.18,103855.24,mortgage,115,1
41,103855.24,2331.44,342.72,1988.72,101866.52,mortgage,115,1
42,101866.52,2331.44,336.16,1995.28,99871.24,mortgage,115,1
43,99871.24,2331.44,329.58,2001.86,97869.38,mortgage,115,1
44,97869.38,2331.44,322.97,2008.47,95860.91,mortgage,115,1
45,95860.91,2331.44,316.34,2015.1,93845.81,mortgage,115,1
46,93845.81,2331.44,309.69,2021.75,91824.06,mortgage,115,1
47,91824.06,2331.44,303.02,2028.42,89795.64,mortgage,115,1
48,89795.64,2331.44,296.33,2035.11,87760.53,mortgage,115,1
49,87760.53,2331.44,289.61,2041.83,85718.7,mortgage,115,1
50,85718.7,2331.44,282.87,2048.57,83670.13,mortgage,115,1
51,83670.13,2331.44,276.11,2055.33,81614.8,mortgage,115,1
52,81614.8,2331.44,269.33,2062.11,79552.69,mortgage,115,1
53,79552.69,2331.44,262.52,2068.92,77483.77,mortgage,115,1
54,77483.77,2331.44,255.7,2075.74,75408.03,mortgage,115,1
55,75408.03,2331.44,248.85,2082.59,73325.44,mortgage,115,1
56,73325.44,2331.44,241.97,2089.47,71235.97,mortgage,115,1
57,71235.97,2331.44,235.08,2096.36,69139.61,mortgage,115,1
58,69139.61,2331.44,228.16,2103.28,67036.33,mortgage,115,1
59,67036.33,2331.44,221.22,2110.22,64926.11,mortgage,115,1
60,64926.11,2331.44,214.26,2117.18,62808.93,mortgage,115,1
61,62808.93,2331.44,207.27,2124.17,60684.76,mortgage,115,1
62,60684.76,2331.44,200.26,2131.18,58553.58,mortgage,115,1
63,58553.58,2331.44,193.23,2138.21,56415.37,mortgage,115,1
64,56415.37,2331.44,186.17,2145.27,54270.1,mortgage,115,1
65,54270.1,2331.44,179.09,2152.35,52117.75,mortgage,115,1
66,52117.75,2331.44,171.99,2159.45,49958.3,mortgage,115,1
67,49958.3,2331.44,164.86,2166.58,47791.72,mortgage,115,1
68,47791.72,2331.44,157.71,2173.73,45617.99,mortgage,115,1
69,45617.99,2331.44,150.54,2180.9,43437.09,mortgage,115,1
70,43437.09,2331.44,143.34,2188.1,41248.99,mortgage,115,1
71,41248.99,2331.44,136.12,2195.32,39053.67,mortgage,115,1
72,39053.67,2331.44,128.88,2202.56,36851.11,mortgage,115,1
73,36851.11,2331.44,121.61,2209.83,34641.28,mortgage,115,1
74,34641.28,2331.44,114.32,2217.12,32424.16,mortgage,115,1
75,32424.16,2331.44,107.0,2224.44,30199.72,mortgage,115,1
76,30199.72,2331.44,99.66,2231.78,27967.94,mortgage,115,1
77,27967.94,2331.44,92.29,2239.15,25728.79,mortgage,115,1
78,25728.79,2331.44,84.91,2246.53,23482.26,mortgage,115,1
79,23482.26,2331.44,77.49,2253.95,21228.31,mortgage,115,1
80,21228.31,2331.44,70.05,2261.39,18966.92,mortgage,115,1
81,18966.92,2331.44,62.59,2268.85,16698.07,mortgage,115,1
82,16698.07,2331.44,55.1,2276.34,14421.73,mortgage,115,1
83,14421.73,2331.44,47.59,2283.85,12137.88,mortgage,115,1
84,12137.88,2331.44,40.06,2291.38,9846.5,mortgage,115,1
85,9846.5,2331.44,32.49,2298.95,7547.55,mortgage,115,1
86,7547.55,2331.44,24.91,2306.53,5241.02,mortgage,115,1
87,5241.02,2331.44,17.3,2314.14,2926.88,mortgage,115,1
88,2926.88,2331.44,9.66,2321.78,605.1,mortgage,115,1
89,605.1,2331.44,2.0,2329.44,-1724.34,mortgage,115,1
0,20000.0,191.04,108.0,83.04,19916.96,WellsFargo2,115,2
1,19916.96,191.04,107.55,83.49,19833.47,WellsFargo2,115,2
2,19833.47,191.04,107.1,83.94,19749.53,WellsFargo2,115,2
3,19749.53,191.04,106.65,84.39,19665.14,WellsFargo2,115,2
4,19665.14,191.04,106.19,84.85,19580.29,WellsFargo2,115,2
5,19580.29,191.04,105.73,85.31,19494.98,WellsFargo2,115,2
6,19494.98,191.04,105.27,85.77,19409.21,WellsFargo2,115,2
7,19409.21,191.04,104.81,86.23,19322.98,WellsFargo2,115,2
8,19322.98,191.04,104.34,86.7,19236.28,WellsFargo2,115,2
9,19236.28,191.04,103.88,87.16,19149.12,WellsFargo2,115,2
10,19149.12,191.04,103.41,87.63,19061.49,WellsFargo2,115,2
11,19061.49,191.04,102.93,88.11,18973.38,WellsFargo2,115,2
12,18973.38,191.04,102.46,88.58,18884.8,WellsFargo2,115,2
13,18884.8,191.04,101.98,89.06,18795.74,WellsFargo2,115,2
14,18795.74,191.04,101.5,89.54,18706.2,WellsFargo2,115,2
15,18706.2,191.04,101.01,90.03,18616.17,WellsFargo2,115,2
16,18616.17,191.04,100.53,90.51,18525.66,WellsFargo2,115,2
17,18525.66,191.04,100.04,91.0,18434.66,WellsFargo2,115,2
18,18434.66,191.04,99.55,91.49,18343.17,WellsFargo2,115,2
19,18343.17,191.04,99.05,91.99,18251.18,WellsFargo2,115,2
20,18251.18,191.04,98.56,92.48,18158.7,WellsFargo2,115,2
21,18158.7,191.04,98.06,92.98,18065.72,WellsFargo2,115,2
22,18065.72,191.04,97.55,93.49,17972.23,WellsFargo2,115,2
23,17972.23,191.04,97.05,93.99,17878.24,WellsFargo2,115,2
24,17878.24,191.04,96.54,94.5,17783.74,WellsFargo2,115,2
25,17783.74,191.04,96.03,95.01,17688.73,WellsFargo2,115,2
26,17688.73,191.04,95.52,95.52,17593.21,WellsFargo2,115,2
27,17593.21,191.04,95.0,96.04,17497.17,WellsFargo2,115,2
28,17497.17,191.04,94.48,96.56,17400.61,WellsFargo2,115,2
29,17400.61,191.04,93.96,97.08,17303.53,WellsFargo2,115,2
30,17303.53,191.04,93.44,97.6,17205.93,WellsFargo2,115,2
31,17205.93,191.04,92.91,98.13,17107.8,WellsFargo2,115,2
32,17107.8,191.04,92.38,98.66,17009.14,WellsFargo2,115,2
33,17009.14,191.04,91.85,99.19,16909.95,WellsFargo2,115,2
34,16909.95,191.04,91.31,99.73,16810.22,WellsFargo2,115,2
35,16810.22,191.04,90.78,100.26,16709.96,WellsFargo2,115,2
36,16709.96,191.04,90.23,100.81,16609.15,WellsFargo2,115,2
37,16609.15,191.04,89.69,101.35,16507.8,WellsFargo2,115,2
38,16507.8,191.04,89.14,101.9,16405.9,WellsFargo2,115,2
39,16405.9,191.04,88.59,102.45,16303.45,WellsFargo2,115,2
40,16303.45,191.04,88.04,103.0,16200.45,WellsFargo2,115,2
41,16200.45,191.04,87.48,103.56,16096.89,WellsFargo2,115,2
42,16096.89,191.04,86.92,104.12,15992.77,WellsFargo2,115,2
43,15992.77,191.04,86.36,104.68,15888.09,WellsFargo2,115,2
44,15888.09,191.04,85.8,105.24,15782.85,WellsFargo2,115,2
45,15782.85,191.04,85.23,105.81,15677.04,WellsFargo2,115,2
46,15677.04,191.04,84.66,106.38,15570.66,WellsFargo2,115,2
47,15570.66,191.04,84.08,106.96,15463.7,WellsFargo2,115,2
48,15463.7,191.04,83.5,107.54,15356.16,WellsFargo2,115,2
49,15356.16,191.04,82.92,108.12,15248.04,WellsFargo2,115,2
50,15248.04,191.04,82.34,108.7,15139.34,WellsFargo2,115,2
51,15139.34,191.04,81.75,109.29,15030.05,WellsFargo2,115,2
52,15030.05,191.04,81.16,109.88,14920.17,WellsFargo2,115,2
53,14920.17,191.04,80.57,110.47,14809.7,WellsFargo2,115,2
54,14809.7,191.04,79.97,111.07,14698.63,WellsFargo2,115,2
55,14698.63,191.04,79.37,111.67,14586.96,WellsFargo2,115,2
56,14586.96,191.04,78.77,112.27,14474.69,WellsFargo2,115,2
57,14474.69,191.04,78.16,112.88,14361.81,WellsFargo2,115,2
58,14361.81,191.04,77.55,113.49,14248.32,WellsFargo2,115,2
59,14248.32,191.04,76.94,114.1,14134.22,WellsFargo2,115,2
60,14134.22,191.04,76.32,114.72,14019.5,WellsFargo2,115,2
61,14019.5,191.04,75.71,115.33,13904.17,WellsFargo2,115,2
62,13904.17,191.04,75.08,115.96,13788.21,WellsFargo2,115,2
63,13788.21,191.04,74.46,116.58,13671.63,WellsFargo2,115,2
64,13671.63,191.04,73.83,117.21,13554.42,WellsFargo2,115,2
65,13554.42,191.04,73.19,117.85,13436.57,WellsFargo2,115,2
66,13436.57,191.04,72.56,118.48,13318.09,WellsFargo2,115,2
67,13318.09,191.04,71.92,119.12,13198.97,WellsFargo2,115,2
68,13198.97,191.04,71.27,119.77,13079.2,WellsFargo2,115,2
69,13079.2,191.04,70.63,120.41,12958.79,WellsFargo2,115,2
70,12958.79,191.04,69.98,121.06,12837.73,WellsFargo2,115,2
71,12837.73,191.04,69.32,121.72,12716.01,WellsFargo2,115,2
72,12716.01,191.04,68.67,122.37,12593.64,WellsFargo2,115,2
73,12593.64,191.04,68.01,123.03,12470.61,WellsFargo2,115,2
74,12470.61,191.04,67.34,123.7,12346.91,WellsFargo2,115,2
75,12346.91,191.04,66.67,124.37,12222.54,WellsFargo2,115,2
76,12222.54,191.04,66.0,125.04,12097.5,WellsFargo2,115,2
77,12097.5,191.04,65.33,125.71,11971.79,WellsFargo2,115,2
78,11971.79,191.04,64.65,126.39,11845.4,WellsFargo2,115,2
79,11845.4,191.04,63.97,127.07,11718.33,WellsFargo2,115,2
80,11718.33,191.04,63.28,127.76,11590.57,WellsFargo2,115,2
81,11590.57,191.04,62.59,128.45,11462.12,WellsFargo2,115,2
82,11462.12,191.04,61.9,129.14,11332.98,WellsFargo2,115,2
83,11332.98,191.04,61.2,129.84,11203.14,WellsFargo2,115,2
84,11203.14,191.04,60.5,130.54,11072.6,WellsFargo2,115,2
85,11072.6,191.04,59.79,131.25,10941.35,WellsFargo2,115,2
86,10941.35,191.04,59.08,131.96,10809.39,WellsFargo2,115,2
87,10809.39,191.04,58.37,132.67,10676.72,WellsFargo2,115,2
88,10676.72,191.04,57.65,133.39,10543.33,WellsFargo2,115,2
89,10543.33,1915.38,56.93,1858.45,8684.88,WellsFargo2,115,2
90,8684.88,2522.48,46.9,2475.58,6209.3,WellsFargo2,115,2
91,6209.3,2522.48,33.53,2488.95,3720.35,WellsFargo2,115,2
92,3720.35,2522.48,20.09,2502.39,1217.96,WellsFargo2,115,2
93,1217.96,2522.48,6.58,2515.9,-1297.94,WellsFargo2,115,2
0,4000.0,70.0,16.0,54.0,3946.0,testing,115,3
1,3946.0,70.0,15.78,54.22,3891.78,testing,115,3
2,3891.78,70.0,15.57,54.43,3837.35,testing,115,3
3,3837.35,70.0,15.35,54.65,3782.7,testing,115,3
4,3782.7,70.0,15.13,54.87,3727.83,testing,115,3
5,3727.83,70.0,14.91,55.09,3672.74,testing,115,3
6,3672.74,70.0,14.69,55.31,3617.43,testing,115,3
7,3617.43,70.0,14.47,55.53,3561.9,testing,115,3
8,3561.9,70.0,14.25,55.75,3506.15,testing,115,3
9,3506.15,70.0,14.02,55.98,3450.17,testing,115,3
10,3450.17,70.0,13.8,56.2,3393.97,testing,115,3
11,3393.97,70.0,13.58,56.42,3337.55,testing,115,3
12,3337.55,70.0,13.35,56.65,3280.9,testing,115,3
13,3280.9,70.0,13.12,56.88,3224.02,testing,115,3
14,3224.02,70.0,12.9,57.1,3166.92,testing,115,3
15,3166.92,70.0,12.67,57.33,3109.59,testing,115,3
16,3109.59,70.0,12.44,57.56,3052.03,testing,115,3
17,3052.03,70.0,12.21,57.79,2994.24,testing,115,3
18,2994.24,70.0,11.98,58.02,2936.22,testing,115,3
19,2936.22,70.0,11.74,58.26,2877.96,testing,115,3
20,2877.96,70.0,11.51,58.49,2819.47,testing,115,3
21,2819.47,70.0,11.28,58.72,2760.75,testing,115,3
22,2760.75,70.0,11.04,58.96,2701.79,testing,115,3
23,2701.79,70.0,10.81,59.19,2642.6,testing,115,3
24,2642.6,70.0,10.57,59.43,2583.17,testing,115,3
25,2583.17,70.0,10.33,59.67,2523.5,testing,115,3
26,2523.5,70.0,10.09,59.91,2463.59,testing,115,3
27,2463.59,70.0,9.85,60.15,2403.44,testing,115,3
28,2403.44,70.0,9.61,60.39,2343.05,testing,115,3
29,2343.05,70.0,9.37,60.63,2282.42,testing,115,3
30,2282.42,70.0,9.13,60.87,2221.55,testing,115,3
31,2221.55,70.0,8.89,61.11,2160.44,testing,115,3
32,2160.44,70.0,8.64,61.36,2099.08,testing,115,3
33,2099.08,70.0,8.4,61.6,2037.48,testing,115,3
34,2037.48,70.0,8.15,61.85,1975.63,testing,115,3
35,1975.63,70.0,7.9,62.1,1913.53,testing,115,3
36,1913.53,70.0,7.65,62.35,1851.18,testing,115,3
37,1851.18,70.0,7.4,62.6,1788.58,testing,115,3
38,1788.58,70.0,7.15,62.85,1725.73,testing,115,3
39,1725.73,70.0,6.9,63.1,1662.63,testing,115,3
40,1662.63,70.0,6.65,63.35,1599.28,testing,115,3
41,1599.28,70.0,6.4,63.6,1535.68,testing,115,3
42,1535.68,70.0,6.14,63.86,1471.82,testing,115,3
43,1471.82,70.0,5.89,64.11,1407.71,testing,115,3
44,1407.71,70.0,5.63,64.37,1343.34,testing,115,3
45,1343.34,70.0,5.37,64.63,1278.71,testing,115,3
46,1278.71,70.0,5.11,64.89,1213.82,testing,115,3
47,1213.82,70.0,4.86,65.14,1148.68,testing,115,3
48,1148.68,70.0,4.59,65.41,1083.27,testing,115,3
49,1083.27,70.0,4.33,65.67,1017.6,testing,115,3
50,1017.6,70.0,4.07,65.93,951.67,testing,115,3
51,951.67,70.0,3.81,66.19,885.48,testing,115,3
52,885.48,70.0,3.54,66.46,819.02,testing,115,3
53,819.02,70.0,3.28,66.72,752.3,testing,115,3
54,752.3,70.0,3.01,66.99,685.31,testing,115,3
55,685.31,70.0,2.74,67.26,618.05,testing,115,3
56,618.05,70.0,2.47,67.53,550.52,testing,115,3
57,550.52,70.0,2.2,67.8,482.72,testing,115,3
58,482.72,70.0,1.93,68.07,414.65,testing,115,3
59,414.65,70.0,1.66,68.34,346.31,testing,115,3
60,346.31,70.0,1.39,68.61,277.7,testing,115,3
61,277.7,70.0,1.11,68.89,208.81,testing,115,3
62,208.81,70.0,0.84,69.16,139.65,testing,115,3
63,139.65,70.0,0.56,69.44,70.21,testing,115,3
64,70.21,70.0,0.28,69.72,0.49,testing,115,3
65,0.49,70.0,0.0,70.0,-69.51,testing,115,3
0,5000.0,333.0,36.0,297.0,4703.0,Car,115,4
1,4703.0,333.0,33.86,299.14,4403.86,Car,115,4
2,4403.86,333.0,31.71,301.29,4102.57,Car,115,4
3,4102.57,333.0,29.54,303.46,3799.11,Car,115,4
4,3799.11,333.0,27.35,305.65,3493.46,Car,115,4
5,3493.46,333.0,25.15,307.85,3185.61,Car,115,4
6,3185.61,333.0,22.94,310.06,2875.55,Car,115,4
7,2875.55,333.0,20.7,312.3,2563.25,Car,115,4
8,2563.25,333.0,18.46,314.54,2248.71,Car,115,4
9,2248.71,333.0,16.19,316.81,1931.9,Car,115,4
10,1931.9,333.0,13.91,319.09,1612.81,Car,115,4
11,1612.81,333.0,11.61,321.39,1291.42,Car,115,4
12,1291.42,333.0,9.3,323.7,967.72,Car,115,4
13,967.72,333.0,6.97,326.03,641.69,Car,115,4
14,641.69,333.0,4.62,328.38,313.31,Car,115,4
15,313.31,333.0,2.26,330.74,-17.43,Car,115,4
0,8250.57,84.62,53.63,30.99,8219.58,WellsFargo1,115,5
1,8219.58,84.62,53.43,31.19,8188.39,WellsFargo1,115,5
2,8188.39,84.62,53.22,31.4,8156.99,WellsFargo1,115,5
3,8156.99,84.62,53.02,31.6,8125.39,WellsFargo1,115,5
4,8125.39,84.62,52.82,31.8,8093.59,WellsFargo1,115,5
5,8093.59,84.62,52.61,32.01,8061.58,WellsFargo1,115,5
6,8061.58,84.62,52.4,32.22,8029.36,WellsFargo1,115,5
7,8029.36,84.62,52.19,32.43,7996.93,WellsFargo1,115,5
8,7996.93,84.62,51.98,32.64,7964.29,WellsFargo1,115,5
9,7964.29,84.62,51.77,32.85,7931.44,WellsFargo1,115,5
10,7931.44,84.62,51.55,33.07,7898.37,WellsFargo1,115,5
11,7898.37,84.62,51.34,33.28,7865.09,WellsFargo1,115,5
12,7865.09,84.62,51.12,33.5,7831.59,WellsFargo1,115,5
13,7831.59,84.62,50.91,33.71,7797.88,WellsFargo1,115,5
14,7797.88,84.62,50.69,33.93,7763.95,WellsFargo1,115,5
15,7763.95,102.05,50.47,51.58,7712.37,WellsFargo1,115,5
16,7712.37,3010.1,50.13,2959.97,4752.4,WellsFargo1,115,5
17,4752.4,3010.1,30.89,2979.21,1773.19,WellsFargo1,115,5
18,1773.19,3010.1,11.53,2998.57,-1225.38,WellsFargo1,115,5
0,180000.0,2331.44,594.0,1737.44,178262.56,mortgage,116,1
1,178262.56,2331.44,588.27,1743.17,176519.39,mortgage,116,1
2,176519.39,2331.44,582.51,1748.93,174770.46,mortgage,116,1
3,174770.46,2331.44,576.74,1754.7,173015.76,mortgage,116,1
4,173015.76,2331.44,570.95,1760.49,171255.27,mortgage,116,1
5,171255.27,2331.44,565.14,1766.3,169488.97,mortgage,116,1
6,169488.97,2331.44,559.31,1772.13,167716.84,mortgage,116,1
7,167716.84,2331.44,553.47,1777.97,165938.87,mortgage,116,1
8,165938.87,2331.44,547.6,1783.84,164155.03,mortgage,116,1
9,164155.03,2331.44,541.71,1789.73,162365.3,mortgage,116,1
10,162365.3,2331.44,535.81,1795.63,160569.67,mortgage,116,1
11,160569.67,2331.44,529.88,1801.56,158768.11,mortgage,116,1
12,158768.11,2331.44,523.93,1807.51,156960.6,mortgage,116,1
13,156960.6,2331.44,517.97,1813.47,155147.13,mortgage,116,1
14,155147.13,2331.44,511.99,1819.45,153327.68,mortgage,116,1
15,153327.68,2331.44,505.98,1825.46,151502.22,mortgage,116,1
16,151502.22,2331.44,499.96,1831.48,149670.74,mortgage,116,1
17,149670.74,2331.44,493.91,1837.53,147833.21,mortgage,116,1
18,147833.21,2331.44,487.85,1843.59,145989.62,mortgage,116,1
19,145989.62,2331.44,481.77,1849.67,144139.95,mortgage,116,1
20,144139.95,2331.44,475.66,1855.78,142284.17,mortgage,116,1
21,142284.17,2331.44,469.54,1861.9,140422.27,mortgage,116,1
22,140422.27,2331.44,463.39,1868.05,138554.22,mortgage,116,1
23,138554.22,2331.44,457.23,1874.21,136680.01,mortgage,116,1
24,136680.01,2331.44,451.04,1880.4,134799.61,mortgage,116,1
25,134799.61,2331.44,444.84,1886.6,132913.01,mortgage,116,1
26,132913.01,2331.44,438.61,1892.83,131020.18,mortgage,116,1
27,131020.18,2331.44,432.37,1899.07,129121.11,mortgage,116,1
28,129121.11,2331.44,426.1,1905.34,127215.77,mortgage,116,1
29,127215.77,2331.44,419.81,1911.63,125304.14,mortgage,116,1
30,125304.14,2331.44,413.5,1917.94,123386.2,mortgage,116,1
31,123386.2,2331.44,407.17,1924.27,121461.93,mortgage,116,1
32,121461.93,2331.44,400.82,1930.62,119531.31,mortgage,116,1
33,119531.31,2331.44,394.45,1936.99,117594.32,mortgage,116,1
34,117594.32,2331.44,388.06,1943.38,115650.94,mortgage,116,1
35,115650.94,2331.44,381.65,1949.79,113701.15,mortgage,116,1
36,113701.15,2331.44,375.21,1956.23,111744.92,mortgage,116,1
37,111744.92,2331.44,368.76,1962.68,109782.24,mortgage,116,1
38,109782.24,2331.44,362.28,1969.16,107813.08,mortgage,116,1
39,107813.08,2331.44,355.78,1975.66,105837.42,mortgage,116,1
40,105837.42,2331.44,349.26,1982.18,103855.24,mortgage,116,1
41,103855.24,2331.44,342.72,1988.72,101866.52,mortgage,116,1
42,101866.52,2331.44,336.16,1995.28,99871.24,mortgage,116,1
43,99871.24,2331.44,329.58,2001.86,97869.38,mortgage,116,1
44,97869.38,2331.44,322.97,2008.47,95860.91,mortgage,116,1
45,95860.91,2331.44,316.34,2015.1,93845.81,mortgage,116,1
46,93845.81,2331.44,309.69,2021.75,91824.06,mortgage,116,1
47,91824.06,2331.44,303.02,2028.42,89795.64,mortgage,116,1
48,89795.64,2331.44,296.33,2035.11,87760.53,mortgage,116,1
49,87760.53,2331.44,289.61,2041.83,85718.7,mortgage,116,1
50,85718.7,2331.44,282.87,2048.57,83670.13,mortgage,116,1
51,83670.13,2331.44,276.11,2055.33,81614.8,mortgage,116,1
52,81614.8,2331.44,269.33,2062.11,79552.69,mortgage,116,1
53,79552.69,2331.44,262.52,2068.92,77483.77,mortgage,116,1
54,77483.77,2331.44,255.7,2075.74,75408.03,mortgage,116,1
55,75408.03,2331.44,248.85,2082.59,73325.44,mortgage,116,1
56,73325.44,2331.44,241.97,2089.47,71235.97,mortgage,116,1
57,71235.97,2331.44,235.08,2096.36,69139.61,mortgage,116,1
58,69139.61,2331.44,228.16,2103.28,67036.33,mortgage,116,1
59,67036.33,2331.44,221.22,2110.22,64926.11,mortgage,116,1
60,64926.11,2331.44,214.26,2117.18,62808.93,mortgage,116,1
61,62808.93,2331.44,207.27,2124.17,60684.76,mortgage,116,1
62,60684.76,2331.44,200.26,2131.18,58553.58,mortgage,116,1
63,58553.58,2331.44,193.23,2138.21,56415.37,mortgage,116,1
64,56415.37,2331.44,186.17,2145.27,54270.1,mortgage,116,1
65,54270.1,2331.44,179.09,2152.35,52117.75,mortgage,116,1
66,52117.75,2331.44,171.99,2159.45,49958.3,mortgage,116,1
67,49958.3,2331.44,164.86,2166.58,47791.72,mortgage,116,1
68,47791.72,2331.44,157.71,2173.73,45617.99,mortgage,116,1
69,45617.99,2331.44,150.54,2180.9,43437.09,mortgage,116,1
70,43437.09,2331.44,143.34,2188.1,41248.99,mortgage,116,1
71,41248.99,2331.44,136.12,2195.32,39053.67,mortgage,116,1
72,39053.67,2331.44,128.88,2202.56,36851.11,mortgage,116,1
73,36851.11,2331.44,121.61,2209.83,34641.28,mortgage,116,1
74,34641.28,2331.44,114.32,2217.12,32424.16,mortgage,116,1
75,32424.16,2331.44,107.0,2224.44,30199.72,mortgage,116,1
76,30199.72,2331.44,99.66,2231.78,27967.94,mortgage,116,1
77,27967.94,2331.44,92.29,2239.15,25728.79,mortgage,116,1
78,25728.79,2331.44,84.91,2246.53,23482.26,mortgage,116,1
79,23482.26,2331.44,77.49,2253.95,21228.31,mortgage,116,1
80,21228.31,2331.44,70.05,2261.39,18966.92,mortgage,116,1
81,18966.92,2331.44,62.59,2268.85,16698.07,mortgage,116,1
82,16698.07,2331.44,55.1,2276.34,14421.73,mortgage,116,1
83,14421.73,2331.44,47.59,2283.85,12137.88,mortgage,116,1
84,12137.88,2331.44,40.06,2291.38,9846.5,mortgage,116,1
85,9846.5,2331.44,32.49,2298.95,7547.55,mortgage,116,1
86,7547.55,2331.44,24.91,2306.53,5241.02,mortgage,116,1
87,5241.02,2331.44,17.3,2314.14,2926.88,mortgage,116,1
88,2926.88,2331.44,9.66,2321.78,605.1,mortgage,116,1
89,605.1,2331.44,2.0,2329.44,-1724.34,mortgage,116,1
0,20000.0,191.04,108.0,83.04,19916.96,WellsFargo2,116,2
1,19916.96,191.04,107.55,83.49,19833.47,WellsFargo2,116,2
2,19833.47,191.04,107.1,83.94,19749.53,WellsFargo2,116,2
3,19749.53,191.04,106.65,84.39,19665.14,WellsFargo2,116,2
4,19665.14,191.04,106.19,84.85,19580.29,WellsFargo2,116,2
5,19580.29,191.04,105.73,85.31,19494.98,WellsFargo2,116,2
6,19494.98,191.04,105.27,85.77,19409.21,WellsFargo2,116,2
7,19409.21,191.04,104.81,86.23,19322.98,WellsFargo2,116,2
8,19322.98,191.04,104.34,86.7,19236.28,WellsFargo2,116,2
9,19236.28,191.04,103.88,87.16,19149.12,WellsFargo2,116,2
10,19149.12,191.04,103.41,87.63,19061.49,WellsFargo2,116,2
11,19061.49,191.04,102.93,88.11,18973.38,WellsFargo2,116,2
12,18973.38,191.04,102.46,88.58,18884.8,WellsFargo2,116,2
13,18884.8,191.04,101.98,89.06,18795.74,WellsFargo2,116,2
14,18795.74,191.04,101.5,89.54,18706.2,WellsFargo2,116,2
15,18706.2,191.04,101.01,90.03,18616.17,WellsFargo2,116,2
16,18616.17,191.04,100.53,90.51,18525.66,WellsFargo2,116,2
17,18525.66,191.04,100.04,91.0,18434.66,WellsFargo2,116,2
18,18434.66,191.04,99.55,91.49,18343.17,WellsFargo2,116,2
19,18343.17,191.04,99.05,91.99,18251.18,WellsFargo2,116,2
20,18251.18,191.04,98.56,92.48,18158.7,WellsFargo2,116,2
21,18158.7,191.04,98.06,92.98,18065.72,WellsFargo2,116,2
22,18065.72,191.04,97.55,93.49,17972.23,WellsFargo2,116,2
23,17972.23,191.04,97.05,93.99,17878.24,WellsFargo2,116,2
24,17878.24,191.04,96.54,94.5,17783.74,WellsFargo2,116,2
25,17783.74,191.04,96.03,95.01,17688.73,WellsFargo2,116,2
26,17688.73,191.04,95.52,95.52,17593.21,WellsFargo2,116,2
27,17593.21,191.04,95.0,96.04,17497.17,WellsFargo2,116,2
28,17497.17,191.04,94.48,96.56,17400.61,WellsFargo2,116,2
29,17400.61,191.04,93.96,97.08,17303.53,WellsFargo2,116,2
30,17303.53,191.04,93.44,97.6,17205.93,WellsFargo2,116,2
31,17205.93,191.04,92.91,98.13,17107.8,WellsFargo2,116,2
32,17107.8,191.04,92.38,98.66,17009.14,WellsFargo2,116,2
33,17009.14,191.04,91.85,99.19,16909.95,WellsFargo2,116,2
34,16909.95,191.04,91.31,99.73,16810.22,WellsFargo2,116,2
35,16810.22,191.04,90.78,100.26,16709.96,WellsFargo2,116,2
36,16709.96,191.04,90.23,100.81,16609.15,WellsFargo2,116,2
37,16609.15,191.04,89.69,101.35,16507.8,WellsFargo2,116,2
38,16507.8,191.04,89.14,101.9,16405.9,WellsFargo2,116,2
39,16405.9,191.04,88.59,102.45,16303.45,WellsFargo2,116,2
40,16303.45,191.04,88.04,103.0,16200.45,WellsFargo2,116,2
41,16200.45,191.04,87.48,103.56,16096.89,WellsFargo2,116,2
42,16096.89,191.04,86.92,104.12,15992.77,WellsFargo2,116,2
43,15992.77,191.04,86.36,104.68,15888.09,WellsFargo2,116,2
44,15888.09,191.04,85.8,105.24,15782.85,WellsFargo2,116,2
45,15782.85,191.04,85.23,105.81,15677.04,WellsFargo2,116,2
46,15677.04,191.04,84.66,106.38,15570.66,WellsFargo2,116,2
47,15570.66,191.04,84.08,106.96,15463.7,WellsFargo2,116,2
48,15463.7,191.04,83.5,107.54,15356.16,WellsFargo2,116,2
49,15356.16,191.04,82.92,108.12,15248.04,WellsFargo2,116,2
50,15248.04,191.04,82.34,108.7,15139.34,WellsFargo2,116,2
51,15139.34,191.04,81.75,109.29,15030.05,WellsFargo2,116,2
52,15030.05,191.04,81.16,109.88,14920.17,WellsFargo2,116,2
53,14920.17,191.04,80.57,110.47,14809.7,WellsFargo2,116,2
54,14809.7,191.04,79.97,111.07,14698.63,WellsFargo2,116,2
55,14698.63,191.04,79.37,111.67,14586.96,WellsFargo2,116,2
56,14586.96,191.04,78.77,112.27,14474.69,WellsFargo2,116,2
57,14474.69,191.04,78.16,112.88,14361.81,WellsFargo2,116,2
58,14361.81,191.04,77.55,113.49,14248.32,WellsFargo2,116,2
59,14248.32,191.04,76.94,114.1,14134.22,WellsFargo2,116,2
60,14134.22,191.04,76.32,114.72,14019.5,WellsFargo2,116,2
61,14019.5,191.04,75.71,115.33,13904.17,WellsFargo2,116,2
62,13904.17,191.04,75.08,115.96,13788.21,WellsFargo2,116,2
63,13788.21,191.04,74.46,116.58,13671.63,WellsFargo2,116,2
64,13671.63,191.04,73.83,117.21,13554.42,WellsFargo2,116,2
65,13554.42,191.04,73.19,117.85,13436.57,WellsFargo2,116,2
66,13436.57,191.04,72.56,118.48,13318.09,WellsFargo2,116,2
67,13318.09,191.04,71.92,119.12,13198.97,WellsFargo2,116,2
68,13198.97,191.04,71.27,119.77,13079.2,WellsFargo2,116,2
69,13079.2,191.04,70.63,120.41,12958.79,WellsFargo2,116,2
70,12958.79,191.04,69.98,121.06,12837.73,WellsFargo2,116,2
71,12837.73,191.04,69.32,121.72,12716.01,WellsFargo2,116,2
72,12716.01,191.04,68.67,122.37,12593.64,WellsFargo2,116,2
73,12593.64,191.04,68.01,123.03,12470.61,WellsFargo2,116,2
74,12470.61,191.04,67.34,123.7,12346.91,WellsFargo2,116,2
75,12346.91,191.04,66.67,124.37,12222.54,WellsFargo2,116,2
76,12222.54,191.04,66.0,125.04,12097.5,WellsFargo2,116,2
77,12097.5,191.04,65.33,125.71,11971.79,WellsFargo2,116,2
78,11971.79,191.04,64.65,126.39,11845.4,WellsFargo2,116,2
79,11845.4,191.04,63.97,127.07,11718.33,WellsFargo2,116,2
80,11718.33,191.04,63.28,127.76,11590.57,WellsFargo2,116,2
81,11590.57,191.04,62.59,128.45,11462.12,WellsFargo2,116,2
82,11462.12,191.04,61.9,129.14,11332.98,WellsFargo2,116,2
83,11332.98,191.04,61.2,129.84,11203.14,WellsFargo2,116,2
84,11203.14,191.04,60.5,130.54,11072.6,WellsFargo2,116,2
85,11072.6,191.04,59.79,131.25,10941.35,WellsFargo2,116,2
86,10941.35,191.04,59.08,131.96,10809.39,WellsFargo2,116,2
87,10809.39,191.04,58.37,132.67,10676.72,WellsFargo2,116,2
88,10676.72,191.04,57.65,133.39,10543.33,WellsFargo2,116,2
89,10543.33,1915.38,56.93,1858.45,8684.88,WellsFargo2,116,2
90,8684.88,2522.48,46.9,2475.58,6209.3,WellsFargo2,116,2
91,6209.3,2522.48,33.53,2488.95,3720.35,WellsFargo2,116,2
92,3720.35,2522.48,20.09,2502.39,1217.96,WellsFargo2,116,2
93,1217.96,2522.48,6.58,2515.9,-1297.94,WellsFargo2,116,2
0,4000.0,70.0,16.0,54.0,3946.0,testing,116,3
1,3946.0,70.0,15.78,54.22,3891.78,testing,116,3
2,3891.78,70.0,15.57,54.43,3837.35,testing,116,3
3,3837.35,70.0,15.35,54.65,3782.7,testing,116,3
4,3782.7,70.0,15.13,54.87,3727.83,testing,116,3
5,3727.83,70.0,14.91,55.09,3672.74,testing,116,3
6,3672.74,70.0,14.69,55.31,3617.43,testing,116,3
7,3617.43,70.0,14.47,55.53,3561.9,testing,116,3
8,3561.9,70.0,14.25,55.75,3506.15,testing,116,3
9,3506.15,70.0,14.02,55.98,3450.17,testing,116,3
10,3450.17,70.0,13.8,56.2,3393.97,testing,116,3
11,3393.97,70.0,13.58,56.42,3337.55,testing,116,3
12,3337.55,70.0,13.35,56.65,3280.9,testing,116,3
13,3280.9,70.0,13.12,56.88,3224.02,testing,116,3
14,3224.02,70.0,12.9,57.1,3166.92,testing,116,3
15,3166.92,70.0,12.67,57.33,3109.59,testing,116,3
16,3109.59,70.0,12.44,57.56,3052.03,testing,116,3
17,3052.03,70.0,12.21,57.79,2994.24,testing,116,3
18,2994.24,70.0,11.98,58.02,2936.22,testing,116,3
19,2936.22,70.0,11.74,58.26,2877.96,testing,116,3
20,2877.96,70.0,11.51,58.49,2819.47,testing,116,3
21,2819.47,70.0,11.28,58.72,2760.75,testing,116,3
22,2760.75,70.0,11.04,58.96,2701.79,testing,116,3
23,2701.79,70.0,10.81,59.19,2642.6,testing,116,3
24,2642.6,70.0,10.57,59.43,2583.17,testing,116,3
25,2583.17,70.0,10.33,59.67,2523.5,testing,116,3
26,2523.5,70.0,10.09,59.91,2463.59,testing,116,3
27,2463.59,70.0,9.85,60.15,2403.44,testing,116,3
28,2403.44,70.0,9.61,60.39,2343.05,testing,116,3
29,2343.05,70.0,9.37,60.63,2282.42,testing,116,3
30,2282.42,70.0,9.13,60.87,2221.55,testing,116,3
31,2221.55,70.0,8.89,61.11,2160.44,testing,116,3
32,2160.44,70.0,8.64,61.36,2099.08,testing,116,3
33,2099.08,70.0,8.4,61.6,2037.48,testing,116,3
34,2037.48,70.0,8.15,61.85,1975.63,testing,116,3
35,1975.63,70.0,7.9,62.1,1913.53,testing,116,3
36,1913.53,70.0,7.65,62.35,1851.18,testing,116,3
37,1851.18,70.0,7.4,62.6,1788.58,testing,116,3
38,1788.58,70.0,7.15,62.85,1725.73,testing,116,3
39,1725.73,70.0,6.9,63.1,1662.63,testing,116,3
40,1662.63,70.0,6.65,63.35,1599.28,testing,116,3
41,1599.28,70.0,6.4,63.6,1535.68,testing,116,3
42,1535.68,70.0,6.14,63.86,1471.82,testing,116,3
43,1471.82,70.0,5.89,64.11,1407.71,testing,116,3
44,1407.71,70.0,5.63,64.37,1343.34,testing,116,3
45,1343.34,70.0,5.37,64.63,1278.71,testing,116,3
46,1278.71,70.0,5.11,64.89,1213.82,testing,116,3
47,1213.82,70.0,4.86,65.14,1148.68,testing,116,3
48,1148.68,70.0,4.59,65.41,1083.27,testing,116,3
49,1083.27,70.0,4.33,65.67,1017.6,testing,116,3
50,1017.6,70.0,4.07,65.93,951.67,testing,116,3
51,951.67,70.0,3.81,66.19,885.48,testing,116,3
52,885.48,70.0,3.54,66.46,819.02,testing,116,3
53,819.02,70.0,3.28,66.72,752.3,testing,116,3
54,752.3,70.0,3.01,66.99,685.31,testing,116,3
55,685.31,70.0,2.74,67.26,618.05,testing,116,3
56,618.05,70.0,2.47,67.53,550.52,testing,116,3
57,550.52,70.0,2.2,67.8,482.72,testing,116,3
58,482.72,70.0,1.93,68.07,414.65,testing,116,3
59,414.65,70.0,1.66,68.34,346.31,testing,116,3
60,346.31,70.0,1.39,68.61,277.7,testing,116,3
61,277.7,70.0,1.11,68.89,208.81,testing,116,3
62,208.81,70.0,0.84,69.16,139.65,testing,116,3
63,139.65,70.0,0.56,69.44,70.21,testing,116,3
64,70.21,70.0,0.28,69.72,0.49,testing,116,3
65,0.49,70.0,0.0,70.0,-69.51,testing,116,3
0,8250.57,84.62,53.63,30.99,8219.58,WellsFargo1,116,4
1,8219.58,84.62,53.43,31.19,8188.39,WellsFargo1,116,4
2,8188.39,84.62,53.22,31.4,8156.99,WellsFargo1,116,4
3,8156.99,84.62,53.02,31.6,8125.39,WellsFargo1,116,4
4,8125.39,84.62,52.82,31.8,8093.59,WellsFargo1,116,4
5,8093.59,84.62,52.61,32.01,8061.58,WellsFargo1,116,4
6,8061.58,84.62,52.4,32.22,8029.36,WellsFargo1,116,4
7,8029.36,84.62,52.19,32.43,7996.93,WellsFargo1,116,4
8,7996.93,84.62,51.98,32.64,7964.29,WellsFargo1,116,4
9,7964.29,84.62,51.77,32.85,7931.44,WellsFargo1,116,4
10,7931.44,84.62,51.55,33.07,7898.37,WellsFargo1,116,4
11,7898.37,84.62,51.34,33.28,7865.09,WellsFargo1,116,4
12,7865.09,84.62,51.12,33.5,7831.59,WellsFargo1,116,4
13,7831.59,84.62,50.91,33.71,7797.88,WellsFargo1,116,4
14,7797.88,84.62,50.69,33.93,7763.95,WellsFargo1,116,4
15,7763.95,84.62,50.47,34.15,7729.8,WellsFargo1,116,4
16,7729.8,84.62,50.24,34.38,7695.42,WellsFargo1,116,4
17,7695.42,84.62,50.02,34.6,7660.82,WellsFargo1,116,4
18,7660.82,84.62,49.8,34.82,7626.0,WellsFargo1,116,4
19,7626.0,84.62,49.57,35.05,7590.95,WellsFargo1,116,4
20,7590.95,84.62,49.34,35.28,7555.67,WellsFargo1,116,4
21,7555.67,84.62,49.11,35.51,7520.16,WellsFargo1,116,4
22,7520.16,84.62,48.88,35.74,7484.42,WellsFargo1,116,4
23,7484.42,84.62,48.65,35.97,7448.45,WellsFargo1,116,4
24,7448.45,84.62,48.41,36.21,7412.24,WellsFargo1,116,4
25,7412.24,84.62,48.18,36.44,7375.8,WellsFargo1,116,4
26,7375.8,84.62,47.94,36.68,7339.12,WellsFargo1,116,4
27,7339.12,84.62,47.7,36.92,7302.2,WellsFargo1,116,4
28,7302.2,84.62,47.46,37.16,7265.04,WellsFargo1,116,4
29,7265.04,84.62,47.22,37.4,7227.64,WellsFargo1,116,4
30,7227.64,84.62,46.98,37.64,7190.0,WellsFargo1,116,4
31,7190.0,84.62,46.73,37.89,7152.11,WellsFargo1,116,4
32,7152.11,84.62,46.49,38.13,7113.98,WellsFargo1,116,4
33,7113.98,84.62,46.24,38.38,7075.6,WellsFargo1,116,4
34,7075.6,84.62,45.99,38.63,7036.97,WellsFargo1,116,4
35,7036.97,84.62,45.74,38.88,6998.09,WellsFargo1,116,4
36,6998.09,84.62,45.49,39.13,6958.96,WellsFargo1,116,4
37,6958.96,84.62,45.23,39.39,6919.57,WellsFargo1,116,4
38,6919.57,84.62,44.98,39.64,6879.93,WellsFargo1,116,4
39,6879.93,84.62,44.72,39.9,6840.03,WellsFargo1,116,4
40,6840.03,84.62,44.46,40.16,6799.87,WellsFargo1,116,4
41,6799.87,84.62,44.2,40.42,6759.45,WellsFargo1,116,4
42,6759.45,84.62,43.94,40.68,6718.77,WellsFargo1,116,4
43,6718.77,84.62,43.67,40.95,6677.82,WellsFargo1,116,4
44,6677.82,84.62,43.41,41.21,6636.61,WellsFargo1,116,4
45,6636.61,84.62,43.14,41.48,6595.13,WellsFargo1,116,4
46,6595.13,84.62,42.87,41.75,6553.38,WellsFargo1,116,4
47,6553.38,84.62,42.6,42.02,6511.36,WellsFargo1,116,4
48,6511.36,84.62,42.32,42.3,6469.06,WellsFargo1,116,4
49,6469.06,84.62,42.05,42.57,6426.49,WellsFargo1,116,4
50,6426.49,84.62,41.77,42.85,6383.64,WellsFargo1,116,4
51,6383.64,84.62,41.49,43.13,6340.51,WellsFargo1,116,4
52,6340.51,84.62,41.21,43.41,6297.1,WellsFargo1,116,4
53,6297.1,84.62,40.93,43.69,6253.41,WellsFargo1,116,4
54,6253.41,84.62,40.65,43.97,6209.44,WellsFargo1,116,4
55,6209.44,84.62,40.36,44.26,6165.18,WellsFargo1,116,4
56,6165.18,84.62,40.07,44.55,6120.63,WellsFargo1,116,4
57,6120.63,84.62,39.78,44.84,6075.79,WellsFargo1,116,4
58,6075.79,84.62,39.49,45.13,6030.66,WellsFargo1,116,4
59,6030.66,84.62,39.2,45.42,5985.24,WellsFargo1,116,4
60,5985.24,84.62,38.9,45.72,5939.52,WellsFargo1,116,4
61,5939.52,84.62,38.61,46.01,5893.51,WellsFargo1,116,4
62,5893.51,84.62,38.31,46.31,5847.2,WellsFargo1,116,4
63,5847.2,84.62,38.01,46.61,5800.59,WellsFargo1,116,4
64,5800.59,84.62,37.7,46.92,5753.67,WellsFargo1,116,4
65,5753.67,154.13,37.4,116.73,5636.94,WellsFargo1,116,4
66,5636.94,2677.1,36.64,2640.46,2996.48,WellsFargo1,116,4
67,2996.48,2677.1,19.48,2657.62,338.86,WellsFargo1,116,4
68,338.86,2677.1,2.2,2674.9,-2336.04,WellsFargo1,116,4
0,5000.0,333.0,36.0,297.0,4703.0,Car,116,5
1,4703.0,333.0,33.86,299.14,4403.86,Car,116,5
2,4403.86,333.0,31.71,301.29,4102.57,Car,116,5
3,4102.57,333.0,29.54,303.46,3799.11,Car,116,5
4,3799.11,333.0,27.35,305.65,3493.46,Car,116,5
5,3493.46,333.0,25.15,307.85,3185.61,Car,116,5
6,3185.61,333.0,22.94,310.06,2875.55,Car,116,5
7,2875.55,333.0,20.7,312.3,2563.25,Car,116,5
8,2563.25,333.0,18.46,314.54,2248.71,Car,116,5
9,2248.71,333.0,16.19,316.81,1931.9,Car,116,5
10,1931.9,333.0,13.91,319.09,1612.81,Car,116,5
11,1612.81,333.0,11.61,321.39,1291.42,Car,116,5
12,1291.42,333.0,9.3,323.7,967.72,Car,116,5
13,967.72,333.0,6.97,326.03,641.69,Car,116,5
14,641.69,333.0,4.62,328.38,313.31,Car,116,5
15,313.31,333.0,2.26,330.74,-17.43,Car,116,5
0,180000.0,2331.44,594.0,1737.44,178262.56,mortgage,117,1
1,178262.56,2331.44,588.27,1743.17,176519.39,mortgage,117,1
2,176519.39,2331.44,582.51,1748.93,174770.46,mortgage,117,1
3,174770.46,2331.44,576.74,1754.7,173015.76,mortgage,117,1
4,173015.76,2331.44,570.95,1760.49,171255.27,mortgage,117,1
5,171255.27,2331.44,565.14,1766.3,169488.97,mortgage,117,1
6,169488.97,2331.44,559.31,1772.13,167716.84,mortgage,117,1
7,167716.84,2331.44,553.47,1777.97,165938.87,mortgage,117,1
8,165938.87,2331.44,547.6,1783.84,164155.03,mortgage,117,1
9,164155.03,2331.44,541.71,1789.73,162365.3,mortgage,117,1
10,162365.3,2331.44,535.81,1795.63,160569.67,mortgage,117,1
11,160569.67,2331.44,529.88,1801.56,158768.11,mortgage,117,1
12,158768.11,2331.44,523.93,1807.51,156960.6,mortgage,117,1
13,156960.6,2331.44,517.97,1813.47,155147.13,mortgage,117,1
14,155147.13,2331.44,511.99,1819.45,153327.68,mortgage,117,1
15,153327.68,2331.44,505.98,1825.46,151502.22,mortgage,117,1
16,151502.22,2331.44,499.96,1831.48,149670.74,mortgage,117,1
17,149670.74,2331.44,493.91,1837.53,147833.21,mortgage,117,1
18,147833.21,2331.44,487.85,1843.59,145989.62,mortgage,117,1
19,145989.62,2331.44,481.77,1849.67,144139.95,mortgage,117,1
20,144139.95,2331.44,475.66,1855.78,142284.17,mortgage,117,1
21,142284.17,2331.44,469.54,1861.9,140422.27,mortgage,117,1
22,140422.27,2331.44,463.39,1868.05,138554.22,mortgage,117,1
23,138554.22,2331.44,457.23,1874.21,136680.01,mortgage,117,1
24,136680.01,2331.44,451.04,1880.4,134799.61,mortgage,117,1
25,134799.61,2331.44,444.84,1886.6,132913.01,mortgage,117,1
26,132913.01,2331.44,438.61,1892.83,131020.18,mortgage,117,1
27,131020.18,2331.44,432.37,1899.07,129121.11,mortgage,117,1
28,129121.11,2331.44,426.1,1905.34,127215.77,mortgage,117,1
29,127215.77,2331.44,419.81,1911.63,125304.14,mortgage,117,1
30,125304.14,2331.44,413.5,1917.94,123386.2,mortgage,117,1
31,123386.2,2331.44,407.17,1924.27,121461.93,mortgage,117,1
32,121461.93,2331.44,400.82,1930.62,119531.31,mortgage,117,1
33,119531.31,2331.44,394.45,1936.99,117594.32,mortgage,117,1
34,117594.32,2331.44,388.06,1943.38,115650.94,mortgage,117,1
35,115650.94,2331.44,381.65,1949.79,113701.15,mortgage,117,1
36,113701.15,2331.44,375.21,1956.23,111744.92,mortgage,117,1
37,111744.92,2331.44,368.76,1962.68,109782.24,mortgage,117,1
38,109782.24,2331.44,362.28,1969.16,107813.08,mortgage,117,1
39,107813.08,2331.44,355.78,1975.66,105837.42,mortgage,117,1
40,105837.42,2331.44,349.26,1982.18,103855.24,mortgage,117,1
41,103855.24,2331.44,342.72,1988.72,101866.52,mortgage,117,1
42,101866.52,2331.44,336.16,1995.28,99871.24,mortgage,117,1
43,99871.24,2331.44,329.58,2001.86,97869.38,mortgage,117,1
44,97869.38,2331.44,322.97,2008.47,95860.91,mortgage,117,1
45,95860.91,2331.44,316.34,2015.1,93845.81,mortgage,117,1
46,93845.81,2331.44,309.69,2021.75,91824.06,mortgage,117,1
47,91824.06,2331.44,303.02,2028.42,89795.64,mortgage,117,1
48,89795.64,2331.44,296.33,2035.11,87760.53,mortgage,117,1
49,87760.53,2331.44,289.61,2041.83,85718.7,mortgage,117,1
50,85718.7,2331.44,282.87,2048.57,83670.13,mortgage,117,1
51,83670.13,2331.44,276.11,2055.33,81614.8,mortgage,117,1
52,81614.8,2331.44,269.33,2062.11,79552.69,mortgage,117,1
53,79552.69,2331.44,262.52,2068.92,77483.77,mortgage,117,1
54,77483.77,2331.44,255.7,2075.74,75408.03,mortgage,117,1
55,75408.03,2331.44,248.85,2082.59,73325.44,mortgage,117,1
56,73325.44,2331.44,241.97,2089.47,71235.97,mortgage,117,1
57,71235.97,2331.44,235.08,2096.36,69139.61,mortgage,117,1
58,69139.61,2331.44,228.16,2103.28,67036.33,mortgage,117,1
59,67036.33,2331.44,221.22,2110.22,64926.11,mortgage,117,1
60,64926.11,2331.44,214.26,2117.18,62808.93,mortgage,117,1
61,62808.93,2331.44,207.27,2124.17,60684.76,mortgage,117,1
62,60684.76,2331.44,200.26,2131.18,58553.58,mortgage,117,1
63,58553.58,2331.44,193.23,2138.21,56415.37,mortgage,117,1
64,56415.37,2331.44,186.17,2145.27,54270.1,mortgage,117,1
65,54270.1,2331.44,179.09,2152.35,52117.75,mortgage,117,1
66,52117.75,2331.44,171.99,2159.45,49958.3,mortgage,117,1
67,49958.3,2331.44,164.86,2166.58,47791.72,mortgage,117,1
68,47791.72,2331.44,157.71,2173.73,45617.99,mortgage,117,1
69,45617.99,2331.44,150.54,2180.9,43437.09,mortgage,117,1
70,43437.09,2331.44,143.34,2188.1,41248.99,mortgage,117,1
71,41248.99,2331.44,136.12,2195.32,39053.67,mortgage,117,1
72,39053.67,2331.44,128.88,2202.56,36851.11,mortgage,117,1
73,36851.11,2331.44,121.61,2209.83,34641.28,mortgage,117,1
74,34641.28,2331.44,114.32,2217.12,32424.16,mortgage,117,1
75,32424.16,2331.44,107.0,2224.44,30199.72,mortgage,117,1
76,30199.72,2331.44,99.66,2231.78,27967.94,mortgage,117,1
77,27967.94,2331.44,92.29,2239.15,25728.79,mortgage,117,1
78,25728.79,2331.44,84.91,2246.53,23482.26,mortgage,117,1
79,23482.26,2331.44,77.49,2253.95,21228.31,mortgage,117,1
80,21228.31,2331.44,70.05,2261.39,18966.92,mortgage,117,1
81,18966.92,2331.44,62.59,2268.85,16698.07,mortgage,117,1
82,16698.07,2331.44,55.1,2276.34,14421.73,mortgage,117,1
83,14421.73,2331.44,47.59,2283.85,12137.88,mortgage,117,1
84,12137.88,2331.44,40.06,2291.38,9846.5,mortgage,117,1
85,9846.5,2331.44,32.49,2298.95,7547.55,mortgage,117,1
86,7547.55,2331.44,24.91,2306.53,5241.02,mortgage,117,1
87,5241.02,2331.44,17.3,2314.14,2926.88,mortgage,117,1
88,2926.88,2331.44,9.66,2321.78,605.1,mortgage,117,1
89,605.1,2331.44,2.0,2329.44,-1724.34,mortgage,117,1
0,20000.0,191.04,108.0,83.04,19916.96,WellsFargo2,117,2
1,19916.96,191.04,107.55,83.49,19833.47,WellsFargo2,117,2
2,19833.47,191.04,107.1,83.94,19749.53,WellsFargo2,117,2
3,19749.53,191.04,106.65,84.39,19665.14,WellsFargo2,117,2
4,19665.14,191.04,106.19,84.85,19580.29,WellsFargo2,117,2
5,19580.29,191.04,105.73,85.31,19494.98,WellsFargo2,117,2
6,19494.98,191.04,105.27,85.77,19409.21,WellsFargo2,117,2
7,19409.21,191.04,104.81,86.23,19322.98,WellsFargo2,117,2
8,19322.98,191.04,104.34,86.7,19236.28,WellsFargo2,117,2
9,19236.28,191.04,103.88,87.16,19149.12,WellsFargo2,117,2
10,19149.12,191.04,103.41,87.63,19061.49,WellsFargo2,117,2
11,19061.49,191.04,102.93,88.11,18973.38,WellsFargo2,117,2
12,18973.38,191.04,102.46,88.58,18884.8,WellsFargo2,117,2
13,18884.8,191.04,101.98,89.06,18795.74,WellsFargo2,117,2
14,18795.74,191.04,101.5,89.54,18706.2,WellsFargo2,117,2
15,18706.2,191.04,101.01,90.03,18616.17,WellsFargo2,117,2
16,18616.17,191.04,100.53,90.51,18525.66,WellsFargo2,117,2
17,18525.66,191.04,100.04,91.0,18434.66,WellsFargo2,117,2
18,18434.66,191.04,99.55,91.49,18343.17,WellsFargo2,117,2
19,18343.17,191.04,99.05,91.99,18251.18,WellsFargo2,117,2
20,18251.18,191.04,98.56,92.48,18158.7,WellsFargo2,117,2
21,18158.7,191.04,98.06,92.98,18065.72,WellsFargo2,117,2
22,18065.72,191.04,97.55,93.49,17972.23,WellsFargo2,117,2
23,17972.23,191.04,97.05,93.99,17878.24,WellsFargo2,117,2
24,17878.24,191.04,96.54,94.5,17783.74,WellsFargo2,117,2
25,17783.74,191.04,96.03,95.01,17688.73,WellsFargo2,117,2
26,17688.73,191.04,95.52,95.52,17593.21,WellsFargo2,117,2
27,17593.21,191.04,95.0,96.04,17497.17,WellsFargo2,117,2
28,17497.17,191.04,94.48,96.56,17400.61,WellsFargo2,117,2
29,17400.61,191.04,93.96,97.08,17303.53,WellsFargo2,117,2
30,17303.53,191.04,93.44,97.6,17205.93,WellsFargo2,117,2
31,17205.93,191.04,92.91,98.13,17107.8,WellsFargo2,117,2
32,17107.8,191.04,92.38,98.66,17009.14,WellsFargo2,117,2
33,17009.14,191.04,91.85,99.19,16909.95,WellsFargo2,117,2
34,16909.95,191.04,91.31,99.73,16810.22,WellsFargo2,117,2
35,16810.22,191.04,90.78,100.26,16709.96,WellsFargo2,117,2
36,16709.96,191.04,90.23,100.81,16609.15,WellsFargo2,117,2
37,16609.15,191.04,89.69,101.35,16507.8,WellsFargo2,117,2
38,16507.8,191.04,89.14,101.9,16405.9,WellsFargo2,117,2
39,16405.9,191.04,88.59,102.45,16303.45,WellsFargo2,117,2
40,16303.45,191.04,88.04,103.0,16200.45,WellsFargo2,117,2
41,16200.45,191.04,87.48,103.56,16096.89,WellsFargo2,117,2
42,16096.89,191.04,86.92,104.12,15992.77,WellsFargo2,117,2
43,15992.77,191.04,86.36,104.68,15888.09,WellsFargo2,117,2
44,15888.09,191.04,85.8,105.24,15782.85,WellsFargo2,117,2
45,15782.85,191.04,85.23,105.81,15677.04,WellsFargo2,117,2
46,15677.04,191.04,84.66,106.38,15570.66,WellsFargo2,117,2
47,15570.66,191.04,84.08,106.96,15463.7,WellsFargo2,117,2
48,15463.7,191.04,83.5,107.54,15356.16,WellsFargo2,117,2
49,15356.16,191.04,82.92,108.12,15248.04,WellsFargo2,117,2
50,15248.04,191.04,82.34,108.7,15139.34,WellsFargo2,117,2
51,15139.34,191.04,81.75,109.29,15030.05,WellsFargo2,117,2
52,15030.05,191.04,81.16,109.88,14920.17,WellsFargo2,117,2
53,14920.17,191.04,80.57,110.47,14809.7,WellsFargo2,117,2
54,14809.7,191.04,79.97,111.07,14698.63,WellsFargo2,117,2
55,14698.63,191.04,79.37,111.67,14586.96,WellsFargo2,117,2
56,14586.96,191.04,78.77,112.27,14474.69,WellsFargo2,117,2
57,14474.69,191.04,78.16,112.88,14361.81,WellsFargo2,117,2
58,14361.81,191.04,77.55,113.49,14248.32,WellsFargo2,117,2
59,14248.32,191.04,76.94,114.1,14134.22,WellsFargo2,117,2
60,14134.22,191.04,76.32,114.72,14019.5,WellsFargo2,117,2
61,14019.5,191.04,75.71,115.33,13904.17,WellsFargo2,117,2
62,13904.17,191.04,75.08,115.96,13788.21,WellsFargo2,117,2
63,13788.21,191.04,74.46,116.58,13671.63,WellsFargo2,117,2
64,13671.63,191.04,73.83,117.21,13554.42,WellsFargo2,117,2
65,13554.42,191.04,73.19,117.85,13436.57,WellsFargo2,117,2
66,13436.57,191.04,72.56,118.48,13318.09,WellsFargo2,117,2
67,13318.09,191.04,71.92,119.12,13198.97,WellsFargo2,117,2
68,13198.97,191.04,71.27,119.77,13079.2,WellsFargo2,117,2
69,13079.2,191.04,70.63,120.41,12958.79,WellsFargo2,117,2
70,12958.79,191.04,69.98,121.06,12837.73,WellsFargo2,117,2
71,12837.73,191.04,69.32,121.72,12716.01,WellsFargo2,117,2
72,12716.01,191.04,68.67,122.37,12593.64,WellsFargo2,117,2
73,12593.64,191.04,68.01,123.03,12470.61,WellsFargo2,117,2
74,12470.61,191.04,67.34,123.7,12346.91,WellsFargo2,117,2
75,12346.91,191.04,66.67,124.37,12222.54,WellsFargo2,117,2
76,12222.54,191.04,66.0,125.04,12097.5,WellsFargo2,117,2
77,12097.5,191.04,65.33,125.71,11971.79,WellsFargo2,117,2
78,11971.79,191.04,64.65,126.39,11845.4,WellsFargo2,117,2
79,11845.4,191.04,63.97,127.07,11718.33,WellsFargo2,117,2
80,11718.33,191.04,63.28,127.76,11590.57,WellsFargo2,117,2
81,11590.57,191.04,62.59,128.45,11462.12,WellsFargo2,117,2
82,11462.12,191.04,61.9,129.14,11332.98,WellsFargo2,117,2
83,11332.98,191.04,61.2,129.84,11203.14,WellsFargo2,117,2
84,11203.14,191.04,60.5,130.54,11072.6,WellsFargo2,117,2
85,11072.6,191.04,59.79,131.25,10941.35,WellsFargo2,117,2
86,10941.35,191.04,59.08,131.96,10809.39,WellsFargo2,117,2
87,10809.39,191.04,58.37,132.67,10676.72,WellsFargo2,117,2
88,10676.72,191.04,57.65,133.39,10543.33,WellsFargo2,117,2
89,10543.33,1915.38,56.93,1858.45,8684.88,WellsFargo2,117,2
90,8684.88,2522.48,46.9,2475.58,6209.3,WellsFargo2,117,2
91,6209.3,2522.48,33.53,2488.95,3720.35,WellsFargo2,117,2
92,3720.35,2522.48,20.09,2502.39,1217.96,WellsFargo2,117,2
93,1217.96,2522.48,6.58,2515.9,-1297.94,WellsFargo2,117,2
0,5000.0,333.0,36.0,297.0,4703.0,Car,117,3
1,4703.0,333.0,33.86,299.14,4403.86,Car,117,3
2,4403.86,333.0,31.71,301.29,4102.57,Car,117,3
3,4102.57,333.0,29.54,303.46,3799.11,Car,117,3
4,3799.11,333.0,27.35,305.65,3493.46,Car,117,3
5,3493.46,333.0,25.15,307.85,3185.61,Car,117,3
6,3185.61,333.0,22.94,310.06,2875.55,Car,117,3
7,2875.55,333.0,20.7,312.3,2563.25,Car,117,3
8,2563.25,333.0,18.46,314.54,2248.71,Car,117,3
9,2248.71,333.0,16.19,316.81,1931.9,Car,117,3
10,1931.9,333.0,13.91,319.09,1612.81,Car,117,3
11,1612.81,333.0,11.61,321.39,1291.42,Car,117,3
12,1291.42,333.0,9.3,323.7,967.72,Car,117,3
13,967.72,333.0,6.97,326.03,641.69,Car,117,3
14,641.69,333.0,4.62,328.38,313.31,Car,117,3
15,313.31,333.0,2.26,330.74,-17.43,Car,117,3
0,4000.0,70.0,16.0,54.0,3946.0,testing,117,4
1,3946.0,70.0,15.78,54.22,3891.78,testing,117,4
2,3891.78,70.0,15.57,54.43,3837.35,testing,117,4
3,3837.35,70.0,15.35,54.65,3782.7,testing,117,4
4,3782.7,70.0,15.13,54.87,3727.83,testing,117,4
5,3727.83,70.0,14.91,55.09,3672.74,testing,117,4
6,3672.74,70.0,14.69,55.31,3617.43,testing,117,4
7,3617.43,70.0,14.47,55.53,3561.9,testing,117,4
8,3561.9,70.0,14.25,55.75,3506.15,testing,117,4
9,3506.15,70.0,14.02,55.98,3450.17,testing,117,4
10,3450.17,70.0,13.8,56.2,3393.97,testing,117,4
11,3393.97,70.0,13.58,56.42,3337.55,testing,117,4
12,3337.55,70.0,13.35,56.65,3280.9,testing,117,4
13,3280.9,70.0,13.12,56.88,3224.02,testing,117,4
14,3224.02,70.0,12.9,57.1,3166.92,testing,117,4
15,3166.92,87.43,12.67,74.76,3092.16,testing,117,4
16,3092.16,2925.48,12.37,2913.11,179.05,testing,117,4
17,179.05,2925.48,0.72,2924.76,-2745.71,testing,117,4
0,8250.57,84.62,53.63,30.99,8219.58,WellsFargo1,117,5
1,8219.58,84.62,53.43,31.19,8188.39,WellsFargo1,117,5
2,8188.39,84.62,53.22,31.4,8156.99,WellsFargo1,117,5
3,8156.99,84.62,53.02,31.6,8125.39,WellsFargo1,117,5
4,8125.39,84.62,52.82,31.8,8093.59,WellsFargo1,117,5
5,8093.59,84.62,52.61,32.01,8061.58,WellsFargo1,117,5
6,8061.58,84.62,52.4,32.22,8029.36,WellsFargo1,117,5
7,8029.36,84.62,52.19,32.43,7996.93,WellsFargo1,117,5
8,7996.93,84.62,51.98,32.64,7964.29,WellsFargo1,117,5
9,7964.29,84.62,51.77,32.85,7931.44,WellsFargo1,117,5
10,7931.44,84.62,51.55,33.07,7898.37,WellsFargo1,117,5
11,7898.37,84.62,51.34,33.28,7865.09,WellsFargo1,117,5
12,7865.09,84.62,51.12,33.5,7831.59,WellsFargo1,117,5
13,7831.59,84.62,50.91,33.71,7797.88,WellsFargo1,117,5
14,7797.88,84.62,50.69,33.93,7763.95,WellsFargo1,117,5
15,7763.95,84.62,50.47,34.15,7729.8,WellsFargo1,117,5
16,7729.8,84.62,50.24,34.38,7695.42,WellsFargo1,117,5
17,7695.42,2830.33,50.02,2780.31,4915.11,WellsFargo1,117,5
18,4915.11,3010.1,31.95,2978.15,1936.96,WellsFargo1,117,5
19,1936.96,3010.1,12.59,2997.51,-1060.55,WellsFargo1,117,5
0,180000.0,2331.44,594.0,1737.44,178262.56,mortgage,118,1
1,178262.56,2331.44,588.27,1743.17,176519.39,mortgage,118,1
2,176519.39,2331.44,582.51,1748.93,174770.46,mortgage,118,1
3,174770.46,2331.44,576.74,1754.7,173015.76,mortgage,118,1
4,173015.76,2331.44,570.95,1760.49,171255.27,mortgage,118,1
5,171255.27,2331.44,565.14,1766.3,169488.97,mortgage,118,1
6,169488.97,2331.44,559.31,1772.13,167716.84,mortgage,118,1
7,167716.84,2331.44,553.47,1777.97,165938.87,mortgage,118,1
8,165938.87,2331.44,547.6,1783.84,164155.03,mortgage,118,1
9,164155.03,2331.44,541.71,1789.73,162365.3,mortgage,118,1
10,162365.3,2331.44,535.81,1795.63,160569.67,mortgage,118,1
11,160569.67,2331.44,529.88,1801.56,158768.11,mortgage,118,1
12,158768.11,2331.44,523.93,1807.51,156960.6,mortgage,118,1
13,156960.6,2331.44,517.97,1813.47,155147.13,mortgage,118,1
14,155147.13,2331.44,511.99,1819.45,153327.68,mortgage,118,1
15,153327.68,2331.44,505.98,1825.46,151502.22,mortgage,118,1
16,151502.22,2331.44,499.96,1831.48,149670.74,mortgage,118,1
17,149670.74,2331.44,493.91,1837.53,147833.21,mortgage,118,1
18,147833.21,2331.44,487.85,1843.59,145989.62,mortgage,118,1
19,145989.62,2331.44,481.77,1849.67,144139.95,mortgage,118,1
20,144139.95,2331.44,475.66,1855.78,142284.17,mortgage,118,1
21,142284.17,2331.44,469.54,1861.9,140422.27,mortgage,118,1
22,140422.27,2331.44,463.39,1868.05,138554.22,mortgage,118,1
23,138554.22,2331.44,457.23,1874.21,136680.01,mortgage,118,1
24,136680.01,2331.44,451.04,1880.4,134799.61,mortgage,118,1
25,134799.61,2331.44,444.84,1886.6,132913.01,mortgage,118,1
26,132913.01,2331.44,438.61,1892.83,131020.18,mortgage,118,1
27,131020.18,2331.44,432.37,1899.07,129121.11,mortgage,118,1
28,129121.11,2331.44,426.1,1905.34,127215.77,mortgage,118,1
29,127215.77,2331.44,419.81,1911.63,125304.14,mortgage,118,1
30,125304.14,2331.44,413.5,1917.94,123386.2,mortgage,118,1
31,123386.2,2331.44,407.17,1924.27,121461.93,mortgage,118,1
32,121461.93,2331.44,400.82,1930.62,119531.31,mortgage,118,1
33,119531.31,2331.44,394.45,1936.99,117594.32,mortgage,118,1
34,117594.32,2331.44,388.06,1943.38,115650.94,mortgage,118,1
35,115650.94,2331.44,381.65,1949.79,113701.15,mortgage,118,1
36,113701.15,2331.44,375.21,1956.23,111744.92,mortgage,118,1
37,111744.92,2331.44,368.76,1962.68,109782.24,mortgage,118,1
38,109782.24,2331.44,362.28,1969.16,107813.08,mortgage,118,1
39,107813.08,2331.44,355.78,1975.66,105837.42,mortgage,118,1
40,105837.42,2331.44,349.26,1982.18,103855.24,mortgage,118,1
41,103855.24,2331.44,342.72,1988.72,101866.52,mortgage,118,1
42,101866.52,2331.44,336.16,1995.28,99871.24,mortgage,118,1
43,99871.24,2331.44,329.58,2001.86,97869.38,mortgage,118,1
44,97869.38,2331.44,322.97,2008.47,95860.91,mortgage,118,1
45,95860.91,2331.44,316.34,2015.1,93845.81,mortgage,118,1
46,93845.81,2331.44,309.69,2021.75,91824.06,mortgage,118,1
47,91824.06,2331.44,303.02,2028.42,89795.64,mortgage,118,1
48,89795.64,2331.44,296.33,2035.11,87760.53,mortgage,118,1
49,87760.53,2331.44,289.61,2041.83,85718.7,mortgage,118,1
50,85718.7,2331.44,282.87,2048.57,83670.13,mortgage,118,1
51,83670.13,2331.44,276.11,2055.33,81614.8,mortgage,118,1
52,81614.8,2331.44,269.33,2062.11,79552.69,mortgage,118,1
53,79552.69,2331.44,262.52,2068.92,77483.77,mortgage,118,1
54,77483.77,2331.44,255.7,2075.74,75408.03,mortgage,118,1
55,75408.03,2331.44,248.85,2082.59,73325.44,mortgage,118,1
56,73325.44,2331.44,241.97,2089.47,71235.97,mortgage,118,1
57,71235.97,2331.44,235.08,2096.36,69139.61,mortgage,118,1
58,69139.61,2331.44,228.16,2103.28,67036.33,mortgage,118,1
59,67036.33,2331.44,221.22,2110.22,64926.11,mortgage,118,1
60,64926.11,2331.44,214.26,2117.18,62808.93,mortgage,118,1
61,62808.93,2331.44,207.27,2124.17,60684.76,mortgage,118,1
62,60684.76,2331.44,200.26,2131.18,58553.58,mortgage,118,1
63,58553.58,2331.44,193.23,2138.21,56415.37,mortgage,118,1
64,56415.37,2331.44,186.17,2145.27,54270.1,mortgage,118,1
65,54270.1,2331.44,179.09,2152.35,52117.75,mortgage,118,1
66,52117.75,2331.44,171.99,2159.45,49958.3,mortgage,118,1
67,49958.3,2331.44,164.86,2166.58,47791.72,mortgage,118,1
68,47791.72,2331.44,157.71,2173.73,45617.99,mortgage,118,1
69,45617.99,2331.44,150.54,2180.9,43437.09,mortgage,118,1
70,43437.09,2331.44,143.34,2188.1,41248.99,mortgage,118,1
71,41248.99,2331.44,136.12,2195.32,39053.67,mortgage,118,1
72,39053.67,2331.44,128.88,2202.56,36851.11,mortgage,118,1
73,36851.11,2331.44,121.61,2209.83,34641.28,mortgage,118,1
74,34641.28,2331.44,114.32,2217.12,32424.16,mortgage,118,1
75,32424.16,2331.44,107.0,2224.44,30199.72,mortgage,118,1
76,30199.72,2331.44,99.66,2231.78,27967.94,mortgage,118,1
77,27967.94,2331.44,92.29,2239.15,25728.79,mortgage,118,1
78,25728.79,2331.44,84.91,2246.53,23482.26,mortgage,118,1
79,23482.26,2331.44,77.49,2253.95,21228.31,mortgage,118,1
80,21228.31,2331.44,70.05,2261.39,18966.92,mortgage,118,1
81,18966.92,2331.44,62.59,2268.85,16698.07,mortgage,118,1
82,16698.07,2331.44,55.1,2276.34,14421.73,mortgage,118,1
83,14421.73,2331.44,47.59,2283.85,12137.88,mortgage,118,1
84,12137.88,2331.44,40.06,2291.38,9846.5,mortgage,118,1
85,9846.5,2331.44,32.49,2298.95,7547.55,mortgage,118,1
86,7547.55,2331.44,24.91,2306.53,5241.02,mortgage,118,1
87,5241.02,2331.44,17.3,2314.14,2926.88,mortgage,118,1
88,2926.88,2331.44,9.66,2321.78,605.1,mortgage,118,1
89,605.1,2331.44,2.0,2329.44,-1724.34,mortgage,118,1
0,20000.0,191.04,108.0,83.04,19916.96,WellsFargo2,118,2
1,19916.96,191.04,107.55,83.49,19833.47,WellsFargo2,118,2
2,19833.47,191.04,107.1,83.94,19749.53,WellsFargo2,118,2
3,19749.53,191.04,106.65,84.39,19665.14,WellsFargo2,118,2
4,19665.14,191.04,106.19,84.85,19580.29,WellsFargo2,118,2
5,19580.29,191.04,105.73,85.31,19494.98,WellsFargo2,118,2
6,19494.98,191.04,105.27,85.77,19409.21,WellsFargo2,118,2
7,19409.21,191.04,104.81,86.23,19322.98,WellsFargo2,118,2
8,19322.98,191.04,104.34,86.7,19236.28,WellsFargo2,118,2
9,19236.28,191.04,103.88,87.16,19149.12,WellsFargo2,118,2
10,19149.12,191.04,103.41,87.63,19061.49,WellsFargo2,118,2
11,19061.49,191.04,102.93,88.11,18973.38,WellsFargo2,118,2
12,18973.38,191.04,102.46,88.58,18884.8,WellsFargo2,118,2
13,18884.8,191.04,101.98,89.06,18795.74,WellsFargo2,118,2
14,18795.74,191.04,101.5,89.54,18706.2,WellsFargo2,118,2
15,18706.2,191.04,101.01,90.03,18616.17,WellsFargo2,118,2
16,18616.17,191.04,100.53,90.51,18525.66,WellsFargo2,118,2
17,18525.66,191.04,100.04,91.0,18434.66,WellsFargo2,118,2
18,18434.66,191.04,99.55,91.49,18343.17,WellsFargo2,118,2
19,18343.17,191.04,99.05,91.99,18251.18,WellsFargo2,118,2
20,18251.18,191.04,98.56,92.48,18158.7,WellsFargo2,118,2
21,18158.7,191.04,98.06,92.98,18065.72,WellsFargo2,118,2
22,18065.72,191.04,97.55,93.49,17972.23,WellsFargo2,118,2
23,17972.23,191.04,97.05,93.99,17878.24,WellsFargo2,118,2
24,17878.24,191.04,96.54,94.5,17783.74,WellsFargo2,118,2
25,17783.74,191.04,96.03,95.01,17688.73,WellsFargo2,118,2
26,17688.73,191.04,95.52,95.52,17593.21,WellsFargo2,118,2
27,17593.21,191.04,95.0,96.04,17497.17,WellsFargo2,118,2
28,17497.17,191.04,94.48,96.56,17400.61,WellsFargo2,118,2
29,17400.61,191.04,93.96,97.08,17303.53,WellsFargo2,118,2
30,17303.53,191.04,93.44,97.6,17205.93,WellsFargo2,118,2
31,17205.93,191.04,92.91,98.13,17107.8,WellsFargo2,118,2
32,17107.8,191.04,92.38,98.66,17009.14,WellsFargo2,118,2
33,17009.14,191.04,91.85,99.19,16909.95,WellsFargo2,118,2
34,16909.95,191.04,91.31,99.73,16810.22,WellsFargo2,118,2
35,16810.22,191.04,90.78,100.26,16709.96,WellsFargo2,118,2
36,16709.96,191.04,90.23,100.81,16609.15,WellsFargo2,118,2
37,16609.15,191.04,89.69,101.35,16507.8,WellsFargo2,118,2
38,16507.8,191.04,89.14,101.9,16405.9,WellsFargo2,118,2
39,16405.9,191.04,88.59,102.45,16303.45,WellsFargo2,118,2
40,16303.45,191.04,88.04,103.0,16200.45,WellsFargo2,118,2
41,16200.45,191.04,87.48,103.56,16096.89,WellsFargo2,118,2
42,16096.89,191.04,86.92,104.12,15992.77,WellsFargo2,118,2
43,15992.77,191.04,86.36,104.68,15888.09,WellsFargo2,118,2
44,15888.09,191.04,85.8,105.24,15782.85,WellsFargo2,118,2
45,15782.85,191.04,85.23,105.81,15677.04,WellsFargo2,118,2
46,15677.04,191.04,84.66,106.38,15570.66,WellsFargo2,118,2
47,15570.66,191.04,84.08,106.96,15463.7,WellsFargo2,118,2
48,15463.7,191.04,83.5,107.54,15356.16,WellsFargo2,118,2
49,15356.16,191.04,82.92,108.12,15248.04,WellsFargo2,118,2
50,15248.04,191.04,82.34,108.7,15139.34,WellsFargo2,118,2
51,15139.34,191.04,81.75,109.29,15030.05,WellsFargo2,118,2
52,15030.05,191.04,81.16,109.88,14920.17,WellsFargo2,118,2
53,14920.17,191.04,80.57,110.47,14809.7,WellsFargo2,118,2
54,14809.7,191.04,79.97,111.07,14698.63,WellsFargo2,118,2
55,14698.63,191.04,79.37,111.67,14586.96,WellsFargo2,118,2
56,14586.96,191.04,78.77,112.27,14474.69,WellsFargo2,118,2
57,14474.69,191.04,78.16,112.88,14361.81,WellsFargo2,118,2
58,14361.81,191.04,77.55,113.49,14248.32,WellsFargo2,118,2
59,14248.32,191.04,76.94,114.1,14134.22,WellsFargo2,118,2
60,14134.22,191.04,76.32,114.72,14019.5,WellsFargo2,118,2
61,14019.5,191.04,75.71,115.33,13904.17,WellsFargo2,118,2
62,13904.17,191.04,75.08,115.96,13788.21,WellsFargo2,118,2
63,13788.21,191.04,74.46,116.58,13671.63,WellsFargo2,118,2
64,13671.63,191.04,73.83,117.21,13554.42,WellsFargo2,118,2
65,13554.42,191.04,73.19,117.85,13436.57,WellsFargo2,118,2
66,13436.57,191.04,72.56,118.48,13318.09,WellsFargo2,118,2
67,13318.09,191.04,71.92,119.12,13198.97,WellsFargo2,118,2
68,13198.97,191.04,71.27,119.77,13079.2,WellsFargo2,118,2
69,13079.2,191.04,70.63,120.41,12958.79,WellsFargo2,118,2
70,12958.79,191.04,69.98,121.06,12837.73,WellsFargo2,118,2
71,12837.73,191.04,69.32,121.72,12716.01,WellsFargo2,118,2
72,12716.01,191.04,68.67,122.37,12593.64,WellsFargo2,118,2
73,12593.64,191.04,68.01,123.03,12470.61,WellsFargo2,118,2
74,12470.61,191.04,67.34,123.7,12346.91,WellsFargo2,118,2
75,12346.91,191.04,66.67,124.37,12222.54,WellsFargo2,118,2
76,12222.54,191.04,66.0,125.04,12097.5,WellsFargo2,118,2
77,12097.5,191.04,65.33,125.71,11971.79,WellsFargo2,118,2
78,11971.79,191.04,64.65,126.39,11845.4,WellsFargo2,118,2
79,11845.4,191.04,63.97,127.07,11718.33,WellsFargo2,118,2
80,11718.33,191.04,63.28,127.76,11590.57,WellsFargo2,118,2
81,11590.57,191.04,62.59,128.45,11462.12,WellsFargo2,118,2
82,11462.12,191.04,61.9,129.14,11332.98,WellsFargo2,118,2
83,11332.98,191.04,61.2,129.84,11203.14,WellsFargo2,118,2
84,11203.14,191.04,60.5,130.54,11072.6,WellsFargo2,118,2
85,11072.6,191.04,59.79,131.25,10941.35,WellsFargo2,118,2
86,10941.35,191.04,59.08,131.96,10809.39,WellsFargo2,118,2
87,10809.39,191.04,58.37,132.67,10676.72,WellsFargo2,118,2
88,10676.72,191.04,57.65,133.39,10543.33,WellsFargo2,118,2
89,10543.33,1915.38,56.93,1858.45,8684.88,WellsFargo2,118,2
90,8684.88,2522.48,46.9,2475.58,6209.3,WellsFargo2,118,2
91,6209.3,2522.48,33.53,2488.95,3720.35,WellsFargo2,118,2
92,3720.35,2522.48,20.09,2502.39,1217.96,WellsFargo2,118,2
93,1217.96,2522.48,6.58,2515.9,-1297.94,WellsFargo2,118,2
0,5000.0,333.0,36.0,297.0,4703.0,Car,118,3
1,4703.0,333.0,33.86,299.14,4403.86,Car,118,3
2,4403.86,333.0,31.71,301.29,4102.57,Car,118,3
3,4102.57,333.0,29.54,303.46,3799.11,Car,118,3
4,3799.11,333.0,27.35,305.65,3493.46,Car,118,3
5,3493.46,333.0,25.15,307.85,3185.61,Car,118,3
6,3185.61,333.0,22.94,310.06,2875.55,Car,118,3
7,2875.55,333.0,20.7,312.3,2563.25,Car,118,3
8,2563.25,333.0,18.46,314.54,2248.71,Car,118,3
9,2248.71,333.0,16.19,316.81,1931.9,Car,118,3
10,1931.9,333.0,13.91,319.09,1612.81,Car,118,3
11,1612.81,333.0,11.61,321.39,1291.42,Car,118,3
12,1291.42,333.0,9.3,323.7,967.72,Car,118,3
13,967.72,333.0,6.97,326.03,641.69,Car,118,3
14,641.69,333.0,4.62,328.38,313.31,Car,118,3
15,313.31,333.0,2.26,330.74,-17.43,Car,118,3
0,8250.57,84.62,53.63,30.99,8219.58,WellsFargo1,118,4
1,8219.58,84.62,53.43,31.19,8188.39,WellsFargo1,118,4
2,8188.39,84.62,53.22,31.4,8156.99,WellsFargo1,118,4
3,8156.99,84.62,53.02,31.6,8125.39,WellsFargo1,118,4
4,8125.39,84.62,52.82,31.8,8093.59,WellsFargo1,118,4
5,8093.59,84.62,52.61,32.01,8061.58,WellsFargo1,118,4
6,8061.58,84.62,52.4,32.22,8029.36,WellsFargo1,118,4
7,8029.36,84.62,52.19,32.43,7996.93,WellsFargo1,118,4
8,7996.93,84.62,51.98,32.64,7964.29,WellsFargo1,118,4
9,7964.29,84.62,51.77,32.85,7931.44,WellsFargo1,118,4
10,7931.44,84.62,51.55,33.07,7898.37,WellsFargo1,118,4
11,7898.37,84.62,51.34,33.28,7865.09,WellsFargo1,118,4
12,7865.09,84.62,51.12,33.5,7831.59,WellsFargo1,118,4
13,7831.59,84.62,50.91,33.71,7797.88,WellsFargo1,118,4
14,7797.88,84.62,50.69,33.93,7763.95,WellsFargo1,118,4
15,7763.95,102.05,50.47,51.58,7712.37,WellsFargo1,118,4
16,7712.37,2940.1,50.13,2889.97,4822.4,WellsFargo1,118,4
17,4822.4,2940.1,31.35,2908.75,1913.65,WellsFargo1,118,4
18,1913.65,2940.1,12.44,2927.66,-1014.01,WellsFargo1,118,4
0,4000.0,70.0,16.0,54.0,3946.0,testing,118,5
1,3946.0,70.0,15.78,54.22,3891.78,testing,118,5
2,3891.78,70.0,15.57,54.43,3837.35,testing,118,5
3,3837.35,70.0,15.35,54.65,3782.7,testing,118,5
4,3782.7,70.0,15.13,54.87,3727.83,testing,118,5
5,3727.83,70.0,14.91,55.09,3672.74,testing,118,5
6,3672.74,70.0,14.69,55.31,3617.43,testing,118,5
7,3617.43,70.0,14.47,55.53,3561.9,testing,118,5
8,3561.9,70.0,14.25,55.75,3506.15,testing,118,5
9,3506.15,70.0,14.02,55.98,3450.17,testing,118,5
10,3450.17,70.0,13.8,56.2,3393.97,testing,118,5
11,3393.97,70.0,13.58,56.42,3337.55,testing,118,5
12,3337.55,70.0,13.35,56.65,3280.9,testing,118,5
13,3280.9,70.0,13.12,56.88,3224.02,testing,118,5
14,3224.02,70.0,12.9,57.1,3166.92,testing,118,5
15,3166.92,70.0,12.67,57.33,3109.59,testing,118,5
16,3109.59,70.0,12.44,57.56,3052.03,testing,118,5
17,3052.03,70.0,12.21,57.79,2994.24,testing,118,5
18,2994.24,1084.01,11.98,1072.03,1922.21,testing,118,5
19,1922.21,3010.1,7.69,3002.41,-1080.2,testing,118,5
0,180000.0,2331.44,594.0,1737.44,178262.56,mortgage,119,1
1,178262.56,2331.44,588.27,1743.17,176519.39,mortgage,119,1
2,176519.39,2331.44,582.51,1748.93,174770.46,mortgage,119,1
3,174770.46,2331.44,576.74,1754.7,173015.76,mortgage,119,1
4,173015.76,2331.44,570.95,1760.49,171255.27,mortgage,119,1
5,171255.27,2331.44,565.14,1766.3,169488.97,mortgage,119,1
6,169488.97,2331.44,559.31,1772.13,167716.84,mortgage,119,1
7,167716.84,2331.44,553.47,1777.97,165938.87,mortgage,119,1
8,165938.87,2331.44,547.6,1783.84,164155.03,mortgage,119,1
9,164155.03,2331.44,541.71,1789.73,162365.3,mortgage,119,1
10,162365.3,2331.44,535.81,1795.63,160569.67,mortgage,119,1
11,160569.67,2331.44,529.88,1801.56,158768.11,mortgage,119,1
12,158768.11,2331.44,523.93,1807.51,156960.6,mortgage,119,1
13,156960.6,2331.44,517.97,1813.47,155147.13,mortgage,119,1
14,155147.13,2331.44,511.99,1819.45,153327.68,mortgage,119,1
15,153327.68,2331.44,505.98,1825.46,151502.22,mortgage,119,1
16,151502.22,2331.44,499.96,1831.48,149670.74,mortgage,119,1
17,149670.74,2331.44,493.91,1837.53,147833.21,mortgage,119,1
18,147833.21,2331.44,487.85,1843.59,145989.62,mortgage,119,1
19,145989.62,2331.44,481.77,1849.67,144139.95,mortgage,119,1
20,144139.95,2331.44,475.66,1855.78,142284.17,mortgage,119,1
21,142284.17,2331.44,469.54,1861.9,140422.27,mortgage,119,1
22,140422.27,2331.44,463.39,1868.05,138554.22,mortgage,119,1
23,138554.22,2331.44,457.23,1874.21,136680.01,mortgage,119,1
24,136680.01,2331.44,451.04,1880.4,134799.61,mortgage,119,1
25,134799.61,2331.44,444.84,1886.6,132913.01,mortgage,119,1
26,132913.01,2331.44,438.61,1892.83,131020.18,mortgage,119,1
27,131020.18,2331.44,432.37,1899.07,129121.11,mortgage,119,1
28,129121.11,2331.44,426.1,1905.34,127215.77,mortgage,119,1
29,127215.77,2331.44,419.81,1911.63,125304.14,mortgage,119,1
30,125304.14,2331.44,413.5,1917.94,123386.2,mortgage,119,1
31,123386.2,2331.44,407.17,1924.27,121461.93,mortgage,119,1
32,121461.93,2331.44,400.82,1930.62,119531.31,mortgage,119,1
33,119531.31,2331.44,394.45,1936.99,117594.32,mortgage,119,1
34,117594.32,2331.44,388.06,1943.38,115650.94,mortgage,119,1
35,115650.94,2331.44,381.65,1949.79,113701.15,mortgage,119,1
36,113701.15,2331.44,375.21,1956.23,111744.92,mortgage,119,1
37,111744.92,2331.44,368.76,1962.68,109782.24,mortgage,119,1
38,109782.24,2331.44,362.28,1969.16,107813.08,mortgage,119,1
39,107813.08,2331.44,355.78,1975.66,105837.42,mortgage,119,1
40,105837.42,2331.44,349.26,1982.18,103855.24,mortgage,119,1
41,103855.24,2331.44,342.72,1988.72,101866.52,mortgage,119,1
42,101866.52,2331.44,336.16,1995.28,99871.24,mortgage,119,1
43,99871.24,2331.44,329.58,2001.86,97869.38,mortgage,119,1
44,97869.38,2331.44,322.97,2008.47,95860.91,mortgage,119,1
45,95860.91,2331.44,316.34,2015.1,93845.81,mortgage,119,1
46,93845.81,2331.44,309.69,2021.75,91824.06,mortgage,119,1
47,91824.06,2331.44,303.02,2028.42,89795.64,mortgage,119,1
48,89795.64,2331.44,296.33,2035.11,87760.53,mortgage,119,1
49,87760.53,2331.44,289.61,2041.83,85718.7,mortgage,119,1
50,85718.7,2331.44,282.87,2048.57,83670.13,mortgage,119,1
51,83670.13,2331.44,276.11,2055.33,81614.8,mortgage,119,1
52,81614.8,2331.44,269.33,2062.11,79552.69,mortgage,119,1
53,79552.69,2331.44,262.52,2068.92,77483.77,mortgage,119,1
54,77483.77,2331.44,255.7,2075.74,75408.03,mortgage,119,1
55,75408.03,2331.44,248.85,2082.59,73325.44,mortgage,119,1
56,73325.44,2331.44,241.97,2089.47,71235.97,mortgage,119,1
57,71235.97,2331.44,235.08,2096.36,69139.61,mortgage,119,1
58,69139.61,2331.44,228.16,2103.28,67036.33,mortgage,119,1
59,67036.33,2331.44,221.22,2110.22,64926.11,mortgage,119,1
60,64926.11,2331.44,214.26,2117.18,62808.93,mortgage,119,1
61,62808.93,2331.44,207.27,2124.17,60684.76,mortgage,119,1
62,60684.76,2331.44,200.26,2131.18,58553.58,mortgage,119,1
63,58553.58,2331.44,193.23,2138.21,56415.37,mortgage,119,1
64,56415.37,2331.44,186.17,2145.27,54270.1,mortgage,119,1
65,54270.1,2331.44,179.09,2152.35,52117.75,mortgage,119,1
66,52117.75,2331.44,171.99,2159.45,49958.3,mortgage,119,1
67,49958.3,2331.44,164.86,2166.58,47791.72,mortgage,119,1
68,47791.72,2331.44,157.71,2173.73,45617.99,mortgage,119,1
69,45617.99,2331.44,150.54,2180.9,43437.09,mortgage,119,1
70,43437.09,2331.44,143.34,2188.1,41248.99,mortgage,119,1
71,41248.99,2331.44,136.12,2195.32,39053.67,mortgage,119,1
72,39053.67,2331.44,128.88,2202.56,36851.11,mortgage,119,1
73,36851.11,2331.44,121.61,2209.83,34641.28,mortgage,119,1
74,34641.28,2331.44,114.32,2217.12,32424.16,mortgage,119,1
75,32424.16,2331.44,107.0,2224.44,30199.72,mortgage,119,1
76,30199.72,2331.44,99.66,2231.78,27967.94,mortgage,119,1
77,27967.94,2331.44,92.29,2239.15,25728.79,mortgage,119,1
78,25728.79,2331.44,84.91,2246.53,23482.26,mortgage,119,1
79,23482.26,2331.44,77.49,2253.95,21228.31,mortgage,119,1
80,21228.31,2331.44,70.05,2261.39,18966.92,mortgage,119,1
81,18966.92,2331.44,62.59,2268.85,16698.07,mortgage,119,1
82,16698.07,2331.44,55.1,2276.34,14421.73,mortgage,119,1
83,14421.73,2331.44,47.59,2283.85,12137.88,mortgage,119,1
84,12137.88,2331.44,40.06,2291.38,9846.5,mortgage,119,1
85,9846.5,2331.44,32.49,2298.95,7547.55,mortgage,119,1
86,7547.55,2331.44,24.91,2306.53,5241.02,mortgage,119,1
87,5241.02,2331.44,17.3,2314.14,2926.88,mortgage,119,1
88,2926.88,2331.44,9.66,2321.78,605.1,mortgage,119,1
89,605.1,2331.44,2.0,2329.44,-1724.34,mortgage,119,1
0,20000.0,191.04,108.0,83.04,19916.96,WellsFargo2,119,2
1,19916.96,191.04,107.55,83.49,19833.47,WellsFargo2,119,2
2,19833.47,191.04,107.1,83.94,19749.53,WellsFargo2,119,2
3,19749.53,191.04,106.65,84.39,19665.14,WellsFargo2,119,2
4,19665.14,191.04,106.19,84.85,19580.29,WellsFargo2,119,2
5,19580.29,191.04,105.73,85.31,19494.98,WellsFargo2,119,2
6,19494.98,191.04,105.27,85.77,19409.21,WellsFargo2,119,2
7,19409.21,191.04,104.81,86.23,19322.98,WellsFargo2,119,2
8,19322.98,191.04,104.34,86.7,19236.28,WellsFargo2,119,2
9,19236.28,191.04,103.88,87.16,19149.12,WellsFargo2,119,2
10,19149.12,191.04,103.41,87.63,19061.49,WellsFargo2,119,2
11,19061.49,191.04,102.93,88.11,18973.38,WellsFargo2,119,2
12,18973.38,191.04,102.46,88.58,18884.8,WellsFargo2,119,2
13,18884.8,191.04,101.98,89.06,18795.74,WellsFargo2,119,2
14,18795.74,191.04,101.5,89.54,18706.2,WellsFargo2,119,2
15,18706.2,191.04,101.01,90.03,18616.17,WellsFargo2,119,2
16,18616.17,191.04,100.53,90.51,18525.66,WellsFargo2,119,2
17,18525.66,191.04,100.04,91.0,18434.66,WellsFargo2,119,2
18,18434.66,191.04,99.55,91.49,18343.17,WellsFargo2,119,2
19,18343.17,191.04,99.05,91.99,18251.18,WellsFargo2,119,2
20,18251.18,191.04,98.56,92.48,18158.7,WellsFargo2,119,2
21,18158.7,191.04,98.06,92.98,18065.72,WellsFargo2,119,2
22,18065.72,191.04,97.55,93.49,17972.23,WellsFargo2,119,2
23,17972.23,191.04,97.05,93.99,17878.24,WellsFargo2,119,2
24,17878.24,191.04,96.54,94.5,17783.74,WellsFargo2,119,2
25,17783.74,191.04,96.03,95.01,17688.73,WellsFargo2,119,2
26,17688.73,191.04,95.52,95.52,17593.21,WellsFargo2,119,2
27,17593.21,191.04,95.0,96.04,17497.17,WellsFargo2,119,2
28,17497.17,191.04,94.48,96.56,17400.61,WellsFargo2,119,2
29,17400.61,191.04,93.96,97.08,17303.53,WellsFargo2,119,2
30,17303.53,191.04,93.44,97.6,17205.93,WellsFargo2,119,2
31,17205.93,191.04,92.91,98.13,17107.8,WellsFargo2,119,2
32,17107.8,191.04,92.38,98.66,17009.14,WellsFargo2,119,2
33,17009.14,191.04,91.85,99.19,16909.95,WellsFargo2,119,2
34,16909.95,191.04,91.31,99.73,16810.22,WellsFargo2,119,2
35,16810.22,191.04,90.78,100.26,16709.96,WellsFargo2,119,2
36,16709.96,191.04,90.23,100.81,16609.15,WellsFargo2,119,2
37,16609.15,191.04,89.69,101.35,16507.8,WellsFargo2,119,2
38,16507.8,191.04,89.14,101.9,16405.9,WellsFargo2,119,2
39,16405.9,191.04,88.59,102.45,16303.45,WellsFargo2,119,2
40,16303.45,191.04,88.04,103.0,16200.45,WellsFargo2,119,2
41,16200.45,191.04,87.48,103.56,16096.89,WellsFargo2,119,2
42,16096.89,191.04,86.92,104.12,15992.77,WellsFargo2,119,2
43,15992.77,191.04,86.36,104.68,15888.09,WellsFargo2,119,2
44,15888.09,191.04,85.8,105.24,15782.85,WellsFargo2,119,2
45,15782.85,191.04,85.23,105.81,15677.04,WellsFargo2,119,2
46,15677.04,191.04,84.66,106.38,15570.66,WellsFargo2,119,2
47,15570.66,191.04,84.08,106.96,15463.7,WellsFargo2,119,2
48,15463.7,191.04,83.5,107.54,15356.16,WellsFargo2,119,2
49,15356.16,191.04,82.92,108.12,15248.04,WellsFargo2,119,2
50,15248.04,191.04,82.34,108.7,15139.34,WellsFargo2,119,2
51,15139.34,191.04,81.75,109.29,15030.05,WellsFargo2,119,2
52,15030.05,191.04,81.16,109.88,14920.17,WellsFargo2,119,2
53,14920.17,191.04,80.57,110.47,14809.7,WellsFargo2,119,2
54,14809.7,191.04,79.97,111.07,14698.63,WellsFargo2,119,2
55,14698.63,191.04,79.37,111.67,14586.96,WellsFargo2,119,2
56,14586.96,191.04,78.77,112.27,14474.69,WellsFargo2,119,2
57,14474.69,191.04,78.16,112.88,14361.81,WellsFargo2,119,2
58,14361.81,191.04,77.55,113.49,14248.32,WellsFargo2,119,2
59,14248.32,191.04,76.94,114.1,14134.22,WellsFargo2,119,2
60,14134.22,191.04,76.32,114.72,14019.5,WellsFargo2,119,2
61,14019.5,191.04,75.71,115.33,13904.17,WellsFargo2,119,2
62,13904.17,191.04,75.08,115.96,13788.21,WellsFargo2,119,2
63,13788.21,191.04,74.46,116.58,13671.63,WellsFargo2,119,2
64,13671.63,191.04,73.83,117.21,13554.42,WellsFargo2,119,2
65,13554.42,191.04,73.19,117.85,13436.57,WellsFargo2,119,2
66,13436.57,191.04,72.56,118.48,13318.09,WellsFargo2,119,2
67,13318.09,191.04,71.92,119.12,13198.97,WellsFargo2,119,2
68,13198.97,191.04,71.27,119.77,13079.2,WellsFargo2,119,2
69,13079.2,191.04,70.63,120.41,12958.79,WellsFargo2,119,2
70,12958.79,191.04,69.98,121.06,12837.73,WellsFargo2,119,2
71,12837.73,191.04,69.32,121.72,12716.01,WellsFargo2,119,2
72,12716.01,191.04,68.67,122.37,12593.64,WellsFargo2,119,2
73,12593.64,191.04,68.01,123.03,12470.61,WellsFargo2,119,2
74,12470.61,191.04,67.34,123.7,12346.91,WellsFargo2,119,2
75,12346.91,191.04,66.67,124.37,12222.54,WellsFargo2,119,2
76,12222.54,191.04,66.0,125.04,12097.5,WellsFargo2,119,2
77,12097.5,191.04,65.33,125.71,11971.79,WellsFargo2,119,2
78,11971.79,191.04,64.65,126.39,11845.4,WellsFargo2,119,2
79,11845.4,191.04,63.97,127.07,11718.33,WellsFargo2,119,2
80,11718.33,191.04,63.28,127.76,11590.57,WellsFargo2,119,2
81,11590.57,191.04,62.59,128.45,11462.12,WellsFargo2,119,2
82,11462.12,191.04,61.9,129.14,11332.98,WellsFargo2,119,2
83,11332.98,191.04,61.2,129.84,11203.14,WellsFargo2,119,2
84,11203.14,191.04,60.5,130.54,11072.6,WellsFargo2,119,2
85,11072.6,191.04,59.79,131.25,10941.35,WellsFargo2,119,2
86,10941.35,191.04,59.08,131.96,10809.39,WellsFargo2,119,2
87,10809.39,191.04,58.37,132.67,10676.72,WellsFargo2,119,2
88,10676.72,191.04,57.65,133.39,10543.33,WellsFargo2,119,2
89,10543.33,1915.38,56.93,1858.45,8684.88,WellsFargo2,119,2
90,8684.88,2522.48,46.9,2475.58,6209.3,WellsFargo2,119,2
91,6209.3,2522.48,33.53,2488.95,3720.35,WellsFargo2,119,2
92,3720.35,2522.48,20.09,2502.39,1217.96,WellsFargo2,119,2
93,1217.96,2522.48,6.58,2515.9,-1297.94,WellsFargo2,119,2
0,8250.57,84.62,53.63,30.99,8219.58,WellsFargo1,119,3
1,8219.58,84.62,53.43,31.19,8188.39,WellsFargo1,119,3
2,8188.39,84.62,53.22,31.4,8156.99,WellsFargo1,119,3
3,8156.99,84.62,53.02,31.6,8125.39,WellsFargo1,119,3
4,8125.39,84.62,52.82,31.8,8093.59,WellsFargo1,119,3
5,8093.59,84.62,52.61,32.01,8061.58,WellsFargo1,119,3
6,8061.58,84.62,52.4,32.22,8029.36,WellsFargo1,119,3
7,8029.36,84.62,52.19,32.43,7996.93,WellsFargo1,119,3
8,7996.93,84.62,51.98,32.64,7964.29,WellsFargo1,119,3
9,7964.29,84.62,51.77,32.85,7931.44,WellsFargo1,119,3
10,7931.44,84.62,51.55,33.07,7898.37,WellsFargo1,119,3
11,7898.37,84.62,51.34,33.28,7865.09,WellsFargo1,119,3
12,7865.09,84.62,51.12,33.5,7831.59,WellsFargo1,119,3
13,7831.59,84.62,50.91,33.71,7797.88,WellsFargo1,119,3
14,7797.88,84.62,50.69,33.93,7763.95,WellsFargo1,119,3
15,7763.95,84.62,50.47,34.15,7729.8,WellsFargo1,119,3
16,7729.8,84.62,50.24,34.38,7695.42,WellsFargo1,119,3
17,7695.42,84.62,50.02,34.6,7660.82,WellsFargo1,119,3
18,7660.82,84.62,49.8,34.82,7626.0,WellsFargo1,119,3
19,7626.0,84.62,49.57,35.05,7590.95,WellsFargo1,119,3
20,7590.95,84.62,49.34,35.28,7555.67,WellsFargo1,119,3
21,7555.67,84.62,49.11,35.51,7520.16,WellsFargo1,119,3
22,7520.16,84.62,48.88,35.74,7484.42,WellsFargo1,119,3
23,7484.42,84.62,48.65,35.97,7448.45,WellsFargo1,119,3
24,7448.45,84.62,48.41,36.21,7412.24,WellsFargo1,119,3
25,7412.24,84.62,48.18,36.44,7375.8,WellsFargo1,119,3
26,7375.8,84.62,47.94,36.68,7339.12,WellsFargo1,119,3
27,7339.12,84.62,47.7,36.92,7302.2,WellsFargo1,119,3
28,7302.2,84.62,47.46,37.16,7265.04,WellsFargo1,119,3
29,7265.04,84.62,47.22,37.4,7227.64,WellsFargo1,119,3
30,7227.64,84.62,46.98,37.64,7190.0,WellsFargo1,119,3
31,7190.0,84.62,46.73,37.89,7152.11,WellsFargo1,119,3
32,7152.11,84.62,46.49,38.13,7113.98,WellsFargo1,119,3
33,7113.98,84.62,46.24,38.38,7075.6,WellsFargo1,119,3
34,7075.6,84.62,45.99,38.63,7036.97,WellsFargo1,119,3
35,7036.97,84.62,45.74,38.88,6998.09,WellsFargo1,119,3
36,6998.09,84.62,45.49,39.13,6958.96,WellsFargo1,119,3
37,6958.96,84.62,45.23,39.39,6919.57,WellsFargo1,119,3
38,6919.57,84.62,44.98,39.64,6879.93,WellsFargo1,119,3
39,6879.93,84.62,44.72,39.9,6840.03,WellsFargo1,119,3
40,6840.03,84.62,44.46,40.16,6799.87,WellsFargo1,119,3
41,6799.87,84.62,44.2,40.42,6759.45,WellsFargo1,119,3
42,6759.45,84.62,43.94,40.68,6718.77,WellsFargo1,119,3
43,6718.77,84.62,43.67,40.95,6677.82,WellsFargo1,119,3
44,6677.82,84.62,43.41,41.21,6636.61,WellsFargo1,119,3
45,6636.61,84.62,43.14,41.48,6595.13,WellsFargo1,119,3
46,6595.13,84.62,42.87,41.75,6553.38,WellsFargo1,119,3
47,6553.38,84.62,42.6,42.02,6511.36,WellsFargo1,119,3
48,6511.36,84.62,42.32,42.3,6469.06,WellsFargo1,119,3
49,6469.06,84.62,42.05,42.57,6426.49,WellsFargo1,119,3
50,6426.49,84.62,41.77,42.85,6383.64,WellsFargo1,119,3
51,6383.64,84.62,41.49,43.13,6340.51,WellsFargo1,119,3
52,6340.51,84.62,41.21,43.41,6297.1,WellsFargo1,119,3
53,6297.1,84.62,40.93,43.69,6253.41,WellsFargo1,119,3
54,6253.41,84.62,40.65,43.97,6209.44,WellsFargo1,119,3
55,6209.44,84.62,40.36,44.26,6165.18,WellsFargo1,119,3
56,6165.18,84.62,40.07,44.55,6120.63,WellsFargo1,119,3
57,6120.63,84.62,39.78,44.84,6075.79,WellsFargo1,119,3
58,6075.79,84.62,39.49,45.13,6030.66,WellsFargo1,119,3
59,6030.66,84.62,39.2,45.42,5985.24,WellsFargo1,119,3
60,5985.24,84.62,38.9,45.72,5939.52,WellsFargo1,119,3
61,5939.52,84.62,38.61,46.01,5893.51,WellsFargo1,119,3
62,5893.51,84.62,38.31,46.31,5847.2,WellsFargo1,119,3
63,5847.2,84.62,38.01,46.61,5800.59,WellsFargo1,119,3
64,5800.59,84.62,37.7,46.92,5753.67,WellsFargo1,119,3
65,5753.67,84.62,37.4,47.22,5706.45,WellsFargo1,119,3
66,5706.45,84.62,37.09,47.53,5658.92,WellsFargo1,119,3
67,5658.92,84.62,36.78,47.84,5611.08,WellsFargo1,119,3
68,5611.08,84.62,36.47,48.15,5562.93,WellsFargo1,119,3
69,5562.93,84.62,36.16,48.46,5514.47,WellsFargo1,119,3
70,5514.47,84.62,35.84,48.78,5465.69,WellsFargo1,119,3
71,5465.69,84.62,35.53,49.09,5416.6,WellsFargo1,119,3
72,5416.6,84.62,35.21,49.41,5367.19,WellsFargo1,119,3
73,5367.19,84.62,34.89,49.73,5317.46,WellsFargo1,119,3
74,5317.46,84.62,34.56,50.06,5267.4,WellsFargo1,119,3
75,5267.4,84.62,34.24,50.38,5217.02,WellsFargo1,119,3
76,5217.02,84.62,33.91,50.71,5166.31,WellsFargo1,119,3
77,5166.31,84.62,33.58,51.04,5115.27,WellsFargo1,119,3
78,5115.27,84.62,33.25,51.37,5063.9,WellsFargo1,119,3
79,5063.9,84.62,32.92,51.7,5012.2,WellsFargo1,119,3
80,5012.2,84.62,32.58,52.04,4960.16,WellsFargo1,119,3
81,4960.16,84.62,32.24,52.38,4907.78,WellsFargo1,119,3
82,4907.78,84.62,31.9,52.72,4855.06,WellsFargo1,119,3
83,4855.06,84.62,31.56,53.06,4802.0,WellsFargo1,119,3
84,4802.0,84.62,31.21,53.41,4748.59,WellsFargo1,119,3
85,4748.59,84.62,30.87,53.75,4694.84,WellsFargo1,119,3
86,4694.84,84.62,30.52,54.1,4640.74,WellsFargo1,119,3
87,4640.74,84.62,30.16,54.46,4586.28,WellsFargo1,119,3
88,4586.28,84.62,29.81,54.81,4531.47,WellsFargo1,119,3
89,4531.47,84.62,29.45,55.17,4476.3,WellsFargo1,119,3
90,4476.3,84.62,29.1,55.52,4420.78,WellsFargo1,119,3
91,4420.78,84.62,28.74,55.88,4364.9,WellsFargo1,119,3
92,4364.9,84.62,28.37,56.25,4308.65,WellsFargo1,119,3
93,4308.65,1382.56,28.01,1354.55,2954.1,WellsFargo1,119,3
94,2954.1,2607.1,19.2,2587.9,366.2,WellsFargo1,119,3
95,366.2,2607.1,2.38,2604.72,-2238.52,WellsFargo1,119,3
0,4000.0,70.0,16.0,54.0,3946.0,testing,119,4
1,3946.0,70.0,15.78,54.22,3891.78,testing,119,4
2,3891.78,70.0,15.57,54.43,3837.35,testing,119,4
3,3837.35,70.0,15.35,54.65,3782.7,testing,119,4
4,3782.7,70.0,15.13,54.87,3727.83,testing,119,4
5,3727.83,70.0,14.91,55.09,3672.74,testing,119,4
6,3672.74,70.0,14.69,55.31,3617.43,testing,119,4
7,3617.43,70.0,14.47,55.53,3561.9,testing,119,4
8,3561.9,70.0,14.25,55.75,3506.15,testing,119,4
9,3506.15,70.0,14.02,55.98,3450.17,testing,119,4
10,3450.17,70.0,13.8,56.2,3393.97,testing,119,4
11,3393.97,70.0,13.58,56.42,3337.55,testing,119,4
12,3337.55,70.0,13.35,56.65,3280.9,testing,119,4
13,3280.9,70.0,13.12,56.88,3224.02,testing,119,4
14,3224.02,70.0,12.9,57.1,3166.92,testing,119,4
15,3166.92,70.0,12.67,57.33,3109.59,testing,119,4
16,3109.59,70.0,12.44,57.56,3052.03,testing,119,4
17,3052.03,70.0,12.21,57.79,2994.24,testing,119,4
18,2994.24,70.0,11.98,58.02,2936.22,testing,119,4
19,2936.22,70.0,11.74,58.26,2877.96,testing,119,4
20,2877.96,70.0,11.51,58.49,2819.47,testing,119,4
21,2819.47,70.0,11.28,58.72,2760.75,testing,119,4
22,2760.75,70.0,11.04,58.96,2701.79,testing,119,4
23,2701.79,70.0,10.81,59.19,2642.6,testing,119,4
24,2642.6,70.0,10.57,59.43,2583.17,testing,119,4
25,2583.17,70.0,10.33,59.67,2523.5,testing,119,4
26,2523.5,70.0,10.09,59.91,2463.59,testing,119,4
27,2463.59,70.0,9.85,60.15,2403.44,testing,119,4
28,2403.44,70.0,9.61,60.39,2343.05,testing,119,4
29,2343.05,70.0,9.37,60.63,2282.42,testing,119,4
30,2282.42,70.0,9.13,60.87,2221.55,testing,119,4
31,2221.55,70.0,8.89,61.11,2160.44,testing,119,4
32,2160.44,70.0,8.64,61.36,2099.08,testing,119,4
33,2099.08,70.0,8.4,61.6,2037.48,testing,119,4
34,2037.48,70.0,8.15,61.85,1975.63,testing,119,4
35,1975.63,70.0,7.9,62.1,1913.53,testing,119,4
36,1913.53,70.0,7.65,62.35,1851.18,testing,119,4
37,1851.18,70.0,7.4,62.6,1788.58,testing,119,4
38,1788.58,70.0,7.15,62.85,1725.73,testing,119,4
39,1725.73,70.0,6.9,63.1,1662.63,testing,119,4
40,1662.63,70.0,6.65,63.35,1599.28,testing,119,4
41,1599.28,70.0,6.4,63.6,1535.68,testing,119,4
42,1535.68,70.0,6.14,63.86,1471.82,testing,119,4
43,1471.82,70.0,5.89,64.11,1407.71,testing,119,4
44,1407.71,70.0,5.63,64.37,1343.34,testing,119,4
45,1343.34,70.0,5.37,64.63,1278.71,testing,119,4
46,1278.71,70.0,5.11,64.89,1213.82,testing,119,4
47,1213.82,70.0,4.86,65.14,1148.68,testing,119,4
48,1148.68,70.0,4.59,65.41,1083.27,testing,119,4
49,1083.27,70.0,4.33,65.67,1017.6,testing,119,4
50,1017.6,70.0,4.07,65.93,951.67,testing,119,4
51,951.67,70.0,3.81,66.19,885.48,testing,119,4
52,885.48,70.0,3.54,66.46,819.02,testing,119,4
53,819.02,70.0,3.28,66.72,752.3,testing,119,4
54,752.3,70.0,3.01,66.99,685.31,testing,119,4
55,685.31,70.0,2.74,67.26,618.05,testing,119,4
56,618.05,70.0,2.47,67.53,550.52,testing,119,4
57,550.52,70.0,2.2,67.8,482.72,testing,119,4
58,482.72,70.0,1.93,68.07,414.65,testing,119,4
59,414.65,70.0,1.66,68.34,346.31,testing,119,4
60,346.31,70.0,1.39,68.61,277.7,testing,119,4
61,277.7,70.0,1.11,68.89,208.81,testing,119,4
62,208.81,70.0,0.84,69.16,139.65,testing,119,4
63,139.65,70.0,0.56,69.44,70.21,testing,119,4
64,70.21,70.0,0.28,69.72,0.49,testing,119,4
65,0.49,70.0,0.0,70.0,-69.51,testing,119,4
0,5000.0,333.0,36.0,297.0,4703.0,Car,119,5
1,4703.0,333.0,33.86,299.14,4403.86,Car,119,5
2,4403.86,333.0,31.71,301.29,4102.57,Car,119,5
3,4102.57,333.0,29.54,303.46,3799.11,Car,119,5
4,3799.11,333.0,27.35,305.65,3493.46,Car,119,5
5,3493.46,333.0,25.15,307.85,3185.61,Car,119,5
6,3185.61,333.0,22.94,310.06,2875.55,Car,119,5
7,2875.55,333.0,20.7,312.3,2563.25,Car,119,5
8,2563.25,333.0,18.46,314.54,2248.71,Car,119,5
9,2248.71,333.0,16.19,316.81,1931.9,Car,119,5
10,1931.9,333.0,13.91,319.09,1612.81,Car,119,5
11,1612.81,333.0,11.61,321.39,1291.42,Car,119,5
12,1291.42,333.0,9.3,323.7,967.72,Car,119,5
13,967.72,333.0,6.97,326.03,641.69,Car,119,5
14,641.69,333.0,4.62,328.38,313.31,Car,119,5
15,313.31,333.0,2.26,330.74,-17.43,Car,119,5
0,180000.0,2331.44,594.0,1737.44,178262.56,mortgage,120,1
1,178262.56,2331.44,588.27,1743.17,176519.39,mortgage,120,1
2,176519.39,2331.44,582.51,1748.93,174770.46,mortgage,120,1
3,174770.46,2331.44,576.74,1754.7,173015.76,mortgage,120,1
4,173015.76,2331.44,570.95,1760.49,171255.27,mortgage,120,1
5,171255.27,2331.44,565.14,1766.3,169488.97,mortgage,120,1
6,169488.97,2331.44,559.31,1772.13,167716.84,mortgage,120,1
7,167716.84,2331.44,553.47,1777.97,165938.87,mortgage,120,1
8,165938.87,2331.44,547.6,1783.84,164155.03,mortgage,120,1
9,164155.03,2331.44,541.71,1789.73,162365.3,mortgage,120,1
10,162365.3,2331.44,535.81,1795.63,160569.67,mortgage,120,1
11,160569.67,2331.44,529.88,1801.56,158768.11,mortgage,120,1
12,158768.11,2331.44,523.93,1807.51,156960.6,mortgage,120,1
13,156960.6,2331.44,517.97,1813.47,155147.13,mortgage,120,1
14,155147.13,2331.44,511.99,1819.45,153327.68,mortgage,120,1
15,153327.68,2331.44,505.98,1825.46,151502.22,mortgage,120,1
16,151502.22,2331.44,499.96,1831.48,149670.74,mortgage,120,1
17,149670.74,2331.44,493.91,1837.53,147833.21,mortgage,120,1
18,147833.21,2331.44,487.85,1843.59,145989.62,mortgage,120,1
19,145989.62,2331.44,481.77,1849.67,144139.95,mortgage,120,1
20,144139.95,2331.44,475.66,1855.78,142284.17,mortgage,120,1
21,142284.17,2331.44,469.54,1861.9,140422.27,mortgage,120,1
22,140422.27,2331.44,463.39,1868.05,138554.22,mortgage,120,1
23,138554.22,2331.44,457.23,1874.21,136680.01,mortgage,120,1
24,136680.01,2331.44,451.04,1880.4,134799.61,mortgage,120,1
25,134799.61,2331.44,444.84,1886.6,132913.01,mortgage,120,1
26,132913.01,2331.44,438.61,1892.83,131020.18,mortgage,120,1
27,131020.18,2331.44,432.37,1899.07,129121.11,mortgage,120,1
28,129121.11,2331.44,426.1,1905.34,127215.77,mortgage,120,1
29,127215.77,2331.44,419.81,1911.63,125304.14,mortgage,120,1
30,125304.14,2331.44,413.5,1917.94,123386.2,mortgage,120,1
31,123386.2,2331.44,407.17,1924.27,121461.93,mortgage,120,1
32,121461.93,2331.44,400.82,1930.62,119531.31,mortgage,120,1
33,119531.31,2331.44,394.45,1936.99,117594.32,mortgage,120,1
34,117594.32,2331.44,388.06,1943.38,115650.94,mortgage,120,1
35,115650.94,2331.44,381.65,1949.79,113701.15,mortgage,120,1
36,113701.15,2331.44,375.21,1956.23,111744.92,mortgage,120,1
37,111744.92,2331.44,368.76,1962.68,109782.24,mortgage,120,1
38,109782.24,2331.44,362.28,1969.16,107813.08,mortgage,120,1
39,107813.08,2331.44,355.78,1975.66,105837.42,mortgage,120,1
40,105837.42,2331.44,349.26,1982.18,103855.24,mortgage,120,1
41,103855.24,2331.44,342.72,1988.72,101866.52,mortgage,120,1
42,101866.52,2331.44,336.16,1995.28,99871.24,mortgage,120,1
43,99871.24,2331.44,329.58,2001.86,97869.38,mortgage,120,1
44,97869.38,2331.44,322.97,2008.47,95860.91,mortgage,120,1
45,95860.91,2331.44,316.34,2015.1,93845.81,mortgage,120,1
46,93845.81,2331.44,309.69,2021.75,91824.06,mortgage,120,1
47,91824.06,2331.44,303.02,2028.42,89795.64,mortgage,120,1
48,89795.64,2331.44,296.33,2035.11,87760.53,mortgage,120,1
49,87760.53,2331.44,289.61,2041.83,85718.7,mortgage,120,1
50,85718.7,2331.44,282.87,2048.57,83670.13,mortgage,120,1
51,83670.13,2331.44,276.11,2055.33,81614.8,mortgage,120,1
52,81614.8,2331.44,269.33,2062.11,79552.69,mortgage,120,1
53,79552.69,2331.44,262.52,2068.92,77483.77,mortgage,120,1
54,77483.77,2331.44,255.7,2075.74,75408.03,mortgage,120,1
55,75408.03,2331.44,248.85,2082.59,73325.44,mortgage,120,1
56,73325.44,2331.44,241.97,2089.47,71235.97,mortgage,120,1
57,71235.97,2331.44,235.08,2096.36,69139.61,mortgage,120,1
58,69139.61,2331.44,228.16,2103.28,67036.33,mortgage,120,1
59,67036.33,2331.44,221.22,2110.22,64926.11,mortgage,120,1
60,64926.11,2331.44,214.26,2117.18,62808.93,mortgage,120,1
61,62808.93,2331.44,207.27,2124.17,60684.76,mortgage,120,1
62,60684.76,2331.44,200.26,2131.18,58553.58,mortgage,120,1
63,58553.58,2331.44,193.23,2138.21,56415.37,mortgage,120,1
64,56415.37,2331.44,186.17,2145.27,54270.1,mortgage,120,1
65,54270.1,2331.44,179.09,2152.35,52117.75,mortgage,120,1
66,52117.75,2331.44,171.99,2159.45,49958.3,mortgage,120,1
67,49958.3,2331.44,164.86,2166.58,47791.72,mortgage,120,1
68,47791.72,2331.44,157.71,2173.73,45617.99,mortgage,120,1
69,45617.99,2331.44,150.54,2180.9,43437.09,mortgage,120,1
70,43437.09,2331.44,143.34,2188.1,41248.99,mortgage,120,1
71,41248.99,2331.44,136.12,2195.32,39053.67,mortgage,120,1
72,39053.67,2331.44,128.88,2202.56,36851.11,mortgage,120,1
73,36851.11,2331.44,121.61,2209.83,34641.28,mortgage,120,1
74,34641.28,2331.44,114.32,2217.12,32424.16,mortgage,120,1
75,32424.16,2331.44,107.0,2224.44,30199.72,mortgage,120,1
76,30199.72,2331.44,99.66,2231.78,27967.94,mortgage,120,1
77,27967.94,2331.44,92.29,2239.15,25728.79,mortgage,120,1
78,25728.79,2331.44,84.91,2246.53,23482.26,mortgage,120,1
79,23482.26,2331.44,77.49,2253.95,21228.31,mortgage,120,1
80,21228.31,2331.44,70.05,2261.39,18966.92,mortgage,120,1
81,18966.92,2331.44,62.59,2268.85,16698.07,mortgage,120,1
82,16698.07,2331.44,55.1,2276.34,14421.73,mortgage,120,1
83,14421.73,2331.44,47.59,2283.85,12137.88,mortgage,120,1
84,12137.88,2331.44,40.06,2291.38,9846.5,mortgage,120,1
85,9846.5,2331.44,32.49,2298.95,7547.55,mortgage,120,1
86,7547.55,2331.44,24.91,2306.53,5241.02,mortgage,120,1
87,5241.02,2331.44,17.3,2314.14,2926.88,mortgage,120,1
88,2926.88,2331.44,9.66,2321.78,605.1,mortgage,120,1
89,605.1,2331.44,2.0,2329.44,-1724.34,mortgage,120,1
0,20000.0,191.04,108.0,83.04,19916.96,WellsFargo2,120,2
1,19916.96,191.04,107.55,83.49,19833.47,WellsFargo2,120,2
2,19833.47,191.04,107.1,83.94,19749.53,WellsFargo2,120,2
3,19749.53,191.04,106.65,84.39,19665.14,WellsFargo2,120,2
4,19665.14,191.04,106.19,84.85,19580.29,WellsFargo2,120,2
5,19580.29,191.04,105.73,85.31,19494.98,WellsFargo2,120,2
6,19494.98,191.04,105.27,85.77,19409.21,WellsFargo2,120,2
7,19409.21,191.04,104.81,86.23,19322.98,WellsFargo2,120,2
8,19322.98,191.04,104.34,86.7,19236.28,WellsFargo2,120,2
9,19236.28,191.04,103.88,87.16,19149.12,WellsFargo2,120,2
10,19149.12,191.04,103.41,87.63,19061.49,WellsFargo2,120,2
11,19061.49,191.04,102.93,88.11,18973.38,WellsFargo2,120,2
12,18973.38,191.04,102.46,88.58,18884.8,WellsFargo2,120,2
13,18884.8,191.04,101.98,89.06,18795.74,WellsFargo2,120,2
14,18795.74,191.04,101.5,89.54,18706.2,WellsFargo2,120,2
15,18706.2,191.04,101.01,90.03,18616.17,WellsFargo2,120,2
16,18616.17,191.04,100.53,90.51,18525.66,WellsFargo2,120,2
17,18525.66,191.04,100.04,91.0,18434.66,WellsFargo2,120,2
18,18434.66,191.04,99.55,91.49,18343.17,WellsFargo2,120,2
19,18343.17,191.04,99.05,91.99,18251.18,WellsFargo2,120,2
20,18251.18,191.04,98.56,92.48,18158.7,WellsFargo2,120,2
21,18158.7,191.04,98.06,92.98,18065.72,WellsFargo2,120,2
22,18065.72,191.04,97.55,93.49,17972.23,WellsFargo2,120,2
23,17972.23,191.04,97.05,93.99,17878.24,WellsFargo2,120,2
24,17878.24,191.04,96.54,94.5,17783.74,WellsFargo2,120,2
25,17783.74,191.04,96.03,95.01,17688.73,WellsFargo2,120,2
26,17688.73,191.04,95.52,95.52,17593.21,WellsFargo2,120,2
27,17593.21,191.04,95.0,96.04,17497.17,WellsFargo2,120,2
28,17497.17,191.04,94.48,96.56,17400.61,WellsFargo2,120,2
29,17400.61,191.04,93.96,97.08,17303.53,WellsFargo2,120,2
30,17303.53,191.04,93.44,97.6,17205.93,WellsFargo2,120,2
31,17205.93,191.04,92.91,98.13,17107.8,WellsFargo2,120,2
32,17107.8,191.04,92.38,98.66,17009.14,WellsFargo2,120,2
33,17009.14,191.04,91.85,99.19,16909.95,WellsFargo2,120,2
34,16909.95,191.04,91.31,99.73,16810.22,WellsFargo2,120,2
35,16810.22,191.04,90.78,100.26,16709.96,WellsFargo2,120,2
36,16709.96,191.04,90.23,100.81,16609.15,WellsFargo2,120,2
37,16609.15,191.04,89.69,101.35,16507.8,WellsFargo2,120,2
38,16507.8,191.04,89.14,101.9,16405.9,WellsFargo2,120,2
39,16405.9,191.04,88.59,102.45,16303.45,WellsFargo2,120,2
40,16303.45,191.04,88.04,103.0,16200.45,WellsFargo2,120,2
41,16200.45,191.04,87.48,103.56,16096.89,WellsFargo2,120,2
42,16096.89,191.04,86.92,104.12,15992.77,WellsFargo2,120,2
43,15992.77,191.04,86.36,104.68,15888.09,WellsFargo2,120,2
44,15888.09,191.04,85.8,105.24,15782.85,WellsFargo2,120,2
45,15782.85,191.04,85.23,105.81,15677.04,WellsFargo2,120,2
46,15677.04,191.04,84.66,106.38,15570.66,WellsFargo2,120,2
47,15570.66,191.04,84.08,106.96,15463.7,WellsFargo2,120,2
48,15463.7,191.04,83.5,107.54,15356.16,WellsFargo2,120,2
49,15356.16,191.04,82.92,108.12,15248.04,WellsFargo2,120,2
50,15248.04,191.04,82.34,108.7,15139.34,WellsFargo2,120,2
51,15139.34,191.04,81.75,109.29,15030.05,WellsFargo2,120,2
52,15030.05,191.04,81.16,109.88,14920.17,WellsFargo2,120,2
53,14920.17,191.04,80.57,110.47,14809.7,WellsFargo2,120,2
54,14809.7,191.04,79.97,111.07,14698.63,WellsFargo2,120,2
55,14698.63,191.04,79.37,111.67,14586.96,WellsFargo2,120,2
56,14586.96,191.04,78.77,112.27,14474.69,WellsFargo2,120,2
57,14474.69,191.04,78.16,112.88,14361.81,WellsFargo2,120,2
58,14361.81,191.04,77.55,113.49,14248.32,WellsFargo2,120,2
59,14248.32,191.04,76.94,114.1,14134.22,WellsFargo2,120,2
60,14134.22,191.04,76.32,114.72,14019.5,WellsFargo2,120,2
61,14019.5,191.04,75.71,115.33,13904.17,WellsFargo2,120,2
62,13904.17,191.04,75.08,115.96,13788.21,WellsFargo2,120,2
63,13788.21,191.04,74.46,116.58,13671.63,WellsFargo2,120,2
64,13671.63,191.04,73.83,117.21,13554.42,WellsFargo2,120,2
65,13554.42,191.04,73.19,117.85,13436.57,WellsFargo2,120,2
66,13436.57,191.04,72.56,118.48,13318.09,WellsFargo2,120,2
67,13318.09,191.04,71.92,119.12,13198.97,WellsFargo2,120,2
68,13198.97,191.04,71.27,119.77,13079.2,WellsFargo2,120,2
69,13079.2,191.04,70.63,120.41,12958.79,WellsFargo2,120,2
70,12958.79,191.04,69.98,121.06,12837.73,WellsFargo2,120,2
71,12837.73,191.04,69.32,121.72,12716.01,WellsFargo2,120,2
72,12716.01,191.04,68.67,122.37,12593.64,WellsFargo2,120,2
73,12593.64,191.04,68.01,123.03,12470.61,WellsFargo2,120,2
74,12470.61,191.04,67.34,123.7,12346.91,WellsFargo2,120,2
75,12346.91,191.04,66.67,124.37,12222.54,WellsFargo2,120,2
76,12222.54,191.04,66.0,125.04,12097.5,WellsFargo2,120,2
77,12097.5,191.04,65.33,125.71,11971.79,WellsFargo2,120,2
78,11971.79,191.04,64.65,126.39,11845.4,WellsFargo2,120,2
79,11845.4,191.04,63.97,127.07,11718.33,WellsFargo2,120,2
80,11718.33,191.04,63.28,127.76,11590.57,WellsFargo2,120,2
81,11590.57,191.04,62.59,128.45,11462.12,WellsFargo2,120,2
82,11462.12,191.04,61.9,129.14,11332.98,WellsFargo2,120,2
83,11332.98,191.04,61.2,129.84,11203.14,WellsFargo2,120,2
84,11203.14,191.04,60.5,130.54,11072.6,WellsFargo2,120,2
85,11072.6,191.04,59.79,131.25,10941.35,WellsFargo2,120,2
86,10941.35,191.04,59.08,131.96,10809.39,WellsFargo2,120,2
87,10809.39,191.04,58.37,132.67,10676.72,WellsFargo2,120,2
88,10676.72,191.04,57.65,133.39,10543.33,WellsFargo2,120,2
89,10543.33,1915.38,56.93,1858.45,8684.88,WellsFargo2,120,2
90,8684.88,2522.48,46.9,2475.58,6209.3,WellsFargo2,120,2
91,6209.3,2522.48,33.53,2488.95,3720.35,WellsFargo2,120,2
92,3720.35,2522.48,20.09,2502.39,1217.96,WellsFargo2,120,2
93,1217.96,2522.48,6.58,2515.9,-1297.94,WellsFargo2,120,2
0,8250.57,84.62,53.63,30.99,8219.58,WellsFargo1,120,3
1,8219.58,84.62,53.43,31.19,8188.39,WellsFargo1,120,3
2,8188.39,84.62,53.22,31.4,8156.99,WellsFargo1,120,3
3,8156.99,84.62,53.02,31.6,8125.39,WellsFargo1,120,3
4,8125.39,84.62,52.82,31.8,8093.59,WellsFargo1,120,3
5,8093.59,84.62,52.61,32.01,8061.58,WellsFargo1,120,3
6,8061.58,84.62,52.4,32.22,8029.36,WellsFargo1,120,3
7,8029.36,84.62,52.19,32.43,7996.93,WellsFargo1,120,3
8,7996.93,84.62,51.98,32.64,7964.29,WellsFargo1,120,3
9,7964.29,84.62,51.77,32.85,7931.44,WellsFargo1,120,3
10,7931.44,84.62,51.55,33.07,7898.37,WellsFargo1,120,3
11,7898.37,84.62,51.34,33.28,7865.09,WellsFargo1,120,3
12,7865.09,84.62,51.12,33.5,7831.59,WellsFargo1,120,3
13,7831.59,84.62,50.91,33.71,7797.88,WellsFargo1,120,3
14,7797.88,84.62,50.69,33.93,7763.95,WellsFargo1,120,3
15,7763.95,84.62,50.47,34.15,7729.8,WellsFargo1,120,3
16,7729.8,84.62,50.24,34.38,7695.42,WellsFargo1,120,3
17,7695.42,84.62,50.02,34.6,7660.82,WellsFargo1,120,3
18,7660.82,84.62,49.8,34.82,7626.0,WellsFargo1,120,3
19,7626.0,84.62,49.57,35.05,7590.95,WellsFargo1,120,3
20,7590.95,84.62,49.34,35.28,7555.67,WellsFargo1,120,3
21,7555.67,84.62,49.11,35.51,7520.16,WellsFargo1,120,3
22,7520.16,84.62,48.88,35.74,7484.42,WellsFargo1,120,3
23,7484.42,84.62,48.65,35.97,7448.45,WellsFargo1,120,3
24,7448.45,84.62,48.41,36.21,7412.24,WellsFargo1,120,3
25,7412.24,84.62,48.18,36.44,7375.8,WellsFargo1,120,3
26,7375.8,84.62,47.94,36.68,7339.12,WellsFargo1,120,3
27,7339.12,84.62,47.7,36.92,7302.2,WellsFargo1,120,3
28,7302.2,84.62,47.46,37.16,7265.04,WellsFargo1,120,3
29,7265.04,84.62,47.22,37.4,7227.64,WellsFargo1,120,3
30,7227.64,84.62,46.98,37.64,7190.0,WellsFargo1,120,3
31,7190.0,84.62,46.73,37.89,7152.11,WellsFargo1,120,3
32,7152.11,84.62,46.49,38.13,7113.98,WellsFargo1,120,3
33,7113.98,84.62,46.24,38.38,7075.6,WellsFargo1,120,3
34,7075.6,84.62,45.99,38.63,7036.97,WellsFargo1,120,3
35,7036.97,84.62,45.74,38.88,6998.09,WellsFargo1,120,3
36,6998.09,84.62,45.49,39.13,6958.96,WellsFargo1,120,3
37,6958.96,84.62,45.23,39.39,6919.57,WellsFargo1,120,3
38,6919.57,84.62,44.98,39.64,6879.93,WellsFargo1,120,3
39,6879.93,84.62,44.72,39.9,6840.03,WellsFargo1,120,3
40,6840.03,84.62,44.46,40.16,6799.87,WellsFargo1,120,3
41,6799.87,84.62,44.2,40.42,6759.45,WellsFargo1,120,3
42,6759.45,84.62,43.94,40.68,6718.77,WellsFargo1,120,3
43,6718.77,84.62,43.67,40.95,6677.82,WellsFargo1,120,3
44,6677.82,84.62,43.41,41.21,6636.61,WellsFargo1,120,3
45,6636.61,84.62,43.14,41.48,6595.13,WellsFargo1,120,3
46,6595.13,84.62,42.87,41.75,6553.38,WellsFargo1,120,3
47,6553.38,84.62,42.6,42.02,6511.36,WellsFargo1,120,3
48,6511.36,84.62,42.32,42.3,6469.06,WellsFargo1,120,3
49,6469.06,84.62,42.05,42.57,6426.49,WellsFargo1,120,3
50,6426.49,84.62,41.77,42.85,6383.64,WellsFargo1,120,3
51,6383.64,84.62,41.49,43.13,6340.51,WellsFargo1,120,3
52,6340.51,84.62,41.21,43.41,6297.1,WellsFargo1,120,3
53,6297.1,84.62,40.93,43.69,6253.41,WellsFargo1,120,3
54,6253.41,84.62,40.65,43.97,6209.44,WellsFargo1,120,3
55,6209.44,84.62,40.36,44.26,6165.18,WellsFargo1,120,3
56,6165.18,84.62,40.07,44.55,6120.63,WellsFargo1,120,3
57,6120.63,84.62,39.78,44.84,6075.79,WellsFargo1,120,3
58,6075.79,84.62,39.49,45.13,6030.66,WellsFargo1,120,3
59,6030.66,84.62,39.2,45.42,5985.24,WellsFargo1,120,3
60,5985.24,84.62,38.9,45.72,5939.52,WellsFargo1,120,3
61,5939.52,84.62,38.61,46.01,5893.51,WellsFargo1,120,3
62,5893.51,84.62,38.31,46.31,5847.2,WellsFargo1,120,3
63,5847.2,84.62,38.01,46.61,5800.59,WellsFargo1,120,3
64,5800.59,84.62,37.7,46.92,5753.67,WellsFargo1,120,3
65,5753.67,84.62,37.4,47.22,5706.45,WellsFargo1,120,3
66,5706.45,84.62,37.09,47.53,5658.92,WellsFargo1,120,3
67,5658.92,84.62,36.78,47.84,5611.08,WellsFargo1,120,3
68,5611.08,84.62,36.47,48.15,5562.93,WellsFargo1,120,3
69,5562.93,84.62,36.16,48.46,5514.47,WellsFargo1,120,3
70,5514.47,84.62,35.84,48.78,5465.69,WellsFargo1,120,3
71,5465.69,84.62,35.53,49.09,5416.6,WellsFargo1,120,3
72,5416.6,84.62,35.21,49.41,5367.19,WellsFargo1,120,3
73,5367.19,84.62,34.89,49.73,5317.46,WellsFargo1,120,3
74,5317.46,84.62,34.56,50.06,5267.4,WellsFargo1,120,3
75,5267.4,84.62,34.24,50.38,5217.02,WellsFargo1,120,3
76,5217.02,84.62,33.91,50.71,5166.31,WellsFargo1,120,3
77,5166.31,84.62,33.58,51.04,5115.27,WellsFargo1,120,3
78,5115.27,84.62,33.25,51.37,5063.9,WellsFargo1,120,3
79,5063.9,84.62,32.92,51.7,5012.2,WellsFargo1,120,3
80,5012.2,84.62,32.58,52.04,4960.16,WellsFargo1,120,3
81,4960.16,84.62,32.24,52.38,4907.78,WellsFargo1,120,3
82,4907.78,84.62,31.9,52.72,4855.06,WellsFargo1,120,3
83,4855.06,84.62,31.56,53.06,4802.0,WellsFargo1,120,3
84,4802.0,84.62,31.21,53.41,4748.59,WellsFargo1,120,3
85,4748.59,84.62,30.87,53.75,4694.84,WellsFargo1,120,3
86,4694.84,84.62,30.52,54.1,4640.74,WellsFargo1,120,3
87,4640.74,84.62,30.16,54.46,4586.28,WellsFargo1,120,3
88,4586.28,84.62,29.81,54.81,4531.47,WellsFargo1,120,3
89,4531.47,84.62,29.45,55.17,4476.3,WellsFargo1,120,3
90,4476.3,84.62,29.1,55.52,4420.78,WellsFargo1,120,3
91,4420.78,84.62,28.74,55.88,4364.9,WellsFargo1,120,3
92,4364.9,84.62,28.37,56.25,4308.65,WellsFargo1,120,3
93,4308.65,1382.56,28.01,1354.55,2954.1,WellsFargo1,120,3
94,2954.1,2607.1,19.2,2587.9,366.2,WellsFargo1,120,3
95,366.2,2607.1,2.38,2604.72,-2238.52,WellsFargo1,120,3
0,5000.0,333.0,36.0,297.0,4703.0,Car,120,4
1,4703.0,333.0,33.86,299.14,4403.86,Car,120,4
2,4403.86,333.0,31.71,301.29,4102.57,Car,120,4
3,4102.57,333.0,29.54,303.46,3799.11,Car,120,4
4,3799.11,333.0,27.35,305.65,3493.46,Car,120,4
5,3493.46,333.0,25.15,307.85,3185.61,Car,120,4
6,3185.61,333.0,22.94,310.06,2875.55,Car,120,4
7,2875.55,333.0,20.7,312.3,2563.25,Car,120,4
8,2563.25,333.0,18.46,314.54,2248.71,Car,120,4
9,2248.71,333.0,16.19,316.81,1931.9,Car,120,4
10,1931.9,333.0,13.91,319.09,1612.81,Car,120,4
11,1612.81,333.0,11.61,321.39,1291.42,Car,120,4
12,1291.42,333.0,9.3,323.7,967.72,Car,120,4
13,967.72,333.0,6.97,326.03,641.69,Car,120,4
14,641.69,333.0,4.62,328.38,313.31,Car,120,4
15,313.31,333.0,2.26,330.74,-17.43,Car,120,4
0,4000.0,70.0,16.0,54.0,3946.0,testing,120,5
1,3946.0,70.0,15.78,54.22,3891.78,testing,120,5
2,3891.78,70.0,15.57,54.43,3837.35,testing,120,5
3,3837.35,70.0,15.35,54.65,3782.7,testing,120,5
4,3782.7,70.0,15.13,54.87,3727.83,testing,120,5
5,3727.83,70.0,14.91,55.09,3672.74,testing,120,5
6,3672.74,70.0,14.69,55.31,3617.43,testing,120,5
7,3617.43,70.0,14.47,55.53,3561.9,testing,120,5
8,3561.9,70.0,14.25,55.75,3506.15,testing,120,5
9,3506.15,70.0,14.02,55.98,3450.17,testing,120,5
10,3450.17,70.0,13.8,56.2,3393.97,testing,120,5
11,3393.97,70.0,13.58,56.42,3337.55,testing,120,5
12,3337.55,70.0,13.35,56.65,3280.9,testing,120,5
13,3280.9,70.0,13.12,56.88,3224.02,testing,120,5
14,3224.02,70.0,12.9,57.1,3166.92,testing,120,5
15,3166.92,87.43,12.67,74.76,3092.16,testing,120,5
16,3092.16,3010.1,12.37,2997.73,94.43,testing,120,5
17,94.43,3010.1,0.38,3009.72,-2915.29,testing,120,5
