Period,Principal,Payment,Interest,Amount_Towards_Principal,Ending Balance,Loan_Name,Index,Inner_Loop_Iteration
0,5000.0,1333.0,36.0,1297.0,3703.0,Car,1,1
1,3703.0,1333.0,26.66,1306.34,2396.66,Car,1,1
2,2396.66,1333.0,17.26,1315.74,1080.92,Car,1,1
3,1080.92,1333.0,7.78,1325.22,-244.3,Car,1,1
0,8250.57,84.62,53.63,30.99,8219.58,WellsFargo1,1,2
1,8219.58,84.62,53.43,31.19,8188.39,WellsFargo1,1,2
2,8188.39,84.62,53.22,31.4,8156.99,WellsFargo1,1,2
3,8156.99,328.92,53.02,275.9,7881.09,WellsFargo1,1,2
4,7881.09,1417.62,51.23,1366.39,6514.7,WellsFargo1,1,2
5,6514.7,1417.62,42.35,1375.27,5139.43,WellsFargo1,1,2
6,5139.43,1417.62,33.41,1384.21,3755.22,WellsFargo1,1,2
7,3755.22,1417.62,24.41,1393.21,2362.01,WellsFargo1,1,2
8,2362.01,1417.62,15.35,1402.27,959.74,WellsFargo1,1,2
9,959.74,1417.62,6.24,1411.38,-451.64,WellsFargo1,1,2
0,20000.0,191.04,108.0,83.04,19916.96,WellsFargo2,1,3
1,19916.96,191.04,107.55,83.49,19833.47,WellsFargo2,1,3
2,19833.47,191.04,107.1,83.94,19749.53,WellsFargo2,1,3
3,19749.53,191.04,106.65,84.39,19665.14,WellsFargo2,1,3
4,19665.14,191.04,106.19,84.85,19580.29,WellsFargo2,1,3
5,19580.29,191.04,105.73,85.31,19494.98,WellsFargo2,1,3
6,19494.98,191.04,105.27,85.77,19409.21,WellsFargo2,1,3
7,19409.21,191.04,104.81,86.23,19322.98,WellsFargo2,1,3
8,19322.98,191.04,104.34,86.7,19236.28,WellsFargo2,1,3
9,19236.28,642.68,103.88,538.8,18697.48,WellsFargo2,1,3
10,18697.48,1608.66,100.97,1507.69,17189.79,WellsFargo2,1,3
11,17189.79,1608.66,92.82,1515.84,15673.95,WellsFargo2,1,3
12,15673.95,1608.66,84.64,1524.02,14149.93,WellsFargo2,1,3
13,14149.93,1608.66,76.41,1532.25,12617.68,WellsFargo2,1,3
14,12617.68,1608.66,68.14,1540.52,11077.16,WellsFargo2,1,3
15,11077.16,1608.66,59.82,1548.84,9528.32,WellsFargo2,1,3
16,9528.32,1608.66,51.45,1557.21,7971.11,WellsFargo2,1,3
17,7971.11,1608.66,43.04,1565.62,6405.49,WellsFargo2,1,3
18,6405.49,1608.66,34.59,1574.07,4831.42,WellsFargo2,1,3
19,4831.42,1608.66,26.09,1582.57,3248.85,WellsFargo2,1,3
20,3248.85,1608.66,17.54,1591.12,1657.73,WellsFargo2,1,3
21,1657.73,1608.66,8.95,1599.71,58.02,WellsFargo2,1,3
22,58.02,1608.66,0.31,1608.35,-1550.33,WellsFargo2,1,3
0,4000.0,70.0,16.0,54.0,3946.0,testing,1,4
1,3946.0,70.0,15.78,54.22,3891.78,testing,1,4
2,3891.78,70.0,15.57,54.43,3837.35,testing,1,4
3,3837.35,70.0,15.35,54.65,3782.7,testing,1,4
4,3782.7,70.0,15.13,54.87,3727.83,testing,1,4
5,3727.83,70.0,14.91,55.09,3672.74,testing,1,4
6,3672.74,70.0,14.69,55.31,3617.43,testing,1,4
7,3617.43,70.0,14.47,55.53,3561.9,testing,1,4
8,3561.9,70.0,14.25,55.75,3506.15,testing,1,4
9,3506.15,70.0,14.02,55.98,3450.17,testing,1,4
10,3450.17,70.0,13.8,56.2,3393.97,testing,1,4
11,3393.97,70.0,13.58,56.42,3337.55,testing,1,4
12,3337.55,70.0,13.35,56.65,3280.9,testing,1,4
13,3280.9,70.0,13.12,56.88,3224.02,testing,1,4
14,3224.02,70.0,12.9,57.1,3166.92,testing,1,4
15,3166.92,70.0,12.67,57.33,3109.59,testing,1,4
16,3109.59,70.0,12.44,57.56,3052.03,testing,1,4
17,3052.03,70.0,12.21,57.79,2994.24,testing,1,4
18,2994.24,70.0,11.98,58.02,2936.22,testing,1,4
19,2936.22,70.0,11.74,58.26,2877.96,testing,1,4
20,2877.96,70.0,11.51,58.49,2819.47,testing,1,4
21,2819.47,70.0,11.28,58.72,2760.75,testing,1,4
22,2760.75,1620.33,11.04,1609.29,1151.46,testing,1,4
23,1151.46,1678.66,4.61,1674.05,-522.59,testing,1,4
0,5000.0,1333.0,36.0,1297.0,3703.0,Car,2,1
1,3703.0,1333.0,26.66,1306.34,2396.66,Car,2,1
2,2396.66,1333.0,17.26,1315.74,1080.92,Car,2,1
3,1080.92,1333.0,7.78,1325.22,-244.3,Car,2,1
0,8250.57,84.62,53.63,30.99,8219.58,WellsFargo1,2,2
1,8219.58,84.62,53.43,31.19,8188.39,WellsFargo1,2,2
2,8188.39,84.62,53.22,31.4,8156.99,WellsFargo1,2,2
3,8156.99,328.92,53.02,275.9,7881.09,WellsFargo1,2,2
4,7881.09,1417.62,51.23,1366.39,6514.7,WellsFargo1,2,2
5,6514.7,1417.62,42.35,1375.27,5139.43,WellsFargo1,2,2
6,5139.43,1417.62,33.41,1384.21,3755.22,WellsFargo1,2,2
7,3755.22,1417.62,24.41,1393.21,2362.01,WellsFargo1,2,2
8,2362.01,1417.62,15.35,1402.27,959.74,WellsFargo1,2,2
9,959.74,1417.62,6.24,1411.38,-451.64,WellsFargo1,2,2
0,4000.0,70.0,16.0,54.0,3946.0,testing,2,3
1,3946.0,70.0,15.78,54.22,3891.78,testing,2,3
2,3891.78,70.0,15.57,54.43,3837.35,testing,2,3
3,3837.35,70.0,15.35,54.65,3782.7,testing,2,3
4,3782.7,70.0,15.13,54.87,3727.83,testing,2,3
5,3727.83,70.0,14.91,55.09,3672.74,testing,2,3
6,3672.74,70.0,14.69,55.31,3617.43,testing,2,3
7,3617.43,70.0,14.47,55.53,3561.9,testing,2,3
8,3561.9,70.0,14.25,55.75,3506.15,testing,2,3
9,3506.15,521.64,14.02,507.62,2998.53,testing,2,3
10,2998.53,1487.62,11.99,1475.63,1522.9,testing,2,3
11,1522.9,1487.62,6.09,1481.53,41.37,testing,2,3
12,41.37,1487.62,0.17,1487.45,-1446.08,testing,2,3
0,20000.0,191.04,108.0,83.04,19916.96,WellsFargo2,2,4
1,19916.96,191.04,107.55,83.49,19833.47,WellsFargo2,2,4
2,19833.47,191.04,107.1,83.94,19749.53,WellsFargo2,2,4
3,19749.53,191.04,106.65,84.39,19665.14,WellsFargo2,2,4
4,19665.14,191.04,106.19,84.85,19580.29,WellsFargo2,2,4
5,19580.29,191.04,105.73,85.31,19494.98,WellsFargo2,2,4
6,19494.98,191.04,105.27,85.77,19409.21,WellsFargo2,2,4
7,19409.21,191.04,104.81,86.23,19322.98,WellsFargo2,2,4
8,19322.98,191.04,104.34,86.7,19236.28,WellsFargo2,2,4
9,19236.28,191.04,103.88,87.16,19149.12,WellsFargo2,2,4
10,19149.12,191.04,103.41,87.63,19061.49,WellsFargo2,2,4
11,19061.49,191.04,102.93,88.11,18973.38,WellsFargo2,2,4
12,18973.38,1637.12,102.46,1534.66,17438.72,WellsFargo2,2,4
13,17438.72,1678.66,94.17,1584.49,15854.23,WellsFargo2,2,4
14,15854.23,1678.66,85.61,1593.05,14261.18,WellsFargo2,2,4
15,14261.18,1678.66,77.01,1601.65,12659.53,WellsFargo2,2,4
16,12659.53,1678.66,68.36,1610.3,11049.23,WellsFargo2,2,4
17,11049.23,1678.66,59.67,1618.99,9430.24,WellsFargo2,2,4
18,9430.24,1678.66,50.92,1627.74,7802.5,WellsFargo2,2,4
19,7802.5,1678.66,42.13,1636.53,6165.97,WellsFargo2,2,4
20,6165.97,1678.66,33.3,1645.36,4520.61,WellsFargo2,2,4
21,4520.61,1678.66,24.41,1654.25,2866.36,WellsFargo2,2,4
22,2866.36,1678.66,15.48,1663.18,1203.18,WellsFargo2,2,4
23,1203.18,1678.66,6.5,1672.16,-468.98,WellsFargo2,2,4
0,5000.0,1333.0,36.0,1297.0,3703.0,Car,3,1
1,3703.0,1333.0,26.66,1306.34,2396.66,Car,3,1
2,2396.66,1333.0,17.26,1315.74,1080.92,Car,3,1
3,1080.92,1333.0,7.78,1325.22,-244.3,Car,3,1
0,20000.0,191.04,108.0,83.04,19916.96,WellsFargo2,3,2
1,19916.96,191.04,107.55,83.49,19833.47,WellsFargo2,3,2
2,19833.47,191.04,107.1,83.94,19749.53,WellsFargo2,3,2
3,19749.53,435.34,106.65,328.69,19420.84,WellsFargo2,3,2
4,19420.84,1524.04,104.87,1419.17,18001.67,WellsFargo2,3,2
5,18001.67,1524.04,97.21,1426.83,16574.84,WellsFargo2,3,2
6,16574.84,1524.04,89.5,1434.54,15140.3,WellsFargo2,3,2
7,15140.3,1524.04,81.76,1442.28,13698.02,WellsFargo2,3,2
8,13698.02,1524.04,73.97,1450.07,12247.95,WellsFargo2,3,2
9,12247.95,1524.04,66.14,1457.9,10790.05,WellsFargo2,3,2
10,10790.05,1524.04,58.27,1465.77,9324.28,WellsFargo2,3,2
11,9324.28,1524.04,50.35,1473.69,7850.59,WellsFargo2,3,2
12,7850.59,1524.04,42.39,1481.65,6368.94,WellsFargo2,3,2
13,6368.94,1524.04,34.39,1489.65,4879.29,WellsFargo2,3,2
14,4879.29,1524.04,26.35,1497.69,3381.6,WellsFargo2,3,2
15,3381.6,1524.04,18.26,1505.78,1875.82,WellsFargo2,3,2
16,1875.82,1524.04,10.13,1513.91,361.91,WellsFargo2,3,2
17,361.91,1524.04,1.95,1522.09,-1160.18,WellsFargo2,3,2
0,8250.57,84.62,53.63,30.99,8219.58,WellsFargo1,3,3
1,8219.58,84.62,53.43,31.19,8188.39,WellsFargo1,3,3
2,8188.39,84.62,53.22,31.4,8156.99,WellsFargo1,3,3
3,8156.99,84.62,53.02,31.6,8125.39,WellsFargo1,3,3
4,8125.39,84.62,52.82,31.8,8093.59,WellsFargo1,3,3
5,8093.59,84.62,52.61,32.01,8061.58,WellsFargo1,3,3
6,8061.58,84.62,52.4,32.22,8029.36,WellsFargo1,3,3
7,8029.36,84.62,52.19,32.43,7996.93,WellsFargo1,3,3
8,7996.93,84.62,51.98,32.64,7964.29,WellsFargo1,3,3
9,7964.29,84.62,51.77,32.85,7931.44,WellsFargo1,3,3
10,7931.44,84.62,51.55,33.07,7898.37,WellsFargo1,3,3
11,7898.37,84.62,51.34,33.28,7865.09,WellsFargo1,3,3
12,7865.09,84.62,51.12,33.5,7831.59,WellsFargo1,3,3
13,7831.59,84.62,50.91,33.71,7797.88,WellsFargo1,3,3
14,7797.88,84.62,50.69,33.93,7763.95,WellsFargo1,3,3
15,7763.95,84.62,50.47,34.15,7729.8,WellsFargo1,3,3
16,7729.8,84.62,50.24,34.38,7695.42,WellsFargo1,3,3
17,7695.42,1244.8,50.02,1194.78,6500.64,WellsFargo1,3,3
18,6500.64,1608.66,42.25,1566.41,4934.23,WellsFargo1,3,3
19,4934.23,1608.66,32.07,1576.59,3357.64,WellsFargo1,3,3
20,3357.64,1608.66,21.82,1586.84,1770.8,WellsFargo1,3,3
21,1770.8,1608.66,11.51,1597.15,173.65,WellsFargo1,3,3
22,173.65,1608.66,1.13,1607.53,-1433.88,WellsFargo1,3,3
0,4000.0,70.0,16.0,54.0,3946.0,testing,3,4
1,3946.0,70.0,15.78,54.22,3891.78,testing,3,4
2,3891.78,70.0,15.57,54.43,3837.35,testing,3,4
3,3837.35,70.0,15.35,54.65,3782.7,testing,3,4
4,3782.7,70.0,15.13,54.87,3727.83,testing,3,4
5,3727.83,70.0,14.91,55.09,3672.74,testing,3,4
6,3672.74,70.0,14.69,55.31,3617.43,testing,3,4
7,3617.43,70.0,14.47,55.53,3561.9,testing,3,4
8,3561.9,70.0,14.25,55.75,3506.15,testing,3,4
9,3506.15,70.0,14.02,55.98,3450.17,testing,3,4
10,3450.17,70.0,13.8,56.2,3393.97,testing,3,4
11,3393.97,70.0,13.58,56.42,3337.55,testing,3,4
12,3337.55,70.0,13.35,56.65,3280.9,testing,3,4
13,3280.9,70.0,13.12,56.88,3224.02,testing,3,4
14,3224.02,70.0,12.9,57.1,3166.92,testing,3,4
15,3166.92,70.0,12.67,57.33,3109.59,testing,3,4
16,3109.59,70.0,12.44,57.56,3052.03,testing,3,4
17,3052.03,70.0,12.21,57.79,2994.24,testing,3,4
18,2994.24,70.0,11.98,58.02,2936.22,testing,3,4
19,2936.22,70.0,11.74,58.26,2877.96,testing,3,4
20,2877.96,70.0,11.51,58.49,2819.47,testing,3,4
21,2819.47,70.0,11.28,58.72,2760.75,testing,3,4
22,2760.75,1503.88,11.04,1492.84,1267.91,testing,3,4
23,1267.91,1678.66,5.07,1673.59,-405.68,testing,3,4
0,5000.0,1333.0,36.0,1297.0,3703.0,Car,4,1
1,3703.0,1333.0,26.66,1306.34,2396.66,Car,4,1
2,2396.66,1333.0,17.26,1315.74,1080.92,Car,4,1
3,1080.92,1333.0,7.78,1325.22,-244.3,Car,4,1
0,20000.0,191.04,108.0,83.04,19916.96,WellsFargo2,4,2
1,19916.96,191.04,107.55,83.49,19833.47,WellsFargo2,4,2
2,19833.47,191.04,107.1,83.94,19749.53,WellsFargo2,4,2
3,19749.53,435.34,106.65,328.69,19420.84,WellsFargo2,4,2
4,19420.84,1524.04,104.87,1419.17,18001.67,WellsFargo2,4,2
5,18001.67,1524.04,97.21,1426.83,16574.84,WellsFargo2,4,2
6,16574.84,1524.04,89.5,1434.54,15140.3,WellsFargo2,4,2
7,15140.3,1524.04,81.76,1442.28,13698.02,WellsFargo2,4,2
8,13698.02,1524.04,73.97,1450.07,12247.95,WellsFargo2,4,2
9,12247.95,1524.04,66.14,1457.9,10790.05,WellsFargo2,4,2
10,10790.05,1524.04,58.27,1465.77,9324.28,WellsFargo2,4,2
11,9324.28,1524.04,50.35,1473.69,7850.59,WellsFargo2,4,2
12,7850.59,1524.04,42.39,1481.65,6368.94,WellsFargo2,4,2
13,6368.94,1524.04,34.39,1489.65,4879.29,WellsFargo2,4,2
14,4879.29,1524.04,26.35,1497.69,3381.6,WellsFargo2,4,2
15,3381.6,1524.04,18.26,1505.78,1875.82,WellsFargo2,4,2
16,1875.82,1524.04,10.13,1513.91,361.91,WellsFargo2,4,2
17,361.91,1524.04,1.95,1522.09,-1160.18,WellsFargo2,4,2
0,4000.0,70.0,16.0,54.0,3946.0,testing,4,3
1,3946.0,70.0,15.78,54.22,3891.78,testing,4,3
2,3891.78,70.0,15.57,54.43,3837.35,testing,4,3
3,3837.35,70.0,15.35,54.65,3782.7,testing,4,3
4,3782.7,70.0,15.13,54.87,3727.83,testing,4,3
5,3727.83,70.0,14.91,55.09,3672.74,testing,4,3
6,3672.74,70.0,14.69,55.31,3617.43,testing,4,3
7,3617.43,70.0,14.47,55.53,3561.9,testing,4,3
8,3561.9,70.0,14.25,55.75,3506.15,testing,4,3
9,3506.15,70.0,14.02,55.98,3450.17,testing,4,3
10,3450.17,70.0,13.8,56.2,3393.97,testing,4,3
11,3393.97,70.0,13.58,56.42,3337.55,testing,4,3
12,3337.55,70.0,13.35,56.65,3280.9,testing,4,3
13,3280.9,70.0,13.12,56.88,3224.02,testing,4,3
14,3224.02,70.0,12.9,57.1,3166.92,testing,4,3
15,3166.92,70.0,12.67,57.33,3109.59,testing,4,3
16,3109.59,70.0,12.44,57.56,3052.03,testing,4,3
17,3052.03,1230.18,12.21,1217.97,1834.06,testing,4,3
18,1834.06,1594.04,7.34,1586.7,247.36,testing,4,3
19,247.36,1594.04,0.99,1593.05,-1345.69,testing,4,3
0,8250.57,84.62,53.63,30.99,8219.58,WellsFargo1,4,4
1,8219.58,84.62,53.43,31.19,8188.39,WellsFargo1,4,4
2,8188.39,84.62,53.22,31.4,8156.99,WellsFargo1,4,4
3,8156.99,84.62,53.02,31.6,8125.39,WellsFargo1,4,4
4,8125.39,84.62,52.82,31.8,8093.59,WellsFargo1,4,4
5,8093.59,84.62,52.61,32.01,8061.58,WellsFargo1,4,4
6,8061.58,84.62,52.4,32.22,8029.36,WellsFargo1,4,4
7,8029.36,84.62,52.19,32.43,7996.93,WellsFargo1,4,4
8,7996.93,84.62,51.98,32.64,7964.29,WellsFargo1,4,4
9,7964.29,84.62,51.77,32.85,7931.44,WellsFargo1,4,4
10,7931.44,84.62,51.55,33.07,7898.37,WellsFargo1,4,4
11,7898.37,84.62,51.34,33.28,7865.09,WellsFargo1,4,4
12,7865.09,84.62,51.12,33.5,7831.59,WellsFargo1,4,4
13,7831.59,84.62,50.91,33.71,7797.88,WellsFargo1,4,4
14,7797.88,84.62,50.69,33.93,7763.95,WellsFargo1,4,4
15,7763.95,84.62,50.47,34.15,7729.8,WellsFargo1,4,4
16,7729.8,84.62,50.24,34.38,7695.42,WellsFargo1,4,4
17,7695.42,84.62,50.02,34.6,7660.82,WellsFargo1,4,4
18,7660.82,84.62,49.8,34.82,7626.0,WellsFargo1,4,4
19,7626.0,1430.31,49.57,1380.74,6245.26,WellsFargo1,4,4
20,6245.26,1678.66,40.59,1638.07,4607.19,WellsFargo1,4,4
21,4607.19,1678.66,29.95,1648.71,2958.48,WellsFargo1,4,4
22,2958.48,1678.66,19.23,1659.43,1299.05,WellsFargo1,4,4
23,1299.05,1678.66,8.44,1670.22,-371.17,WellsFargo1,4,4
0,5000.0,1333.0,36.0,1297.0,3703.0,Car,5,1
1,3703.0,1333.0,26.66,1306.34,2396.66,Car,5,1
2,2396.66,1333.0,17.26,1315.74,1080.92,Car,5,1
3,1080.92,1333.0,7.78,1325.22,-244.3,Car,5,1
0,4000.0,70.0,16.0,54.0,3946.0,testing,5,2
1,3946.0,70.0,15.78,54.22,3891.78,testing,5,2
2,3891.78,70.0,15.57,54.43,3837.35,testing,5,2
3,3837.35,314.3,15.35,298.95,3538.4,testing,5,2
4,3538.4,1403.0,14.15,1388.85,2149.55,testing,5,2
5,2149.55,1403.0,8.6,1394.4,755.15,testing,5,2
6,755.15,1403.0,3.02,1399.98,-644.83,testing,5,2
0,8250.57,84.62,53.63,30.99,8219.58,WellsFargo1,5,3
1,8219.58,84.62,53.43,31.19,8188.39,WellsFargo1,5,3
2,8188.39,84.62,53.22,31.4,8156.99,WellsFargo1,5,3
3,8156.99,84.62,53.02,31.6,8125.39,WellsFargo1,5,3
4,8125.39,84.62,52.82,31.8,8093.59,WellsFargo1,5,3
5,8093.59,84.62,52.61,32.01,8061.58,WellsFargo1,5,3
6,8061.58,729.45,52.4,677.05,7384.53,WellsFargo1,5,3
7,7384.53,1487.62,48.0,1439.62,5944.91,WellsFargo1,5,3
8,5944.91,1487.62,38.64,1448.98,4495.93,WellsFargo1,5,3
9,4495.93,1487.62,29.22,1458.4,3037.53,WellsFargo1,5,3
10,3037.53,1487.62,19.74,1467.88,1569.65,WellsFargo1,5,3
11,1569.65,1487.62,10.2,1477.42,92.23,WellsFargo1,5,3
12,92.23,1487.62,0.6,1487.02,-1394.79,WellsFargo1,5,3
0,20000.0,191.04,108.0,83.04,19916.96,WellsFargo2,5,4
1,19916.96,191.04,107.55,83.49,19833.47,WellsFargo2,5,4
2,19833.47,191.04,107.1,83.94,19749.53,WellsFargo2,5,4
3,19749.53,191.04,106.65,84.39,19665.14,WellsFargo2,5,4
4,19665.14,191.04,106.19,84.85,19580.29,WellsFargo2,5,4
5,19580.29,191.04,105.73,85.31,19494.98,WellsFargo2,5,4
6,19494.98,191.04,105.27,85.77,19409.21,WellsFargo2,5,4
7,19409.21,191.04,104.81,86.23,19322.98,WellsFargo2,5,4
8,19322.98,191.04,104.34,86.7,19236.28,WellsFargo2,5,4
9,19236.28,191.04,103.88,87.16,19149.12,WellsFargo2,5,4
10,19149.12,191.04,103.41,87.63,19061.49,WellsFargo2,5,4
11,19061.49,191.04,102.93,88.11,18973.38,WellsFargo2,5,4
12,18973.38,1585.83,102.46,1483.37,17490.01,WellsFargo2,5,4
13,17490.01,1678.66,94.45,1584.21,15905.8,WellsFargo2,5,4
14,15905.8,1678.66,85.89,1592.77,14313.03,WellsFargo2,5,4
15,14313.03,1678.66,77.29,1601.37,12711.66,WellsFargo2,5,4
16,12711.66,1678.66,68.64,1610.02,11101.64,WellsFargo2,5,4
17,11101.64,1678.66,59.95,1618.71,9482.93,WellsFargo2,5,4
18,9482.93,1678.66,51.21,1627.45,7855.48,WellsFargo2,5,4
19,7855.48,1678.66,42.42,1636.24,6219.24,WellsFargo2,5,4
20,6219.24,1678.66,33.58,1645.08,4574.16,WellsFargo2,5,4
21,4574.16,1678.66,24.7,1653.96,2920.2,WellsFargo2,5,4
22,2920.2,1678.66,15.77,1662.89,1257.31,WellsFargo2,5,4
23,1257.31,1678.66,6.79,1671.87,-414.56,WellsFargo2,5,4
0,5000.0,1333.0,36.0,1297.0,3703.0,Car,6,1
1,3703.0,1333.0,26.66,1306.34,2396.66,Car,6,1
2,2396.66,1333.0,17.26,1315.74,1080.92,Car,6,1
3,1080.92,1333.0,7.78,1325.22,-244.3,Car,6,1
0,4000.0,70.0,16.0,54.0,3946.0,testing,6,2
1,3946.0,70.0,15.78,54.22,3891.78,testing,6,2
2,3891.78,70.0,15.57,54.43,3837.35,testing,6,2
3,3837.35,314.3,15.35,298.95,3538.4,testing,6,2
4,3538.4,1403.0,14.15,1388.85,2149.55,testing,6,2
5,2149.55,1403.0,8.6,1394.4,755.15,testing,6,2
6,755.15,1403.0,3.02,1399.98,-644.83,testing,6,2
0,20000.0,191.04,108.0,83.04,19916.96,WellsFargo2,6,3
1,19916.96,191.04,107.55,83.49,19833.47,WellsFargo2,6,3
2,19833.47,191.04,107.1,83.94,19749.53,WellsFargo2,6,3
3,19749.53,191.04,106.65,84.39,19665.14,WellsFargo2,6,3
4,19665.14,191.04,106.19,84.85,19580.29,WellsFargo2,6,3
5,19580.29,191.04,105.73,85.31,19494.98,WellsFargo2,6,3
6,19494.98,835.87,105.27,730.6,18764.38,WellsFargo2,6,3
7,18764.38,1594.04,101.33,1492.71,17271.67,WellsFargo2,6,3
8,17271.67,1594.04,93.27,1500.77,15770.9,WellsFargo2,6,3
9,15770.9,1594.04,85.16,1508.88,14262.02,WellsFargo2,6,3
10,14262.02,1594.04,77.01,1517.03,12744.99,WellsFargo2,6,3
11,12744.99,1594.04,68.82,1525.22,11219.77,WellsFargo2,6,3
12,11219.77,1594.04,60.59,1533.45,9686.32,WellsFargo2,6,3
13,9686.32,1594.04,52.31,1541.73,8144.59,WellsFargo2,6,3
14,8144.59,1594.04,43.98,1550.06,6594.53,WellsFargo2,6,3
15,6594.53,1594.04,35.61,1558.43,5036.1,WellsFargo2,6,3
16,5036.1,1594.04,27.19,1566.85,3469.25,WellsFargo2,6,3
17,3469.25,1594.04,18.73,1575.31,1893.94,WellsFargo2,6,3
18,1893.94,1594.04,10.23,1583.81,310.13,WellsFargo2,6,3
19,310.13,1594.04,1.67,1592.37,-1282.24,WellsFargo2,6,3
0,8250.57,84.62,53.63,30.99,8219.58,WellsFargo1,6,4
1,8219.58,84.62,53.43,31.19,8188.39,WellsFargo1,6,4
2,8188.39,84.62,53.22,31.4,8156.99,WellsFargo1,6,4
3,8156.99,84.62,53.02,31.6,8125.39,WellsFargo1,6,4
4,8125.39,84.62,52.82,31.8,8093.59,WellsFargo1,6,4
5,8093.59,84.62,52.61,32.01,8061.58,WellsFargo1,6,4
6,8061.58,84.62,52.4,32.22,8029.36,WellsFargo1,6,4
7,8029.36,84.62,52.19,32.43,7996.93,WellsFargo1,6,4
8,7996.93,84.62,51.98,32.64,7964.29,WellsFargo1,6,4
9,7964.29,84.62,51.77,32.85,7931.44,WellsFargo1,6,4
10,7931.44,84.62,51.55,33.07,7898.37,WellsFargo1,6,4
11,7898.37,84.62,51.34,33.28,7865.09,WellsFargo1,6,4
12,7865.09,84.62,51.12,33.5,7831.59,WellsFargo1,6,4
13,7831.59,84.62,50.91,33.71,7797.88,WellsFargo1,6,4
14,7797.88,84.62,50.69,33.93,7763.95,WellsFargo1,6,4
15,7763.95,84.62,50.47,34.15,7729.8,WellsFargo1,6,4
16,7729.8,84.62,50.24,34.38,7695.42,WellsFargo1,6,4
17,7695.42,84.62,50.02,34.6,7660.82,WellsFargo1,6,4
18,7660.82,84.62,49.8,34.82,7626.0,WellsFargo1,6,4
19,7626.0,1366.86,49.57,1317.29,6308.71,WellsFargo1,6,4
20,6308.71,1678.66,41.01,1637.65,4671.06,WellsFargo1,6,4
21,4671.06,1678.66,30.36,1648.3,3022.76,WellsFargo1,6,4
22,3022.76,1678.66,19.65,1659.01,1363.75,WellsFargo1,6,4
23,1363.75,1678.66,8.86,1669.8,-306.05,WellsFargo1,6,4
0,8250.57,1084.62,53.63,1030.99,7219.58,WellsFargo1,7,1
1,7219.58,1084.62,46.93,1037.69,6181.89,WellsFargo1,7,1
2,6181.89,1084.62,40.18,1044.44,5137.45,WellsFargo1,7,1
3,5137.45,1084.62,33.39,1051.23,4086.22,WellsFargo1,7,1
4,4086.22,1084.62,26.56,1058.06,3028.16,WellsFargo1,7,1
5,3028.16,1084.62,19.68,1064.94,1963.22,WellsFargo1,7,1
6,1963.22,1084.62,12.76,1071.86,891.36,WellsFargo1,7,1
7,891.36,1084.62,5.79,1078.83,-187.47,WellsFargo1,7,1
0,5000.0,333.0,36.0,297.0,4703.0,Car,7,2
1,4703.0,333.0,33.86,299.14,4403.86,Car,7,2
2,4403.86,333.0,31.71,301.29,4102.57,Car,7,2
3,4102.57,333.0,29.54,303.46,3799.11,Car,7,2
4,3799.11,333.0,27.35,305.65,3493.46,Car,7,2
5,3493.46,333.0,25.15,307.85,3185.61,Car,7,2
6,3185.61,333.0,22.94,310.06,2875.55,Car,7,2
7,2875.55,520.47,20.7,499.77,2375.78,Car,7,2
8,2375.78,1417.62,17.11,1400.51,975.27,Car,7,2
9,975.27,1417.62,7.02,1410.6,-435.33,Car,7,2
0,20000.0,191.04,108.0,83.04,19916.96,WellsFargo2,7,3
1,19916.96,191.04,107.55,83.49,19833.47,WellsFargo2,7,3
2,19833.47,191.04,107.1,83.94,19749.53,WellsFargo2,7,3
3,19749.53,191.04,106.65,84.39,19665.14,WellsFargo2,7,3
4,19665.14,191.04,106.19,84.85,19580.29,WellsFargo2,7,3
5,19580.29,191.04,105.73,85.31,19494.98,WellsFargo2,7,3
6,19494.98,191.04,105.27,85.77,19409.21,WellsFargo2,7,3
7,19409.21,191.04,104.81,86.23,19322.98,WellsFargo2,7,3
8,19322.98,191.04,104.34,86.7,19236.28,WellsFargo2,7,3
9,19236.28,626.37,103.88,522.49,18713.79,WellsFargo2,7,3
10,18713.79,1608.66,101.05,1507.61,17206.18,WellsFargo2,7,3
11,17206.18,1608.66,92.91,1515.75,15690.43,WellsFargo2,7,3
12,15690.43,1608.66,84.73,1523.93,14166.5,WellsFargo2,7,3
13,14166.5,1608.66,76.5,1532.16,12634.34,WellsFargo2,7,3
14,12634.34,1608.66,68.23,1540.43,11093.91,WellsFargo2,7,3
15,11093.91,1608.66,59.91,1548.75,9545.16,WellsFargo2,7,3
16,9545.16,1608.66,51.54,1557.12,7988.04,WellsFargo2,7,3
17,7988.04,1608.66,43.14,1565.52,6422.52,WellsFargo2,7,3
18,6422.52,1608.66,34.68,1573.98,4848.54,WellsFargo2,7,3
19,4848.54,1608.66,26.18,1582.48,3266.06,WellsFargo2,7,3
20,3266.06,1608.66,17.64,1591.02,1675.04,WellsFargo2,7,3
21,1675.04,1608.66,9.05,1599.61,75.43,WellsFargo2,7,3
22,75.43,1608.66,0.41,1608.25,-1532.82,WellsFargo2,7,3
0,4000.0,70.0,16.0,54.0,3946.0,testing,7,4
1,3946.0,70.0,15.78,54.22,3891.78,testing,7,4
2,3891.78,70.0,15.57,54.43,3837.35,testing,7,4
3,3837.35,70.0,15.35,54.65,3782.7,testing,7,4
4,3782.7,70.0,15.13,54.87,3727.83,testing,7,4
5,3727.83,70.0,14.91,55.09,3672.74,testing,7,4
6,3672.74,70.0,14.69,55.31,3617.43,testing,7,4
7,3617.43,70.0,14.47,55.53,3561.9,testing,7,4
8,3561.9,70.0,14.25,55.75,3506.15,testing,7,4
9,3506.15,70.0,14.02,55.98,3450.17,testing,7,4
10,3450.17,70.0,13.8,56.2,3393.97,testing,7,4
11,3393.97,70.0,13.58,56.42,3337.55,testing,7,4
12,3337.55,70.0,13.35,56.65,3280.9,testing,7,4
13,3280.9,70.0,13.12,56.88,3224.02,testing,7,4
14,3224.02,70.0,12.9,57.1,3166.92,testing,7,4
15,3166.92,70.0,12.67,57.33,3109.59,testing,7,4
16,3109.59,70.0,12.44,57.56,3052.03,testing,7,4
17,3052.03,70.0,12.21,57.79,2994.24,testing,7,4
18,2994.24,70.0,11.98,58.02,2936.22,testing,7,4
19,2936.22,70.0,11.74,58.26,2877.96,testing,7,4
20,2877.96,70.0,11.51,58.49,2819.47,testing,7,4
21,2819.47,70.0,11.28,58.72,2760.75,testing,7,4
22,2760.75,1602.82,11.04,1591.78,1168.97,testing,7,4
23,1168.97,1678.66,4.68,1673.98,-505.01,testing,7,4
0,8250.57,1084.62,53.63,1030.99,7219.58,WellsFargo1,8,1
1,7219.58,1084.62,46.93,1037.69,6181.89,WellsFargo1,8,1
2,6181.89,1084.62,40.18,1044.44,5137.45,WellsFargo1,8,1
3,5137.45,1084.62,33.39,1051.23,4086.22,WellsFargo1,8,1
4,4086.22,1084.62,26.56,1058.06,3028.16,WellsFargo1,8,1
5,3028.16,1084.62,19.68,1064.94,1963.22,WellsFargo1,8,1
6,1963.22,1084.62,12.76,1071.86,891.36,WellsFargo1,8,1
7,891.36,1084.62,5.79,1078.83,-187.47,WellsFargo1,8,1
0,5000.0,333.0,36.0,297.0,4703.0,Car,8,2
1,4703.0,333.0,33.86,299.14,4403.86,Car,8,2
2,4403.86,333.0,31.71,301.29,4102.57,Car,8,2
3,4102.57,333.0,29.54,303.46,3799.11,Car,8,2
4,3799.11,333.0,27.35,305.65,3493.46,Car,8,2
5,3493.46,333.0,25.15,307.85,3185.61,Car,8,2
6,3185.61,333.0,22.94,310.06,2875.55,Car,8,2
7,2875.55,520.47,20.7,499.77,2375.78,Car,8,2
8,2375.78,1417.62,17.11,1400.51,975.27,Car,8,2
9,975.27,1417.62,7.02,1410.6,-435.33,Car,8,2
0,4000.0,70.0,16.0,54.0,3946.0,testing,8,3
1,3946.0,70.0,15.78,54.22,3891.78,testing,8,3
2,3891.78,70.0,15.57,54.43,3837.35,testing,8,3
3,3837.35,70.0,15.35,54.65,3782.7,testing,8,3
4,3782.7,70.0,15.13,54.87,3727.83,testing,8,3
5,3727.83,70.0,14.91,55.09,3672.74,testing,8,3
6,3672.74,70.0,14.69,55.31,3617.43,testing,8,3
7,3617.43,70.0,14.47,55.53,3561.9,testing,8,3
8,3561.9,70.0,14.25,55.75,3506.15,testing,8,3
9,3506.15,505.33,14.02,491.31,3014.84,testing,8,3
10,3014.84,1487.62,12.06,1475.56,1539.28,testing,8,3
11,1539.28,1487.62,6.16,1481.46,57.82,testing,8,3
12,57.82,1487.62,0.23,1487.39,-1429.57,testing,8,3
0,20000.0,191.04,108.0,83.04,19916.96,WellsFargo2,8,4
1,19916.96,191.04,107.55,83.49,19833.47,WellsFargo2,8,4
2,19833.47,191.04,107.1,83.94,19749.53,WellsFargo2,8,4
3,19749.53,191.04,106.65,84.39,19665.14,WellsFargo2,8,4
4,19665.14,191.04,106.19,84.85,19580.29,WellsFargo2,8,4
5,19580.29,191.04,105.73,85.31,19494.98,WellsFargo2,8,4
6,19494.98,191.04,105.27,85.77,19409.21,WellsFargo2,8,4
7,19409.21,191.04,104.81,86.23,19322.98,WellsFargo2,8,4
8,19322.98,191.04,104.34,86.7,19236.28,WellsFargo2,8,4
9,19236.28,191.04,103.88,87.16,19149.12,WellsFargo2,8,4
10,19149.12,191.04,103.41,87.63,19061.49,WellsFargo2,8,4
11,19061.49,191.04,102.93,88.11,18973.38,WellsFargo2,8,4
12,18973.38,1620.61,102.46,1518.15,17455.23,WellsFargo2,8,4
13,17455.23,1678.66,94.26,1584.4,15870.83,WellsFargo2,8,4
14,15870.83,1678.66,85.7,1592.96,14277.87,WellsFargo2,8,4
15,14277.87,1678.66,77.1,1601.56,12676.31,WellsFargo2,8,4
16,12676.31,1678.66,68.45,1610.21,11066.1,WellsFargo2,8,4
17,11066.1,1678.66,59.76,1618.9,9447.2,WellsFargo2,8,4
18,9447.2,1678.66,51.01,1627.65,7819.55,WellsFargo2,8,4
19,7819.55,1678.66,42.23,1636.43,6183.12,WellsFargo2,8,4
20,6183.12,1678.66,33.39,1645.27,4537.85,WellsFargo2,8,4
21,4537.85,1678.66,24.5,1654.16,2883.69,WellsFargo2,8,4
22,2883.69,1678.66,15.57,1663.09,1220.6,WellsFargo2,8,4
23,1220.6,1678.66,6.59,1672.07,-451.47,WellsFargo2,8,4
0,8250.57,1084.62,53.63,1030.99,7219.58,WellsFargo1,9,1
1,7219.58,1084.62,46.93,1037.69,6181.89,WellsFargo1,9,1
2,6181.89,1084.62,40.18,1044.44,5137.45,WellsFargo1,9,1
3,5137.45,1084.62,33.39,1051.23,4086.22,WellsFargo1,9,1
4,4086.22,1084.62,26.56,1058.06,3028.16,WellsFargo1,9,1
5,3028.16,1084.62,19.68,1064.94,1963.22,WellsFargo1,9,1
6,1963.22,1084.62,12.76,1071.86,891.36,WellsFargo1,9,1
7,891.36,1084.62,5.79,1078.83,-187.47,WellsFargo1,9,1
0,20000.0,191.04,108.0,83.04,19916.96,WellsFargo2,9,2
1,19916.96,191.04,107.55,83.49,19833.47,WellsFargo2,9,2
2,19833.47,191.04,107.1,83.94,19749.53,WellsFargo2,9,2
3,19749.53,191.04,106.65,84.39,19665.14,WellsFargo2,9,2
4,19665.14,191.04,106.19,84.85,19580.29,WellsFargo2,9,2
5,19580.29,191.04,105.73,85.31,19494.98,WellsFargo2,9,2
6,19494.98,191.04,105.27,85.77,19409.21,WellsFargo2,9,2
7,19409.21,378.51,104.81,273.7,19135.51,WellsFargo2,9,2
8,19135.51,1275.66,103.33,1172.33,17963.18,WellsFargo2,9,2
9,17963.18,1275.66,97.0,1178.66,16784.52,WellsFargo2,9,2
10,16784.52,1275.66,90.64,1185.02,15599.5,WellsFargo2,9,2
11,15599.5,1275.66,84.24,1191.42,14408.08,WellsFargo2,9,2
12,14408.08,1275.66,77.8,1197.86,13210.22,WellsFargo2,9,2
13,13210.22,1275.66,71.34,1204.32,12005.9,WellsFargo2,9,2
14,12005.9,1275.66,64.83,1210.83,10795.07,WellsFargo2,9,2
15,10795.07,1275.66,58.29,1217.37,9577.7,WellsFargo2,9,2
16,9577.7,1275.66,51.72,1223.94,8353.76,WellsFargo2,9,2
17,8353.76,1275.66,45.11,1230.55,7123.21,WellsFargo2,9,2
18,7123.21,1275.66,38.47,1237.19,5886.02,WellsFargo2,9,2
19,5886.02,1275.66,31.78,1243.88,4642.14,WellsFargo2,9,2
20,4642.14,1275.66,25.07,1250.59,3391.55,WellsFargo2,9,2
21,3391.55,1275.66,18.31,1257.35,2134.2,WellsFargo2,9,2
22,2134.2,1275.66,11.52,1264.14,870.06,WellsFargo2,9,2
23,870.06,1275.66,4.7,1270.96,-400.9,WellsFargo2,9,2
0,5000.0,333.0,36.0,297.0,4703.0,Car,9,3
1,4703.0,333.0,33.86,299.14,4403.86,Car,9,3
2,4403.86,333.0,31.71,301.29,4102.57,Car,9,3
3,4102.57,333.0,29.54,303.46,3799.11,Car,9,3
4,3799.11,333.0,27.35,305.65,3493.46,Car,9,3
5,3493.46,333.0,25.15,307.85,3185.61,Car,9,3
6,3185.61,333.0,22.94,310.06,2875.55,Car,9,3
7,2875.55,333.0,20.7,312.3,2563.25,Car,9,3
8,2563.25,333.0,18.46,314.54,2248.71,Car,9,3
9,2248.71,333.0,16.19,316.81,1931.9,Car,9,3
10,1931.9,333.0,13.91,319.09,1612.81,Car,9,3
11,1612.81,333.0,11.61,321.39,1291.42,Car,9,3
12,1291.42,333.0,9.3,323.7,967.72,Car,9,3
13,967.72,333.0,6.97,326.03,641.69,Car,9,3
14,641.69,333.0,4.62,328.38,313.31,Car,9,3
15,313.31,333.0,2.26,330.74,-17.43,Car,9,3
0,4000.0,70.0,16.0,54.0,3946.0,testing,9,4
1,3946.0,70.0,15.78,54.22,3891.78,testing,9,4
2,3891.78,70.0,15.57,54.43,3837.35,testing,9,4
3,3837.35,70.0,15.35,54.65,3782.7,testing,9,4
4,3782.7,70.0,15.13,54.87,3727.83,testing,9,4
5,3727.83,70.0,14.91,55.09,3672.74,testing,9,4
6,3672.74,70.0,14.69,55.31,3617.43,testing,9,4
7,3617.43,70.0,14.47,55.53,3561.9,testing,9,4
8,3561.9,70.0,14.25,55.75,3506.15,testing,9,4
9,3506.15,70.0,14.02,55.98,3450.17,testing,9,4
10,3450.17,70.0,13.8,56.2,3393.97,testing,9,4
11,3393.97,70.0,13.58,56.42,3337.55,testing,9,4
12,3337.55,70.0,13.35,56.65,3280.9,testing,9,4
13,3280.9,70.0,13.12,56.88,3224.02,testing,9,4
14,3224.02,70.0,12.9,57.1,3166.92,testing,9,4
15,3166.92,87.43,12.67,74.76,3092.16,testing,9,4
16,3092.16,1678.66,12.37,1666.29,1425.87,testing,9,4
17,1425.87,1678.66,5.7,1672.96,-247.09,testing,9,4
0,8250.57,1084.62,53.63,1030.99,7219.58,WellsFargo1,10,1
1,7219.58,1084.62,46.93,1037.69,6181.89,WellsFargo1,10,1
2,6181.89,1084.62,40.18,1044.44,5137.45,WellsFargo1,10,1
3,5137.45,1084.62,33.39,1051.23,4086.22,WellsFargo1,10,1
4,4086.22,1084.62,26.56,1058.06,3028.16,WellsFargo1,10,1
5,3028.16,1084.62,19.68,1064.94,1963.22,WellsFargo1,10,1
6,1963.22,1084.62,12.76,1071.86,891.36,WellsFargo1,10,1
7,891.36,1084.62,5.79,1078.83,-187.47,WellsFargo1,10,1
0,20000.0,191.04,108.0,83.04,19916.96,WellsFargo2,10,2
1,19916.96,191.04,107.55,83.49,19833.47,WellsFargo2,10,2
2,19833.47,191.04,107.1,83.94,19749.53,WellsFargo2,10,2
3,19749.53,191.04,106.65,84.39,19665.14,WellsFargo2,10,2
4,19665.14,191.04,106.19,84.85,19580.29,WellsFargo2,10,2
5,19580.29,191.04,105.73,85.31,19494.98,WellsFargo2,10,2
6,19494.98,191.04,105.27,85.77,19409.21,WellsFargo2,10,2
7,19409.21,378.51,104.81,273.7,19135.51,WellsFargo2,10,2
8,19135.51,1275.66,103.33,1172.33,17963.18,WellsFargo2,10,2
9,17963.18,1275.66,97.0,1178.66,16784.52,WellsFargo2,10,2
10,16784.52,1275.66,90.64,1185.02,15599.5,WellsFargo2,10,2
11,15599.5,1275.66,84.24,1191.42,14408.08,WellsFargo2,10,2
12,14408.08,1275.66,77.8,1197.86,13210.22,WellsFargo2,10,2
13,13210.22,1275.66,71.34,1204.32,12005.9,WellsFargo2,10,2
14,12005.9,1275.66,64.83,1210.83,10795.07,WellsFargo2,10,2
15,10795.07,1275.66,58.29,1217.37,9577.7,WellsFargo2,10,2
16,9577.7,1275.66,51.72,1223.94,8353.76,WellsFargo2,10,2
17,8353.76,1275.66,45.11,1230.55,7123.21,WellsFargo2,10,2
18,7123.21,1275.66,38.47,1237.19,5886.02,WellsFargo2,10,2
19,5886.02,1275.66,31.78,1243.88,4642.14,WellsFargo2,10,2
20,4642.14,1275.66,25.07,1250.59,3391.55,WellsFargo2,10,2
21,3391.55,1275.66,18.31,1257.35,2134.2,WellsFargo2,10,2
22,2134.2,1275.66,11.52,1264.14,870.06,WellsFargo2,10,2
23,870.06,1275.66,4.7,1270.96,-400.9,WellsFargo2,10,2
0,4000.0,70.0,16.0,54.0,3946.0,testing,10,3
1,3946.0,70.0,15.78,54.22,3891.78,testing,10,3
2,3891.78,70.0,15.57,54.43,3837.35,testing,10,3
3,3837.35,70.0,15.35,54.65,3782.7,testing,10,3
4,3782.7,70.0,15.13,54.87,3727.83,testing,10,3
5,3727.83,70.0,14.91,55.09,3672.74,testing,10,3
6,3672.74,70.0,14.69,55.31,3617.43,testing,10,3
7,3617.43,70.0,14.47,55.53,3561.9,testing,10,3
8,3561.9,70.0,14.25,55.75,3506.15,testing,10,3
9,3506.15,70.0,14.02,55.98,3450.17,testing,10,3
10,3450.17,70.0,13.8,56.2,3393.97,testing,10,3
11,3393.97,70.0,13.58,56.42,3337.55,testing,10,3
12,3337.55,70.0,13.35,56.65,3280.9,testing,10,3
13,3280.9,70.0,13.12,56.88,3224.02,testing,10,3
14,3224.02,70.0,12.9,57.1,3166.92,testing,10,3
15,3166.92,70.0,12.67,57.33,3109.59,testing,10,3
16,3109.59,70.0,12.44,57.56,3052.03,testing,10,3
17,3052.03,70.0,12.21,57.79,2994.24,testing,10,3
18,2994.24,70.0,11.98,58.02,2936.22,testing,10,3
19,2936.22,70.0,11.74,58.26,2877.96,testing,10,3
20,2877.96,70.0,11.51,58.49,2819.47,testing,10,3
21,2819.47,70.0,11.28,58.72,2760.75,testing,10,3
22,2760.75,70.0,11.04,58.96,2701.79,testing,10,3
23,2701.79,470.9,10.81,460.09,2241.7,testing,10,3
24,2241.7,1345.66,8.97,1336.69,905.01,testing,10,3
25,905.01,1345.66,3.62,1342.04,-437.03,testing,10,3
0,5000.0,333.0,36.0,297.0,4703.0,Car,10,4
1,4703.0,333.0,33.86,299.14,4403.86,Car,10,4
2,4403.86,333.0,31.71,301.29,4102.57,Car,10,4
3,4102.57,333.0,29.54,303.46,3799.11,Car,10,4
4,3799.11,333.0,27.35,305.65,3493.46,Car,10,4
5,3493.46,333.0,25.15,307.85,3185.61,Car,10,4
6,3185.61,333.0,22.94,310.06,2875.55,Car,10,4
7,2875.55,333.0,20.7,312.3,2563.25,Car,10,4
8,2563.25,333.0,18.46,314.54,2248.71,Car,10,4
9,2248.71,333.0,16.19,316.81,1931.9,Car,10,4
10,1931.9,333.0,13.91,319.09,1612.81,Car,10,4
11,1612.81,333.0,11.61,321.39,1291.42,Car,10,4
12,1291.42,333.0,9.3,323.7,967.72,Car,10,4
13,967.72,333.0,6.97,326.03,641.69,Car,10,4
14,641.69,333.0,4.62,328.38,313.31,Car,10,4
15,313.31,333.0,2.26,330.74,-17.43,Car,10,4
0,8250.57,1084.62,53.63,1030.99,7219.58,WellsFargo1,11,1
1,7219.58,1084.62,46.93,1037.69,6181.89,WellsFargo1,11,1
2,6181.89,1084.62,40.18,1044.44,5137.45,WellsFargo1,11,1
3,5137.45,1084.62,33.39,1051.23,4086.22,WellsFargo1,11,1
4,4086.22,1084.62,26.56,1058.06,3028.16,WellsFargo1,11,1
5,3028.16,1084.62,19.68,1064.94,1963.22,WellsFargo1,11,1
6,1963.22,1084.62,12.76,1071.86,891.36,WellsFargo1,11,1
7,891.36,1084.62,5.79,1078.83,-187.47,WellsFargo1,11,1
0,4000.0,70.0,16.0,54.0,3946.0,testing,11,2
1,3946.0,70.0,15.78,54.22,3891.78,testing,11,2
2,3891.78,70.0,15.57,54.43,3837.35,testing,11,2
3,3837.35,70.0,15.35,54.65,3782.7,testing,11,2
4,3782.7,70.0,15.13,54.87,3727.83,testing,11,2
5,3727.83,70.0,14.91,55.09,3672.74,testing,11,2
6,3672.74,70.0,14.69,55.31,3617.43,testing,11,2
7,3617.43,257.47,14.47,243.0,3374.43,testing,11,2
8,3374.43,1154.62,13.5,1141.12,2233.31,testing,11,2
9,2233.31,1154.62,8.93,1145.69,1087.62,testing,11,2
10,1087.62,1154.62,4.35,1150.27,-62.65,testing,11,2
0,5000.0,333.0,36.0,297.0,4703.0,Car,11,3
1,4703.0,333.0,33.86,299.14,4403.86,Car,11,3
2,4403.86,333.0,31.71,301.29,4102.57,Car,11,3
3,4102.57,333.0,29.54,303.46,3799.11,Car,11,3
4,3799.11,333.0,27.35,305.65,3493.46,Car,11,3
5,3493.46,333.0,25.15,307.85,3185.61,Car,11,3
6,3185.61,333.0,22.94,310.06,2875.55,Car,11,3
7,2875.55,333.0,20.7,312.3,2563.25,Car,11,3
8,2563.25,333.0,18.46,314.54,2248.71,Car,11,3
9,2248.71,333.0,16.19,316.81,1931.9,Car,11,3
10,1931.9,395.65,13.91,381.74,1550.16,Car,11,3
11,1550.16,1487.62,11.16,1476.46,73.7,Car,11,3
12,73.7,1487.62,0.53,1487.09,-1413.39,Car,11,3
0,20000.0,191.04,108.0,83.04,19916.96,WellsFargo2,11,4
1,19916.96,191.04,107.55,83.49,19833.47,WellsFargo2,11,4
2,19833.47,191.04,107.1,83.94,19749.53,WellsFargo2,11,4
3,19749.53,191.04,106.65,84.39,19665.14,WellsFargo2,11,4
4,19665.14,191.04,106.19,84.85,19580.29,WellsFargo2,11,4
5,19580.29,191.04,105.73,85.31,19494.98,WellsFargo2,11,4
6,19494.98,191.04,105.27,85.77,19409.21,WellsFargo2,11,4
7,19409.21,191.04,104.81,86.23,19322.98,WellsFargo2,11,4
8,19322.98,191.04,104.34,86.7,19236.28,WellsFargo2,11,4
9,19236.28,191.04,103.88,87.16,19149.12,WellsFargo2,11,4
10,19149.12,191.04,103.41,87.63,19061.49,WellsFargo2,11,4
11,19061.49,191.04,102.93,88.11,18973.38,WellsFargo2,11,4
12,18973.38,1604.43,102.46,1501.97,17471.41,WellsFargo2,11,4
13,17471.41,1678.66,94.35,1584.31,15887.1,WellsFargo2,11,4
14,15887.1,1678.66,85.79,1592.87,14294.23,WellsFargo2,11,4
15,14294.23,1678.66,77.19,1601.47,12692.76,WellsFargo2,11,4
16,12692.76,1678.66,68.54,1610.12,11082.64,WellsFargo2,11,4
17,11082.64,1678.66,59.85,1618.81,9463.83,WellsFargo2,11,4
18,9463.83,1678.66,51.1,1627.56,7836.27,WellsFargo2,11,4
19,7836.27,1678.66,42.32,1636.34,6199.93,WellsFargo2,11,4
20,6199.93,1678.66,33.48,1645.18,4554.75,WellsFargo2,11,4
21,4554.75,1678.66,24.6,1654.06,2900.69,WellsFargo2,11,4
22,2900.69,1678.66,15.66,1663.0,1237.69,WellsFargo2,11,4
23,1237.69,1678.66,6.68,1671.98,-434.29,WellsFargo2,11,4
0,8250.57,1084.62,53.63,1030.99,7219.58,WellsFargo1,12,1
1,7219.58,1084.62,46.93,1037.69,6181.89,WellsFargo1,12,1
2,6181.89,1084.62,40.18,1044.44,5137.45,WellsFargo1,12,1
3,5137.45,1084.62,33.39,1051.23,4086.22,WellsFargo1,12,1
4,4086.22,1084.62,26.56,1058.06,3028.16,WellsFargo1,12,1
5,3028.16,1084.62,19.68,1064.94,1963.22,WellsFargo1,12,1
6,1963.22,1084.62,12.76,1071.86,891.36,WellsFargo1,12,1
7,891.36,1084.62,5.79,1078.83,-187.47,WellsFargo1,12,1
0,4000.0,70.0,16.0,54.0,3946.0,testing,12,2
1,3946.0,70.0,15.78,54.22,3891.78,testing,12,2
2,3891.78,70.0,15.57,54.43,3837.35,testing,12,2
3,3837.35,70.0,15.35,54.65,3782.7,testing,12,2
4,3782.7,70.0,15.13,54.87,3727.83,testing,12,2
5,3727.83,70.0,14.91,55.09,3672.74,testing,12,2
6,3672.74,70.0,14.69,55.31,3617.43,testing,12,2
7,3617.43,257.47,14.47,243.0,3374.43,testing,12,2
8,3374.43,1154.62,13.5,1141.12,2233.31,testing,12,2
9,2233.31,1154.62,8.93,1145.69,1087.62,testing,12,2
10,1087.62,1154.62,4.35,1150.27,-62.65,testing,12,2
0,20000.0,191.04,108.0,83.04,19916.96,WellsFargo2,12,3
1,19916.96,191.04,107.55,83.49,19833.47,WellsFargo2,12,3
2,19833.47,191.04,107.1,83.94,19749.53,WellsFargo2,12,3
3,19749.53,191.04,106.65,84.39,19665.14,WellsFargo2,12,3
4,19665.14,191.04,106.19,84.85,19580.29,WellsFargo2,12,3
5,19580.29,191.04,105.73,85.31,19494.98,WellsFargo2,12,3
6,19494.98,191.04,105.27,85.77,19409.21,WellsFargo2,12,3
7,19409.21,191.04,104.81,86.23,19322.98,WellsFargo2,12,3
8,19322.98,191.04,104.34,86.7,19236.28,WellsFargo2,12,3
9,19236.28,191.04,103.88,87.16,19149.12,WellsFargo2,12,3
10,19149.12,253.69,103.41,150.28,18998.84,WellsFargo2,12,3
11,18998.84,1345.66,102.59,1243.07,17755.77,WellsFargo2,12,3
12,17755.77,1345.66,95.88,1249.78,16505.99,WellsFargo2,12,3
13,16505.99,1345.66,89.13,1256.53,15249.46,WellsFargo2,12,3
14,15249.46,1345.66,82.35,1263.31,13986.15,WellsFargo2,12,3
15,13986.15,1345.66,75.53,1270.13,12716.02,WellsFargo2,12,3
16,12716.02,1345.66,68.67,1276.99,11439.03,WellsFargo2,12,3
17,11439.03,1345.66,61.77,1283.89,10155.14,WellsFargo2,12,3
18,10155.14,1345.66,54.84,1290.82,8864.32,WellsFargo2,12,3
19,8864.32,1345.66,47.87,1297.79,7566.53,WellsFargo2,12,3
20,7566.53,1345.66,40.86,1304.8,6261.73,WellsFargo2,12,3
21,6261.73,1345.66,33.81,1311.85,4949.88,WellsFargo2,12,3
22,4949.88,1345.66,26.73,1318.93,3630.95,WellsFargo2,12,3
23,3630.95,1345.66,19.61,1326.05,2304.9,WellsFargo2,12,3
24,2304.9,1345.66,12.45,1333.21,971.69,WellsFargo2,12,3
25,971.69,1345.66,5.25,1340.41,-368.72,WellsFargo2,12,3
0,5000.0,333.0,36.0,297.0,4703.0,Car,12,4
1,4703.0,333.0,33.86,299.14,4403.86,Car,12,4
2,4403.86,333.0,31.71,301.29,4102.57,Car,12,4
3,4102.57,333.0,29.54,303.46,3799.11,Car,12,4
4,3799.11,333.0,27.35,305.65,3493.46,Car,12,4
5,3493.46,333.0,25.15,307.85,3185.61,Car,12,4
6,3185.61,333.0,22.94,310.06,2875.55,Car,12,4
7,2875.55,333.0,20.7,312.3,2563.25,Car,12,4
8,2563.25,333.0,18.46,314.54,2248.71,Car,12,4
9,2248.71,333.0,16.19,316.81,1931.9,Car,12,4
10,1931.9,333.0,13.91,319.09,1612.81,Car,12,4
11,1612.81,333.0,11.61,321.39,1291.42,Car,12,4
12,1291.42,333.0,9.3,323.7,967.72,Car,12,4
13,967.72,333.0,6.97,326.03,641.69,Car,12,4
14,641.69,333.0,4.62,328.38,313.31,Car,12,4
15,313.31,333.0,2.26,330.74,-17.43,Car,12,4
0,20000.0,1191.04,108.0,1083.04,18916.96,WellsFargo2,13,1
1,18916.96,1191.04,102.15,1088.89,17828.07,WellsFargo2,13,1
2,17828.07,1191.04,96.27,1094.77,16733.3,WellsFargo2,13,1
3,16733.3,1191.04,90.36,1100.68,15632.62,WellsFargo2,13,1
4,15632.62,1191.04,84.42,1106.62,14526.0,WellsFargo2,13,1
5,14526.0,1191.04,78.44,1112.6,13413.4,WellsFargo2,13,1
6,13413.4,1191.04,72.43,1118.61,12294.79,WellsFargo2,13,1
7,12294.79,1191.04,66.39,1124.65,11170.14,WellsFargo2,13,1
8,11170.14,1191.04,60.32,1130.72,10039.42,WellsFargo2,13,1
9,10039.42,1191.04,54.21,1136.83,8902.59,WellsFargo2,13,1
10,8902.59,1191.04,48.07,1142.97,7759.62,WellsFargo2,13,1
11,7759.62,1191.04,41.9,1149.14,6610.48,WellsFargo2,13,1
12,6610.48,1191.04,35.7,1155.34,5455.14,WellsFargo2,13,1
13,5455.14,1191.04,29.46,1161.58,4293.56,WellsFargo2,13,1
14,4293.56,1191.04,23.19,1167.85,3125.71,WellsFargo2,13,1
15,3125.71,1191.04,16.88,1174.16,1951.55,WellsFargo2,13,1
16,1951.55,1191.04,10.54,1180.5,771.05,WellsFargo2,13,1
17,771.05,1191.04,4.16,1186.88,-415.83,WellsFargo2,13,1
0,5000.0,333.0,36.0,297.0,4703.0,Car,13,2
1,4703.0,333.0,33.86,299.14,4403.86,Car,13,2
2,4403.86,333.0,31.71,301.29,4102.57,Car,13,2
3,4102.57,333.0,29.54,303.46,3799.11,Car,13,2
4,3799.11,333.0,27.35,305.65,3493.46,Car,13,2
5,3493.46,333.0,25.15,307.85,3185.61,Car,13,2
6,3185.61,333.0,22.94,310.06,2875.55,Car,13,2
7,2875.55,333.0,20.7,312.3,2563.25,Car,13,2
8,2563.25,333.0,18.46,314.54,2248.71,Car,13,2
9,2248.71,333.0,16.19,316.81,1931.9,Car,13,2
10,1931.9,333.0,13.91,319.09,1612.81,Car,13,2
11,1612.81,333.0,11.61,321.39,1291.42,Car,13,2
12,1291.42,333.0,9.3,323.7,967.72,Car,13,2
13,967.72,333.0,6.97,326.03,641.69,Car,13,2
14,641.69,333.0,4.62,328.38,313.31,Car,13,2
15,313.31,333.0,2.26,330.74,-17.43,Car,13,2
0,8250.57,84.62,53.63,30.99,8219.58,WellsFargo1,13,3
1,8219.58,84.62,53.43,31.19,8188.39,WellsFargo1,13,3
2,8188.39,84.62,53.22,31.4,8156.99,WellsFargo1,13,3
3,8156.99,84.62,53.02,31.6,8125.39,WellsFargo1,13,3
4,8125.39,84.62,52.82,31.8,8093.59,WellsFargo1,13,3
5,8093.59,84.62,52.61,32.01,8061.58,WellsFargo1,13,3
6,8061.58,84.62,52.4,32.22,8029.36,WellsFargo1,13,3
7,8029.36,84.62,52.19,32.43,7996.93,WellsFargo1,13,3
8,7996.93,84.62,51.98,32.64,7964.29,WellsFargo1,13,3
9,7964.29,84.62,51.77,32.85,7931.44,WellsFargo1,13,3
10,7931.44,84.62,51.55,33.07,7898.37,WellsFargo1,13,3
11,7898.37,84.62,51.34,33.28,7865.09,WellsFargo1,13,3
12,7865.09,84.62,51.12,33.5,7831.59,WellsFargo1,13,3
13,7831.59,84.62,50.91,33.71,7797.88,WellsFargo1,13,3
14,7797.88,84.62,50.69,33.93,7763.95,WellsFargo1,13,3
15,7763.95,102.05,50.47,51.58,7712.37,WellsFargo1,13,3
16,7712.37,1608.66,50.13,1558.53,6153.84,WellsFargo1,13,3
17,6153.84,1608.66,40.0,1568.66,4585.18,WellsFargo1,13,3
18,4585.18,1608.66,29.8,1578.86,3006.32,WellsFargo1,13,3
19,3006.32,1608.66,19.54,1589.12,1417.2,WellsFargo1,13,3
20,1417.2,1608.66,9.21,1599.45,-182.25,WellsFargo1,13,3
0,4000.0,70.0,16.0,54.0,3946.0,testing,13,4
1,3946.0,70.0,15.78,54.22,3891.78,testing,13,4
2,3891.78,70.0,15.57,54.43,3837.35,testing,13,4
3,3837.35,70.0,15.35,54.65,3782.7,testing,13,4
4,3782.7,70.0,15.13,54.87,3727.83,testing,13,4
5,3727.83,70.0,14.91,55.09,3672.74,testing,13,4
6,3672.74,70.0,14.69,55.31,3617.43,testing,13,4
7,3617.43,70.0,14.47,55.53,3561.9,testing,13,4
8,3561.9,70.0,14.25,55.75,3506.15,testing,13,4
9,3506.15,70.0,14.02,55.98,3450.17,testing,13,4
10,3450.17,70.0,13.8,56.2,3393.97,testing,13,4
11,3393.97,70.0,13.58,56.42,3337.55,testing,13,4
12,3337.55,70.0,13.35,56.65,3280.9,testing,13,4
13,3280.9,70.0,13.12,56.88,3224.02,testing,13,4
14,3224.02,70.0,12.9,57.1,3166.92,testing,13,4
15,3166.92,70.0,12.67,57.33,3109.59,testing,13,4
16,3109.59,70.0,12.44,57.56,3052.03,testing,13,4
17,3052.03,70.0,12.21,57.79,2994.24,testing,13,4
18,2994.24,70.0,11.98,58.02,2936.22,testing,13,4
19,2936.22,70.0,11.74,58.26,2877.96,testing,13,4
20,2877.96,252.25,11.51,240.74,2637.22,testing,13,4
21,2637.22,1678.66,10.55,1668.11,969.11,testing,13,4
22,969.11,1678.66,3.88,1674.78,-705.67,testing,13,4
0,20000.0,1191.04,108.0,1083.04,18916.96,WellsFargo2,14,1
1,18916.96,1191.04,102.15,1088.89,17828.07,WellsFargo2,14,1
2,17828.07,1191.04,96.27,1094.77,16733.3,WellsFargo2,14,1
3,16733.3,1191.04,90.36,1100.68,15632.62,WellsFargo2,14,1
4,15632.62,1191.04,84.42,1106.62,14526.0,WellsFargo2,14,1
5,14526.0,1191.04,78.44,1112.6,13413.4,WellsFargo2,14,1
6,13413.4,1191.04,72.43,1118.61,12294.79,WellsFargo2,14,1
7,12294.79,1191.04,66.39,1124.65,11170.14,WellsFargo2,14,1
8,11170.14,1191.04,60.32,1130.72,10039.42,WellsFargo2,14,1
9,10039.42,1191.04,54.21,1136.83,8902.59,WellsFargo2,14,1
10,8902.59,1191.04,48.07,1142.97,7759.62,WellsFargo2,14,1
11,7759.62,1191.04,41.9,1149.14,6610.48,WellsFargo2,14,1
12,6610.48,1191.04,35.7,1155.34,5455.14,WellsFargo2,14,1
13,5455.14,1191.04,29.46,1161.58,4293.56,WellsFargo2,14,1
14,4293.56,1191.04,23.19,1167.85,3125.71,WellsFargo2,14,1
15,3125.71,1191.04,16.88,1174.16,1951.55,WellsFargo2,14,1
16,1951.55,1191.04,10.54,1180.5,771.05,WellsFargo2,14,1
17,771.05,1191.04,4.16,1186.88,-415.83,WellsFargo2,14,1
0,5000.0,333.0,36.0,297.0,4703.0,Car,14,2
1,4703.0,333.0,33.86,299.14,4403.86,Car,14,2
2,4403.86,333.0,31.71,301.29,4102.57,Car,14,2
3,4102.57,333.0,29.54,303.46,3799.11,Car,14,2
4,3799.11,333.0,27.35,305.65,3493.46,Car,14,2
5,3493.46,333.0,25.15,307.85,3185.61,Car,14,2
6,3185.61,333.0,22.94,310.06,2875.55,Car,14,2
7,2875.55,333.0,20.7,312.3,2563.25,Car,14,2
8,2563.25,333.0,18.46,314.54,2248.71,Car,14,2
9,2248.71,333.0,16.19,316.81,1931.9,Car,14,2
10,1931.9,333.0,13.91,319.09,1612.81,Car,14,2
11,1612.81,333.0,11.61,321.39,1291.42,Car,14,2
12,1291.42,333.0,9.3,323.7,967.72,Car,14,2
13,967.72,333.0,6.97,326.03,641.69,Car,14,2
14,641.69,333.0,4.62,328.38,313.31,Car,14,2
15,313.31,333.0,2.26,330.74,-17.43,Car,14,2
0,4000.0,70.0,16.0,54.0,3946.0,testing,14,3
1,3946.0,70.0,15.78,54.22,3891.78,testing,14,3
2,3891.78,70.0,15.57,54.43,3837.35,testing,14,3
3,3837.35,70.0,15.35,54.65,3782.7,testing,14,3
4,3782.7,70.0,15.13,54.87,3727.83,testing,14,3
5,3727.83,70.0,14.91,55.09,3672.74,testing,14,3
6,3672.74,70.0,14.69,55.31,3617.43,testing,14,3
7,3617.43,70.0,14.47,55.53,3561.9,testing,14,3
8,3561.9,70.0,14.25,55.75,3506.15,testing,14,3
9,3506.15,70.0,14.02,55.98,3450.17,testing,14,3
10,3450.17,70.0,13.8,56.2,3393.97,testing,14,3
11,3393.97,70.0,13.58,56.42,3337.55,testing,14,3
12,3337.55,70.0,13.35,56.65,3280.9,testing,14,3
13,3280.9,70.0,13.12,56.88,3224.02,testing,14,3
14,3224.02,70.0,12.9,57.1,3166.92,testing,14,3
15,3166.92,87.43,12.67,74.76,3092.16,testing,14,3
16,3092.16,1594.04,12.37,1581.67,1510.49,testing,14,3
17,1510.49,1594.04,6.04,1588.0,-77.51,testing,14,3
0,8250.57,84.62,53.63,30.99,8219.58,WellsFargo1,14,4
1,8219.58,84.62,53.43,31.19,8188.39,WellsFargo1,14,4
2,8188.39,84.62,53.22,31.4,8156.99,WellsFargo1,14,4
3,8156.99,84.62,53.02,31.6,8125.39,WellsFargo1,14,4
4,8125.39,84.62,52.82,31.8,8093.59,WellsFargo1,14,4
5,8093.59,84.62,52.61,32.01,8061.58,WellsFargo1,14,4
6,8061.58,84.62,52.4,32.22,8029.36,WellsFargo1,14,4
7,8029.36,84.62,52.19,32.43,7996.93,WellsFargo1,14,4
8,7996.93,84.62,51.98,32.64,7964.29,WellsFargo1,14,4
9,7964.29,84.62,51.77,32.85,7931.44,WellsFargo1,14,4
10,7931.44,84.62,51.55,33.07,7898.37,WellsFargo1,14,4
11,7898.37,84.62,51.34,33.28,7865.09,WellsFargo1,14,4
12,7865.09,84.62,51.12,33.5,7831.59,WellsFargo1,14,4
13,7831.59,84.62,50.91,33.71,7797.88,WellsFargo1,14,4
14,7797.88,84.62,50.69,33.93,7763.95,WellsFargo1,14,4
15,7763.95,84.62,50.47,34.15,7729.8,WellsFargo1,14,4
16,7729.8,84.62,50.24,34.38,7695.42,WellsFargo1,14,4
17,7695.42,162.13,50.02,112.11,7583.31,WellsFargo1,14,4
18,7583.31,1678.66,49.29,1629.37,5953.94,WellsFargo1,14,4
19,5953.94,1678.66,38.7,1639.96,4313.98,WellsFargo1,14,4
20,4313.98,1678.66,28.04,1650.62,2663.36,WellsFargo1,14,4
21,2663.36,1678.66,17.31,1661.35,1002.01,WellsFargo1,14,4
22,1002.01,1678.66,6.51,1672.15,-670.14,WellsFargo1,14,4
0,20000.0,1191.04,108.0,1083.04,18916.96,WellsFargo2,15,1
1,18916.96,1191.04,102.15,1088.89,17828.07,WellsFargo2,15,1
2,17828.07,1191.04,96.27,1094.77,16733.3,WellsFargo2,15,1
3,16733.3,1191.04,90.36,1100.68,15632.62,WellsFargo2,15,1
4,15632.62,1191.04,84.42,1106.62,14526.0,WellsFargo2,15,1
5,14526.0,1191.04,78.44,1112.6,13413.4,WellsFargo2,15,1
6,13413.4,1191.04,72.43,1118.61,12294.79,WellsFargo2,15,1
7,12294.79,1191.04,66.39,1124.65,11170.14,WellsFargo2,15,1
8,11170.14,1191.04,60.32,1130.72,10039.42,WellsFargo2,15,1
9,10039.42,1191.04,54.21,1136.83,8902.59,WellsFargo2,15,1
10,8902.59,1191.04,48.07,1142.97,7759.62,WellsFargo2,15,1
11,7759.62,1191.04,41.9,1149.14,6610.48,WellsFargo2,15,1
12,6610.48,1191.04,35.7,1155.34,5455.14,WellsFargo2,15,1
13,5455.14,1191.04,29.46,1161.58,4293.56,WellsFargo2,15,1
14,4293.56,1191.04,23.19,1167.85,3125.71,WellsFargo2,15,1
15,3125.71,1191.04,16.88,1174.16,1951.55,WellsFargo2,15,1
16,1951.55,1191.04,10.54,1180.5,771.05,WellsFargo2,15,1
17,771.05,1191.04,4.16,1186.88,-415.83,WellsFargo2,15,1
0,8250.57,84.62,53.63,30.99,8219.58,WellsFargo1,15,2
1,8219.58,84.62,53.43,31.19,8188.39,WellsFargo1,15,2
2,8188.39,84.62,53.22,31.4,8156.99,WellsFargo1,15,2
3,8156.99,84.62,53.02,31.6,8125.39,WellsFargo1,15,2
4,8125.39,84.62,52.82,31.8,8093.59,WellsFargo1,15,2
5,8093.59,84.62,52.61,32.01,8061.58,WellsFargo1,15,2
6,8061.58,84.62,52.4,32.22,8029.36,WellsFargo1,15,2
7,8029.36,84.62,52.19,32.43,7996.93,WellsFargo1,15,2
8,7996.93,84.62,51.98,32.64,7964.29,WellsFargo1,15,2
9,7964.29,84.62,51.77,32.85,7931.44,WellsFargo1,15,2
10,7931.44,84.62,51.55,33.07,7898.37,WellsFargo1,15,2
11,7898.37,84.62,51.34,33.28,7865.09,WellsFargo1,15,2
12,7865.09,84.62,51.12,33.5,7831.59,WellsFargo1,15,2
13,7831.59,84.62,50.91,33.71,7797.88,WellsFargo1,15,2
14,7797.88,84.62,50.69,33.93,7763.95,WellsFargo1,15,2
15,7763.95,84.62,50.47,34.15,7729.8,WellsFargo1,15,2
16,7729.8,84.62,50.24,34.38,7695.42,WellsFargo1,15,2
17,7695.42,500.45,50.02,450.43,7244.99,WellsFargo1,15,2
18,7244.99,1275.66,47.09,1228.57,6016.42,WellsFargo1,15,2
19,6016.42,1275.66,39.11,1236.55,4779.87,WellsFargo1,15,2
20,4779.87,1275.66,31.07,1244.59,3535.28,WellsFargo1,15,2
21,3535.28,1275.66,22.98,1252.68,2282.6,WellsFargo1,15,2
22,2282.6,1275.66,14.84,1260.82,1021.78,WellsFargo1,15,2
23,1021.78,1275.66,6.64,1269.02,-247.24,WellsFargo1,15,2
0,5000.0,333.0,36.0,297.0,4703.0,Car,15,3
1,4703.0,333.0,33.86,299.14,4403.86,Car,15,3
2,4403.86,333.0,31.71,301.29,4102.57,Car,15,3
3,4102.57,333.0,29.54,303.46,3799.11,Car,15,3
4,3799.11,333.0,27.35,305.65,3493.46,Car,15,3
5,3493.46,333.0,25.15,307.85,3185.61,Car,15,3
6,3185.61,333.0,22.94,310.06,2875.55,Car,15,3
7,2875.55,333.0,20.7,312.3,2563.25,Car,15,3
8,2563.25,333.0,18.46,314.54,2248.71,Car,15,3
9,2248.71,333.0,16.19,316.81,1931.9,Car,15,3
10,1931.9,333.0,13.91,319.09,1612.81,Car,15,3
11,1612.81,333.0,11.61,321.39,1291.42,Car,15,3
12,1291.42,333.0,9.3,323.7,967.72,Car,15,3
13,967.72,333.0,6.97,326.03,641.69,Car,15,3
14,641.69,333.0,4.62,328.38,313.31,Car,15,3
15,313.31,333.0,2.26,330.74,-17.43,Car,15,3
0,4000.0,70.0,16.0,54.0,3946.0,testing,15,4
1,3946.0,70.0,15.78,54.22,3891.78,testing,15,4
2,3891.78,70.0,15.57,54.43,3837.35,testing,15,4
3,3837.35,70.0,15.35,54.65,3782.7,testing,15,4
4,3782.7,70.0,15.13,54.87,3727.83,testing,15,4
5,3727.83,70.0,14.91,55.09,3672.74,testing,15,4
6,3672.74,70.0,14.69,55.31,3617.43,testing,15,4
7,3617.43,70.0,14.47,55.53,3561.9,testing,15,4
8,3561.9,70.0,14.25,55.75,3506.15,testing,15,4
9,3506.15,70.0,14.02,55.98,3450.17,testing,15,4
10,3450.17,70.0,13.8,56.2,3393.97,testing,15,4
11,3393.97,70.0,13.58,56.42,3337.55,testing,15,4
12,3337.55,70.0,13.35,56.65,3280.9,testing,15,4
13,3280.9,70.0,13.12,56.88,3224.02,testing,15,4
14,3224.02,70.0,12.9,57.1,3166.92,testing,15,4
15,3166.92,87.43,12.67,74.76,3092.16,testing,15,4
16,3092.16,1678.66,12.37,1666.29,1425.87,testing,15,4
17,1425.87,1678.66,5.7,1672.96,-247.09,testing,15,4
0,20000.0,1191.04,108.0,1083.04,18916.96,WellsFargo2,16,1
1,18916.96,1191.04,102.15,1088.89,17828.07,WellsFargo2,16,1
2,17828.07,1191.04,96.27,1094.77,16733.3,WellsFargo2,16,1
3,16733.3,1191.04,90.36,1100.68,15632.62,WellsFargo2,16,1
4,15632.62,1191.04,84.42,1106.62,14526.0,WellsFargo2,16,1
5,14526.0,1191.04,78.44,1112.6,13413.4,WellsFargo2,16,1
6,13413.4,1191.04,72.43,1118.61,12294.79,WellsFargo2,16,1
7,12294.79,1191.04,66.39,1124.65,11170.14,WellsFargo2,16,1
8,11170.14,1191.04,60.32,1130.72,10039.42,WellsFargo2,16,1
9,10039.42,1191.04,54.21,1136.83,8902.59,WellsFargo2,16,1
10,8902.59,1191.04,48.07,1142.97,7759.62,WellsFargo2,16,1
11,7759.62,1191.04,41.9,1149.14,6610.48,WellsFargo2,16,1
12,6610.48,1191.04,35.7,1155.34,5455.14,WellsFargo2,16,1
13,5455.14,1191.04,29.46,1161.58,4293.56,WellsFargo2,16,1
14,4293.56,1191.04,23.19,1167.85,3125.71,WellsFargo2,16,1
15,3125.71,1191.04,16.88,1174.16,1951.55,WellsFargo2,16,1
16,1951.55,1191.04,10.54,1180.5,771.05,WellsFargo2,16,1
17,771.05,1191.04,4.16,1186.88,-415.83,WellsFargo2,16,1
0,8250.57,84.62,53.63,30.99,8219.58,WellsFargo1,16,2
1,8219.58,84.62,53.43,31.19,8188.39,WellsFargo1,16,2
2,8188.39,84.62,53.22,31.4,8156.99,WellsFargo1,16,2
3,8156.99,84.62,53.02,31.6,8125.39,WellsFargo1,16,2
4,8125.39,84.62,52.82,31.8,8093.59,WellsFargo1,16,2
5,8093.59,84.62,52.61,32.01,8061.58,WellsFargo1,16,2
6,8061.58,84.62,52.4,32.22,8029.36,WellsFargo1,16,2
7,8029.36,84.62,52.19,32.43,7996.93,WellsFargo1,16,2
8,7996.93,84.62,51.98,32.64,7964.29,WellsFargo1,16,2
9,7964.29,84.62,51.77,32.85,7931.44,WellsFargo1,16,2
10,7931.44,84.62,51.55,33.07,7898.37,WellsFargo1,16,2
11,7898.37,84.62,51.34,33.28,7865.09,WellsFargo1,16,2
12,7865.09,84.62,51.12,33.5,7831.59,WellsFargo1,16,2
13,7831.59,84.62,50.91,33.71,7797.88,WellsFargo1,16,2
14,7797.88,84.62,50.69,33.93,7763.95,WellsFargo1,16,2
15,7763.95,84.62,50.47,34.15,7729.8,WellsFargo1,16,2
16,7729.8,84.62,50.24,34.38,7695.42,WellsFargo1,16,2
17,7695.42,500.45,50.02,450.43,7244.99,WellsFargo1,16,2
18,7244.99,1275.66,47.09,1228.57,6016.42,WellsFargo1,16,2
19,6016.42,1275.66,39.11,1236.55,4779.87,WellsFargo1,16,2
20,4779.87,1275.66,31.07,1244.59,3535.28,WellsFargo1,16,2
21,3535.28,1275.66,22.98,1252.68,2282.6,WellsFargo1,16,2
22,2282.6,1275.66,14.84,1260.82,1021.78,WellsFargo1,16,2
23,1021.78,1275.66,6.64,1269.02,-247.24,WellsFargo1,16,2
0,4000.0,70.0,16.0,54.0,3946.0,testing,16,3
1,3946.0,70.0,15.78,54.22,3891.78,testing,16,3
2,3891.78,70.0,15.57,54.43,3837.35,testing,16,3
3,3837.35,70.0,15.35,54.65,3782.7,testing,16,3
4,3782.7,70.0,15.13,54.87,3727.83,testing,16,3
5,3727.83,70.0,14.91,55.09,3672.74,testing,16,3
6,3672.74,70.0,14.69,55.31,3617.43,testing,16,3
7,3617.43,70.0,14.47,55.53,3561.9,testing,16,3
8,3561.9,70.0,14.25,55.75,3506.15,testing,16,3
9,3506.15,70.0,14.02,55.98,3450.17,testing,16,3
10,3450.17,70.0,13.8,56.2,3393.97,testing,16,3
11,3393.97,70.0,13.58,56.42,3337.55,testing,16,3
12,3337.55,70.0,13.35,56.65,3280.9,testing,16,3
13,3280.9,70.0,13.12,56.88,3224.02,testing,16,3
14,3224.02,70.0,12.9,57.1,3166.92,testing,16,3
15,3166.92,70.0,12.67,57.33,3109.59,testing,16,3
16,3109.59,70.0,12.44,57.56,3052.03,testing,16,3
17,3052.03,70.0,12.21,57.79,2994.24,testing,16,3
18,2994.24,70.0,11.98,58.02,2936.22,testing,16,3
19,2936.22,70.0,11.74,58.26,2877.96,testing,16,3
20,2877.96,70.0,11.51,58.49,2819.47,testing,16,3
21,2819.47,70.0,11.28,58.72,2760.75,testing,16,3
22,2760.75,70.0,11.04,58.96,2701.79,testing,16,3
23,2701.79,317.24,10.81,306.43,2395.36,testing,16,3
24,2395.36,1345.66,9.58,1336.08,1059.28,testing,16,3
25,1059.28,1345.66,4.24,1341.42,-282.14,testing,16,3
0,5000.0,333.0,36.0,297.0,4703.0,Car,16,4
1,4703.0,333.0,33.86,299.14,4403.86,Car,16,4
2,4403.86,333.0,31.71,301.29,4102.57,Car,16,4
3,4102.57,333.0,29.54,303.46,3799.11,Car,16,4
4,3799.11,333.0,27.35,305.65,3493.46,Car,16,4
5,3493.46,333.0,25.15,307.85,3185.61,Car,16,4
6,3185.61,333.0,22.94,310.06,2875.55,Car,16,4
7,2875.55,333.0,20.7,312.3,2563.25,Car,16,4
8,2563.25,333.0,18.46,314.54,2248.71,Car,16,4
9,2248.71,333.0,16.19,316.81,1931.9,Car,16,4
10,1931.9,333.0,13.91,319.09,1612.81,Car,16,4
11,1612.81,333.0,11.61,321.39,1291.42,Car,16,4
12,1291.42,333.0,9.3,323.7,967.72,Car,16,4
13,967.72,333.0,6.97,326.03,641.69,Car,16,4
14,641.69,333.0,4.62,328.38,313.31,Car,16,4
15,313.31,333.0,2.26,330.74,-17.43,Car,16,4
0,20000.0,1191.04,108.0,1083.04,18916.96,WellsFargo2,17,1
1,18916.96,1191.04,102.15,1088.89,17828.07,WellsFargo2,17,1
2,17828.07,1191.04,96.27,1094.77,16733.3,WellsFargo2,17,1
3,16733.3,1191.04,90.36,1100.68,15632.62,WellsFargo2,17,1
4,15632.62,1191.04,84.42,1106.62,14526.0,WellsFargo2,17,1
5,14526.0,1191.04,78.44,1112.6,13413.4,WellsFargo2,17,1
6,13413.4,1191.04,72.43,1118.61,12294.79,WellsFargo2,17,1
7,12294.79,1191.04,66.39,1124.65,11170.14,WellsFargo2,17,1
8,11170.14,1191.04,60.32,1130.72,10039.42,WellsFargo2,17,1
9,10039.42,1191.04,54.21,1136.83,8902.59,WellsFargo2,17,1
10,8902.59,1191.04,48.07,1142.97,7759.62,WellsFargo2,17,1
11,7759.62,1191.04,41.9,1149.14,6610.48,WellsFargo2,17,1
12,6610.48,1191.04,35.7,1155.34,5455.14,WellsFargo2,17,1
13,5455.14,1191.04,29.46,1161.58,4293.56,WellsFargo2,17,1
14,4293.56,1191.04,23.19,1167.85,3125.71,WellsFargo2,17,1
15,3125.71,1191.04,16.88,1174.16,1951.55,WellsFargo2,17,1
16,1951.55,1191.04,10.54,1180.5,771.05,WellsFargo2,17,1
17,771.05,1191.04,4.16,1186.88,-415.83,WellsFargo2,17,1
0,4000.0,70.0,16.0,54.0,3946.0,testing,17,2
1,3946.0,70.0,15.78,54.22,3891.78,testing,17,2
2,3891.78,70.0,15.57,54.43,3837.35,testing,17,2
3,3837.35,70.0,15.35,54.65,3782.7,testing,17,2
4,3782.7,70.0,15.13,54.87,3727.83,testing,17,2
5,3727.83,70.0,14.91,55.09,3672.74,testing,17,2
6,3672.74,70.0,14.69,55.31,3617.43,testing,17,2
7,3617.43,70.0,14.47,55.53,3561.9,testing,17,2
8,3561.9,70.0,14.25,55.75,3506.15,testing,17,2
9,3506.15,70.0,14.02,55.98,3450.17,testing,17,2
10,3450.17,70.0,13.8,56.2,3393.97,testing,17,2
11,3393.97,70.0,13.58,56.42,3337.55,testing,17,2
12,3337.55,70.0,13.35,56.65,3280.9,testing,17,2
13,3280.9,70.0,13.12,56.88,3224.02,testing,17,2
14,3224.02,70.0,12.9,57.1,3166.92,testing,17,2
15,3166.92,70.0,12.67,57.33,3109.59,testing,17,2
16,3109.59,70.0,12.44,57.56,3052.03,testing,17,2
17,3052.03,485.83,12.21,473.62,2578.41,testing,17,2
18,2578.41,1261.04,10.31,1250.73,1327.68,testing,17,2
19,1327.68,1261.04,5.31,1255.73,71.95,testing,17,2
20,71.95,1261.04,0.29,1260.75,-1188.8,testing,17,2
0,5000.0,333.0,36.0,297.0,4703.0,Car,17,3
1,4703.0,333.0,33.86,299.14,4403.86,Car,17,3
2,4403.86,333.0,31.71,301.29,4102.57,Car,17,3
3,4102.57,333.0,29.54,303.46,3799.11,Car,17,3
4,3799.11,333.0,27.35,305.65,3493.46,Car,17,3
5,3493.46,333.0,25.15,307.85,3185.61,Car,17,3
6,3185.61,333.0,22.94,310.06,2875.55,Car,17,3
7,2875.55,333.0,20.7,312.3,2563.25,Car,17,3
8,2563.25,333.0,18.46,314.54,2248.71,Car,17,3
9,2248.71,333.0,16.19,316.81,1931.9,Car,17,3
10,1931.9,333.0,13.91,319.09,1612.81,Car,17,3
11,1612.81,333.0,11.61,321.39,1291.42,Car,17,3
12,1291.42,333.0,9.3,323.7,967.72,Car,17,3
13,967.72,333.0,6.97,326.03,641.69,Car,17,3
14,641.69,333.0,4.62,328.38,313.31,Car,17,3
15,313.31,333.0,2.26,330.74,-17.43,Car,17,3
0,8250.57,84.62,53.63,30.99,8219.58,WellsFargo1,17,4
1,8219.58,84.62,53.43,31.19,8188.39,WellsFargo1,17,4
2,8188.39,84.62,53.22,31.4,8156.99,WellsFargo1,17,4
3,8156.99,84.62,53.02,31.6,8125.39,WellsFargo1,17,4
4,8125.39,84.62,52.82,31.8,8093.59,WellsFargo1,17,4
5,8093.59,84.62,52.61,32.01,8061.58,WellsFargo1,17,4
6,8061.58,84.62,52.4,32.22,8029.36,WellsFargo1,17,4
7,8029.36,84.62,52.19,32.43,7996.93,WellsFargo1,17,4
8,7996.93,84.62,51.98,32.64,7964.29,WellsFargo1,17,4
9,7964.29,84.62,51.77,32.85,7931.44,WellsFargo1,17,4
10,7931.44,84.62,51.55,33.07,7898.37,WellsFargo1,17,4
11,7898.37,84.62,51.34,33.28,7865.09,WellsFargo1,17,4
12,7865.09,84.62,51.12,33.5,7831.59,WellsFargo1,17,4
13,7831.59,84.62,50.91,33.71,7797.88,WellsFargo1,17,4
14,7797.88,84.62,50.69,33.93,7763.95,WellsFargo1,17,4
15,7763.95,102.05,50.47,51.58,7712.37,WellsFargo1,17,4
16,7712.37,1678.66,50.13,1628.53,6083.84,WellsFargo1,17,4
17,6083.84,1678.66,39.54,1639.12,4444.72,WellsFargo1,17,4
18,4444.72,1678.66,28.89,1649.77,2794.95,WellsFargo1,17,4
19,2794.95,1678.66,18.17,1660.49,1134.46,WellsFargo1,17,4
20,1134.46,1678.66,7.37,1671.29,-536.83,WellsFargo1,17,4
0,20000.0,1191.04,108.0,1083.04,18916.96,WellsFargo2,18,1
1,18916.96,1191.04,102.15,1088.89,17828.07,WellsFargo2,18,1
2,17828.07,1191.04,96.27,1094.77,16733.3,WellsFargo2,18,1
3,16733.3,1191.04,90.36,1100.68,15632.62,WellsFargo2,18,1
4,15632.62,1191.04,84.42,1106.62,14526.0,WellsFargo2,18,1
5,14526.0,1191.04,78.44,1112.6,13413.4,WellsFargo2,18,1
6,13413.4,1191.04,72.43,1118.61,12294.79,WellsFargo2,18,1
7,12294.79,1191.04,66.39,1124.65,11170.14,WellsFargo2,18,1
8,11170.14,1191.04,60.32,1130.72,10039.42,WellsFargo2,18,1
9,10039.42,1191.04,54.21,1136.83,8902.59,WellsFargo2,18,1
10,8902.59,1191.04,48.07,1142.97,7759.62,WellsFargo2,18,1
11,7759.62,1191.04,41.9,1149.14,6610.48,WellsFargo2,18,1
12,6610.48,1191.04,35.7,1155.34,5455.14,WellsFargo2,18,1
13,5455.14,1191.04,29.46,1161.58,4293.56,WellsFargo2,18,1
14,4293.56,1191.04,23.19,1167.85,3125.71,WellsFargo2,18,1
15,3125.71,1191.04,16.88,1174.16,1951.55,WellsFargo2,18,1
16,1951.55,1191.04,10.54,1180.5,771.05,WellsFargo2,18,1
17,771.05,1191.04,4.16,1186.88,-415.83,WellsFargo2,18,1
0,4000.0,70.0,16.0,54.0,3946.0,testing,18,2
1,3946.0,70.0,15.78,54.22,3891.78,testing,18,2
2,3891.78,70.0,15.57,54.43,3837.35,testing,18,2
3,3837.35,70.0,15.35,54.65,3782.7,testing,18,2
4,3782.7,70.0,15.13,54.87,3727.83,testing,18,2
5,3727.83,70.0,14.91,55.09,3672.74,testing,18,2
6,3672.74,70.0,14.69,55.31,3617.43,testing,18,2
7,3617.43,70.0,14.47,55.53,3561.9,testing,18,2
8,3561.9,70.0,14.25,55.75,3506.15,testing,18,2
9,3506.15,70.0,14.02,55.98,3450.17,testing,18,2
10,3450.17,70.0,13.8,56.2,3393.97,testing,18,2
11,3393.97,70.0,13.58,56.42,3337.55,testing,18,2
12,3337.55,70.0,13.35,56.65,3280.9,testing,18,2
13,3280.9,70.0,13.12,56.88,3224.02,testing,18,2
14,3224.02,70.0,12.9,57.1,3166.92,testing,18,2
15,3166.92,70.0,12.67,57.33,3109.59,testing,18,2
16,3109.59,70.0,12.44,57.56,3052.03,testing,18,2
17,3052.03,485.83,12.21,473.62,2578.41,testing,18,2
18,2578.41,1261.04,10.31,1250.73,1327.68,testing,18,2
19,1327.68,1261.04,5.31,1255.73,71.95,testing,18,2
20,71.95,1261.04,0.29,1260.75,-1188.8,testing,18,2
0,8250.57,84.62,53.63,30.99,8219.58,WellsFargo1,18,3
1,8219.58,84.62,53.43,31.19,8188.39,WellsFargo1,18,3
2,8188.39,84.62,53.22,31.4,8156.99,WellsFargo1,18,3
3,8156.99,84.62,53.02,31.6,8125.39,WellsFargo1,18,3
4,8125.39,84.62,52.82,31.8,8093.59,WellsFargo1,18,3
5,8093.59,84.62,52.61,32.01,8061.58,WellsFargo1,18,3
6,8061.58,84.62,52.4,32.22,8029.36,WellsFargo1,18,3
7,8029.36,84.62,52.19,32.43,7996.93,WellsFargo1,18,3
8,7996.93,84.62,51.98,32.64,7964.29,WellsFargo1,18,3
9,7964.29,84.62,51.77,32.85,7931.44,WellsFargo1,18,3
10,7931.44,84.62,51.55,33.07,7898.37,WellsFargo1,18,3
11,7898.37,84.62,51.34,33.28,7865.09,WellsFargo1,18,3
12,7865.09,84.62,51.12,33.5,7831.59,WellsFargo1,18,3
13,7831.59,84.62,50.91,33.71,7797.88,WellsFargo1,18,3
14,7797.88,84.62,50.69,33.93,7763.95,WellsFargo1,18,3
15,7763.95,84.62,50.47,34.15,7729.8,WellsFargo1,18,3
16,7729.8,84.62,50.24,34.38,7695.42,WellsFargo1,18,3
17,7695.42,84.62,50.02,34.6,7660.82,WellsFargo1,18,3
18,7660.82,84.62,49.8,34.82,7626.0,WellsFargo1,18,3
19,7626.0,84.62,49.57,35.05,7590.95,WellsFargo1,18,3
20,7590.95,1273.42,49.34,1224.08,6366.87,WellsFargo1,18,3
21,6366.87,1345.66,41.38,1304.28,5062.59,WellsFargo1,18,3
22,5062.59,1345.66,32.91,1312.75,3749.84,WellsFargo1,18,3
23,3749.84,1345.66,24.37,1321.29,2428.55,WellsFargo1,18,3
24,2428.55,1345.66,15.79,1329.87,1098.68,WellsFargo1,18,3
25,1098.68,1345.66,7.14,1338.52,-239.84,WellsFargo1,18,3
0,5000.0,333.0,36.0,297.0,4703.0,Car,18,4
1,4703.0,333.0,33.86,299.14,4403.86,Car,18,4
2,4403.86,333.0,31.71,301.29,4102.57,Car,18,4
3,4102.57,333.0,29.54,303.46,3799.11,Car,18,4
4,3799.11,333.0,27.35,305.65,3493.46,Car,18,4
5,3493.46,333.0,25.15,307.85,3185.61,Car,18,4
6,3185.61,333.0,22.94,310.06,2875.55,Car,18,4
7,2875.55,333.0,20.7,312.3,2563.25,Car,18,4
8,2563.25,333.0,18.46,314.54,2248.71,Car,18,4
9,2248.71,333.0,16.19,316.81,1931.9,Car,18,4
10,1931.9,333.0,13.91,319.09,1612.81,Car,18,4
11,1612.81,333.0,11.61,321.39,1291.42,Car,18,4
12,1291.42,333.0,9.3,323.7,967.72,Car,18,4
13,967.72,333.0,6.97,326.03,641.69,Car,18,4
14,641.69,333.0,4.62,328.38,313.31,Car,18,4
15,313.31,333.0,2.26,330.74,-17.43,Car,18,4
0,4000.0,1070.0,16.0,1054.0,2946.0,testing,19,1
1,2946.0,1070.0,11.78,1058.22,1887.78,testing,19,1
2,1887.78,1070.0,7.55,1062.45,825.33,testing,19,1
3,825.33,1070.0,3.3,1066.7,-241.37,testing,19,1
0,5000.0,333.0,36.0,297.0,4703.0,Car,19,2
1,4703.0,333.0,33.86,299.14,4403.86,Car,19,2
2,4403.86,333.0,31.71,301.29,4102.57,Car,19,2
3,4102.57,574.37,29.54,544.83,3557.74,Car,19,2
4,3557.74,1403.0,25.62,1377.38,2180.36,Car,19,2
5,2180.36,1403.0,15.7,1387.3,793.06,Car,19,2
6,793.06,1403.0,5.71,1397.29,-604.23,Car,19,2
0,8250.57,84.62,53.63,30.99,8219.58,WellsFargo1,19,3
1,8219.58,84.62,53.43,31.19,8188.39,WellsFargo1,19,3
2,8188.39,84.62,53.22,31.4,8156.99,WellsFargo1,19,3
3,8156.99,84.62,53.02,31.6,8125.39,WellsFargo1,19,3
4,8125.39,84.62,52.82,31.8,8093.59,WellsFargo1,19,3
5,8093.59,84.62,52.61,32.01,8061.58,WellsFargo1,19,3
6,8061.58,688.85,52.4,636.45,7425.13,WellsFargo1,19,3
7,7425.13,1487.62,48.26,1439.36,5985.77,WellsFargo1,19,3
8,5985.77,1487.62,38.91,1448.71,4537.06,WellsFargo1,19,3
9,4537.06,1487.62,29.49,1458.13,3078.93,WellsFargo1,19,3
10,3078.93,1487.62,20.01,1467.61,1611.32,WellsFargo1,19,3
11,1611.32,1487.62,10.47,1477.15,134.17,WellsFargo1,19,3
12,134.17,1487.62,0.87,1486.75,-1352.58,WellsFargo1,19,3
0,20000.0,191.04,108.0,83.04,19916.96,WellsFargo2,19,4
1,19916.96,191.04,107.55,83.49,19833.47,WellsFargo2,19,4
2,19833.47,191.04,107.1,83.94,19749.53,WellsFargo2,19,4
3,19749.53,191.04,106.65,84.39,19665.14,WellsFargo2,19,4
4,19665.14,191.04,106.19,84.85,19580.29,WellsFargo2,19,4
5,19580.29,191.04,105.73,85.31,19494.98,WellsFargo2,19,4
6,19494.98,191.04,105.27,85.77,19409.21,WellsFargo2,19,4
7,19409.21,191.04,104.81,86.23,19322.98,WellsFargo2,19,4
8,19322.98,191.04,104.34,86.7,19236.28,WellsFargo2,19,4
9,19236.28,191.04,103.88,87.16,19149.12,WellsFargo2,19,4
10,19149.12,191.04,103.41,87.63,19061.49,WellsFargo2,19,4
11,19061.49,191.04,102.93,88.11,18973.38,WellsFargo2,19,4
12,18973.38,1543.62,102.46,1441.16,17532.22,WellsFargo2,19,4
13,17532.22,1678.66,94.67,1583.99,15948.23,WellsFargo2,19,4
14,15948.23,1678.66,86.12,1592.54,14355.69,WellsFargo2,19,4
15,14355.69,1678.66,77.52,1601.14,12754.55,WellsFargo2,19,4
16,12754.55,1678.66,68.87,1609.79,11144.76,WellsFargo2,19,4
17,11144.76,1678.66,60.18,1618.48,9526.28,WellsFargo2,19,4
18,9526.28,1678.66,51.44,1627.22,7899.06,WellsFargo2,19,4
19,7899.06,1678.66,42.65,1636.01,6263.05,WellsFargo2,19,4
20,6263.05,1678.66,33.82,1644.84,4618.21,WellsFargo2,19,4
21,4618.21,1678.66,24.94,1653.72,2964.49,WellsFargo2,19,4
22,2964.49,1678.66,16.01,1662.65,1301.84,WellsFargo2,19,4
23,1301.84,1678.66,7.03,1671.63,-369.79,WellsFargo2,19,4
0,4000.0,1070.0,16.0,1054.0,2946.0,testing,20,1
1,2946.0,1070.0,11.78,1058.22,1887.78,testing,20,1
2,1887.78,1070.0,7.55,1062.45,825.33,testing,20,1
3,825.33,1070.0,3.3,1066.7,-241.37,testing,20,1
0,5000.0,333.0,36.0,297.0,4703.0,Car,20,2
1,4703.0,333.0,33.86,299.14,4403.86,Car,20,2
2,4403.86,333.0,31.71,301.29,4102.57,Car,20,2
3,4102.57,574.37,29.54,544.83,3557.74,Car,20,2
4,3557.74,1403.0,25.62,1377.38,2180.36,Car,20,2
5,2180.36,1403.0,15.7,1387.3,793.06,Car,20,2
6,793.06,1403.0,5.71,1397.29,-604.23,Car,20,2
0,20000.0,191.04,108.0,83.04,19916.96,WellsFargo2,20,3
1,19916.96,191.04,107.55,83.49,19833.47,WellsFargo2,20,3
2,19833.47,191.04,107.1,83.94,19749.53,WellsFargo2,20,3
3,19749.53,191.04,106.65,84.39,19665.14,WellsFargo2,20,3
4,19665.14,191.04,106.19,84.85,19580.29,WellsFargo2,20,3
5,19580.29,191.04,105.73,85.31,19494.98,WellsFargo2,20,3
6,19494.98,795.27,105.27,690.0,18804.98,WellsFargo2,20,3
7,18804.98,1594.04,101.55,1492.49,17312.49,WellsFargo2,20,3
8,17312.49,1594.04,93.49,1500.55,15811.94,WellsFargo2,20,3
9,15811.94,1594.04,85.38,1508.66,14303.28,WellsFargo2,20,3
10,14303.28,1594.04,77.24,1516.8,12786.48,WellsFargo2,20,3
11,12786.48,1594.04,69.05,1524.99,11261.49,WellsFargo2,20,3
12,11261.49,1594.04,60.81,1533.23,9728.26,WellsFargo2,20,3
13,9728.26,1594.04,52.53,1541.51,8186.75,WellsFargo2,20,3
14,8186.75,1594.04,44.21,1549.83,6636.92,WellsFargo2,20,3
15,6636.92,1594.04,35.84,1558.2,5078.72,WellsFargo2,20,3
16,5078.72,1594.04,27.43,1566.61,3512.11,WellsFargo2,20,3
17,3512.11,1594.04,18.97,1575.07,1937.04,WellsFargo2,20,3
18,1937.04,1594.04,10.46,1583.58,353.46,WellsFargo2,20,3
19,353.46,1594.04,1.91,1592.13,-1238.67,WellsFargo2,20,3
0,8250.57,84.62,53.63,30.99,8219.58,WellsFargo1,20,4
1,8219.58,84.62,53.43,31.19,8188.39,WellsFargo1,20,4
2,8188.39,84.62,53.22,31.4,8156.99,WellsFargo1,20,4
3,8156.99,84.62,53.02,31.6,8125.39,WellsFargo1,20,4
4,8125.39,84.62,52.82,31.8,8093.59,WellsFargo1,20,4
5,8093.59,84.62,52.61,32.01,8061.58,WellsFargo1,20,4
6,8061.58,84.62,52.4,32.22,8029.36,WellsFargo1,20,4
7,8029.36,84.62,52.19,32.43,7996.93,WellsFargo1,20,4
8,7996.93,84.62,51.98,32.64,7964.29,WellsFargo1,20,4
9,7964.29,84.62,51.77,32.85,7931.44,WellsFargo1,20,4
10,7931.44,84.62,51.55,33.07,7898.37,WellsFargo1,20,4
11,7898.37,84.62,51.34,33.28,7865.09,WellsFargo1,20,4
12,7865.09,84.62,51.12,33.5,7831.59,WellsFargo1,20,4
13,7831.59,84.62,50.91,33.71,7797.88,WellsFargo1,20,4
14,7797.88,84.62,50.69,33.93,7763.95,WellsFargo1,20,4
15,7763.95,84.62,50.47,34.15,7729.8,WellsFargo1,20,4
16,7729.8,84.62,50.24,34.38,7695.42,WellsFargo1,20,4
17,7695.42,84.62,50.02,34.6,7660.82,WellsFargo1,20,4
18,7660.82,84.62,49.8,34.82,7626.0,WellsFargo1,20,4
19,7626.0,1323.29,49.57,1273.72,6352.28,WellsFargo1,20,4
20,6352.28,1678.66,41.29,1637.37,4714.91,WellsFargo1,20,4
21,4714.91,1678.66,30.65,1648.01,3066.9,WellsFargo1,20,4
22,3066.9,1678.66,19.93,1658.73,1408.17,WellsFargo1,20,4
23,1408.17,1678.66,9.15,1669.51,-261.34,WellsFargo1,20,4
0,4000.0,1070.0,16.0,1054.0,2946.0,testing,21,1
1,2946.0,1070.0,11.78,1058.22,1887.78,testing,21,1
2,1887.78,1070.0,7.55,1062.45,825.33,testing,21,1
3,825.33,1070.0,3.3,1066.7,-241.37,testing,21,1
0,8250.57,84.62,53.63,30.99,8219.58,WellsFargo1,21,2
1,8219.58,84.62,53.43,31.19,8188.39,WellsFargo1,21,2
2,8188.39,84.62,53.22,31.4,8156.99,WellsFargo1,21,2
3,8156.99,325.99,53.02,272.97,7884.02,WellsFargo1,21,2
4,7884.02,1154.62,51.25,1103.37,6780.65,WellsFargo1,21,2
5,6780.65,1154.62,44.07,1110.55,5670.1,WellsFargo1,21,2
6,5670.1,1154.62,36.86,1117.76,4552.34,WellsFargo1,21,2
7,4552.34,1154.62,29.59,1125.03,3427.31,WellsFargo1,21,2
8,3427.31,1154.62,22.28,1132.34,2294.97,WellsFargo1,21,2
9,2294.97,1154.62,14.92,1139.7,1155.27,WellsFargo1,21,2
10,1155.27,1154.62,7.51,1147.11,8.16,WellsFargo1,21,2
11,8.16,1154.62,0.05,1154.57,-1146.41,WellsFargo1,21,2
0,5000.0,333.0,36.0,297.0,4703.0,Car,21,3
1,4703.0,333.0,33.86,299.14,4403.86,Car,21,3
2,4403.86,333.0,31.71,301.29,4102.57,Car,21,3
3,4102.57,333.0,29.54,303.46,3799.11,Car,21,3
4,3799.11,333.0,27.35,305.65,3493.46,Car,21,3
5,3493.46,333.0,25.15,307.85,3185.61,Car,21,3
6,3185.61,333.0,22.94,310.06,2875.55,Car,21,3
7,2875.55,333.0,20.7,312.3,2563.25,Car,21,3
8,2563.25,333.0,18.46,314.54,2248.71,Car,21,3
9,2248.71,333.0,16.19,316.81,1931.9,Car,21,3
10,1931.9,333.0,13.91,319.09,1612.81,Car,21,3
11,1612.81,1479.41,11.61,1467.8,145.01,Car,21,3
12,145.01,1487.62,1.04,1486.58,-1341.57,Car,21,3
0,20000.0,191.04,108.0,83.04,19916.96,WellsFargo2,21,4
1,19916.96,191.04,107.55,83.49,19833.47,WellsFargo2,21,4
2,19833.47,191.04,107.1,83.94,19749.53,WellsFargo2,21,4
3,19749.53,191.04,106.65,84.39,19665.14,WellsFargo2,21,4
4,19665.14,191.04,106.19,84.85,19580.29,WellsFargo2,21,4
5,19580.29,191.04,105.73,85.31,19494.98,WellsFargo2,21,4
6,19494.98,191.04,105.27,85.77,19409.21,WellsFargo2,21,4
7,19409.21,191.04,104.81,86.23,19322.98,WellsFargo2,21,4
8,19322.98,191.04,104.34,86.7,19236.28,WellsFargo2,21,4
9,19236.28,191.04,103.88,87.16,19149.12,WellsFargo2,21,4
10,19149.12,191.04,103.41,87.63,19061.49,WellsFargo2,21,4
11,19061.49,191.04,102.93,88.11,18973.38,WellsFargo2,21,4
12,18973.38,1532.61,102.46,1430.15,17543.23,WellsFargo2,21,4
13,17543.23,1678.66,94.73,1583.93,15959.3,WellsFargo2,21,4
14,15959.3,1678.66,86.18,1592.48,14366.82,WellsFargo2,21,4
15,14366.82,1678.66,77.58,1601.08,12765.74,WellsFargo2,21,4
16,12765.74,1678.66,68.93,1609.73,11156.01,WellsFargo2,21,4
17,11156.01,1678.66,60.24,1618.42,9537.59,WellsFargo2,21,4
18,9537.59,1678.66,51.5,1627.16,7910.43,WellsFargo2,21,4
19,7910.43,1678.66,42.72,1635.94,6274.49,WellsFargo2,21,4
20,6274.49,1678.66,33.88,1644.78,4629.71,WellsFargo2,21,4
21,4629.71,1678.66,25.0,1653.66,2976.05,WellsFargo2,21,4
22,2976.05,1678.66,16.07,1662.59,1313.46,WellsFargo2,21,4
23,1313.46,1678.66,7.09,1671.57,-358.11,WellsFargo2,21,4
0,4000.0,1070.0,16.0,1054.0,2946.0,testing,22,1
1,2946.0,1070.0,11.78,1058.22,1887.78,testing,22,1
2,1887.78,1070.0,7.55,1062.45,825.33,testing,22,1
3,825.33,1070.0,3.3,1066.7,-241.37,testing,22,1
0,8250.57,84.62,53.63,30.99,8219.58,WellsFargo1,22,2
1,8219.58,84.62,53.43,31.19,8188.39,WellsFargo1,22,2
2,8188.39,84.62,53.22,31.4,8156.99,WellsFargo1,22,2
3,8156.99,325.99,53.02,272.97,7884.02,WellsFargo1,22,2
4,7884.02,1154.62,51.25,1103.37,6780.65,WellsFargo1,22,2
5,6780.65,1154.62,44.07,1110.55,5670.1,WellsFargo1,22,2
6,5670.1,1154.62,36.86,1117.76,4552.34,WellsFargo1,22,2
7,4552.34,1154.62,29.59,1125.03,3427.31,WellsFargo1,22,2
8,3427.31,1154.62,22.28,1132.34,2294.97,WellsFargo1,22,2
9,2294.97,1154.62,14.92,1139.7,1155.27,WellsFargo1,22,2
10,1155.27,1154.62,7.51,1147.11,8.16,WellsFargo1,22,2
11,8.16,1154.62,0.05,1154.57,-1146.41,WellsFargo1,22,2
0,20000.0,191.04,108.0,83.04,19916.96,WellsFargo2,22,3
1,19916.96,191.04,107.55,83.49,19833.47,WellsFargo2,22,3
2,19833.47,191.04,107.1,83.94,19749.53,WellsFargo2,22,3
3,19749.53,191.04,106.65,84.39,19665.14,WellsFargo2,22,3
4,19665.14,191.04,106.19,84.85,19580.29,WellsFargo2,22,3
5,19580.29,191.04,105.73,85.31,19494.98,WellsFargo2,22,3
6,19494.98,191.04,105.27,85.77,19409.21,WellsFargo2,22,3
7,19409.21,191.04,104.81,86.23,19322.98,WellsFargo2,22,3
8,19322.98,191.04,104.34,86.7,19236.28,WellsFargo2,22,3
9,19236.28,191.04,103.88,87.16,19149.12,WellsFargo2,22,3
10,19149.12,191.04,103.41,87.63,19061.49,WellsFargo2,22,3
11,19061.49,1337.45,102.93,1234.52,17826.97,WellsFargo2,22,3
12,17826.97,1345.66,96.27,1249.39,16577.58,WellsFargo2,22,3
13,16577.58,1345.66,89.52,1256.14,15321.44,WellsFargo2,22,3
14,15321.44,1345.66,82.74,1262.92,14058.52,WellsFargo2,22,3
15,14058.52,1345.66,75.92,1269.74,12788.78,WellsFargo2,22,3
16,12788.78,1345.66,69.06,1276.6,11512.18,WellsFargo2,22,3
17,11512.18,1345.66,62.17,1283.49,10228.69,WellsFargo2,22,3
18,10228.69,1345.66,55.23,1290.43,8938.26,WellsFargo2,22,3
19,8938.26,1345.66,48.27,1297.39,7640.87,WellsFargo2,22,3
20,7640.87,1345.66,41.26,1304.4,6336.47,WellsFargo2,22,3
21,6336.47,1345.66,34.22,1311.44,5025.03,WellsFargo2,22,3
22,5025.03,1345.66,27.14,1318.52,3706.51,WellsFargo2,22,3
23,3706.51,1345.66,20.02,1325.64,2380.87,WellsFargo2,22,3
24,2380.87,1345.66,12.86,1332.8,1048.07,WellsFargo2,22,3
25,1048.07,1345.66,5.66,1340.0,-291.93,WellsFargo2,22,3
0,5000.0,333.0,36.0,297.0,4703.0,Car,22,4
1,4703.0,333.0,33.86,299.14,4403.86,Car,22,4
2,4403.86,333.0,31.71,301.29,4102.57,Car,22,4
3,4102.57,333.0,29.54,303.46,3799.11,Car,22,4
4,3799.11,333.0,27.35,305.65,3493.46,Car,22,4
5,3493.46,333.0,25.15,307.85,3185.61,Car,22,4
6,3185.61,333.0,22.94,310.06,2875.55,Car,22,4
7,2875.55,333.0,20.7,312.3,2563.25,Car,22,4
8,2563.25,333.0,18.46,314.54,2248.71,Car,22,4
9,2248.71,333.0,16.19,316.81,1931.9,Car,22,4
10,1931.9,333.0,13.91,319.09,1612.81,Car,22,4
11,1612.81,333.0,11.61,321.39,1291.42,Car,22,4
12,1291.42,333.0,9.3,323.7,967.72,Car,22,4
13,967.72,333.0,6.97,326.03,641.69,Car,22,4
14,641.69,333.0,4.62,328.38,313.31,Car,22,4
15,313.31,333.0,2.26,330.74,-17.43,Car,22,4
0,4000.0,1070.0,16.0,1054.0,2946.0,testing,23,1
1,2946.0,1070.0,11.78,1058.22,1887.78,testing,23,1
2,1887.78,1070.0,7.55,1062.45,825.33,testing,23,1
3,825.33,1070.0,3.3,1066.7,-241.37,testing,23,1
0,20000.0,191.04,108.0,83.04,19916.96,WellsFargo2,23,2
1,19916.96,191.04,107.55,83.49,19833.47,WellsFargo2,23,2
2,19833.47,191.04,107.1,83.94,19749.53,WellsFargo2,23,2
3,19749.53,432.41,106.65,325.76,19423.77,WellsFargo2,23,2
4,19423.77,1261.04,104.89,1156.15,18267.62,WellsFargo2,23,2
5,18267.62,1261.04,98.65,1162.39,17105.23,WellsFargo2,23,2
6,17105.23,1261.04,92.37,1168.67,15936.56,WellsFargo2,23,2
7,15936.56,1261.04,86.06,1174.98,14761.58,WellsFargo2,23,2
8,14761.58,1261.04,79.71,1181.33,13580.25,WellsFargo2,23,2
9,13580.25,1261.04,73.33,1187.71,12392.54,WellsFargo2,23,2
10,12392.54,1261.04,66.92,1194.12,11198.42,WellsFargo2,23,2
11,11198.42,1261.04,60.47,1200.57,9997.85,WellsFargo2,23,2
12,9997.85,1261.04,53.99,1207.05,8790.8,WellsFargo2,23,2
13,8790.8,1261.04,47.47,1213.57,7577.23,WellsFargo2,23,2
14,7577.23,1261.04,40.92,1220.12,6357.11,WellsFargo2,23,2
15,6357.11,1261.04,34.33,1226.71,5130.4,WellsFargo2,23,2
16,5130.4,1261.04,27.7,1233.34,3897.06,WellsFargo2,23,2
17,3897.06,1261.04,21.04,1240.0,2657.06,WellsFargo2,23,2
18,2657.06,1261.04,14.35,1246.69,1410.37,WellsFargo2,23,2
19,1410.37,1261.04,7.62,1253.42,156.95,WellsFargo2,23,2
20,156.95,1261.04,0.85,1260.19,-1103.24,WellsFargo2,23,2
0,5000.0,333.0,36.0,297.0,4703.0,Car,23,3
1,4703.0,333.0,33.86,299.14,4403.86,Car,23,3
2,4403.86,333.0,31.71,301.29,4102.57,Car,23,3
3,4102.57,333.0,29.54,303.46,3799.11,Car,23,3
4,3799.11,333.0,27.35,305.65,3493.46,Car,23,3
5,3493.46,333.0,25.15,307.85,3185.61,Car,23,3
6,3185.61,333.0,22.94,310.06,2875.55,Car,23,3
7,2875.55,333.0,20.7,312.3,2563.25,Car,23,3
8,2563.25,333.0,18.46,314.54,2248.71,Car,23,3
9,2248.71,333.0,16.19,316.81,1931.9,Car,23,3
10,1931.9,333.0,13.91,319.09,1612.81,Car,23,3
11,1612.81,333.0,11.61,321.39,1291.42,Car,23,3
12,1291.42,333.0,9.3,323.7,967.72,Car,23,3
13,967.72,333.0,6.97,326.03,641.69,Car,23,3
14,641.69,333.0,4.62,328.38,313.31,Car,23,3
15,313.31,333.0,2.26,330.74,-17.43,Car,23,3
0,8250.57,84.62,53.63,30.99,8219.58,WellsFargo1,23,4
1,8219.58,84.62,53.43,31.19,8188.39,WellsFargo1,23,4
2,8188.39,84.62,53.22,31.4,8156.99,WellsFargo1,23,4
3,8156.99,84.62,53.02,31.6,8125.39,WellsFargo1,23,4
4,8125.39,84.62,52.82,31.8,8093.59,WellsFargo1,23,4
5,8093.59,84.62,52.61,32.01,8061.58,WellsFargo1,23,4
6,8061.58,84.62,52.4,32.22,8029.36,WellsFargo1,23,4
7,8029.36,84.62,52.19,32.43,7996.93,WellsFargo1,23,4
8,7996.93,84.62,51.98,32.64,7964.29,WellsFargo1,23,4
9,7964.29,84.62,51.77,32.85,7931.44,WellsFargo1,23,4
10,7931.44,84.62,51.55,33.07,7898.37,WellsFargo1,23,4
11,7898.37,84.62,51.34,33.28,7865.09,WellsFargo1,23,4
12,7865.09,84.62,51.12,33.5,7831.59,WellsFargo1,23,4
13,7831.59,84.62,50.91,33.71,7797.88,WellsFargo1,23,4
14,7797.88,84.62,50.69,33.93,7763.95,WellsFargo1,23,4
15,7763.95,102.05,50.47,51.58,7712.37,WellsFargo1,23,4
16,7712.37,1678.66,50.13,1628.53,6083.84,WellsFargo1,23,4
17,6083.84,1678.66,39.54,1639.12,4444.72,WellsFargo1,23,4
18,4444.72,1678.66,28.89,1649.77,2794.95,WellsFargo1,23,4
19,2794.95,1678.66,18.17,1660.49,1134.46,WellsFargo1,23,4
20,1134.46,1678.66,7.37,1671.29,-536.83,WellsFargo1,23,4
0,4000.0,1070.0,16.0,1054.0,2946.0,testing,24,1
1,2946.0,1070.0,11.78,1058.22,1887.78,testing,24,1
2,1887.78,1070.0,7.55,1062.45,825.33,testing,24,1
3,825.33,1070.0,3.3,1066.7,-241.37,testing,24,1
0,20000.0,191.04,108.0,83.04,19916.96,WellsFargo2,24,2
1,19916.96,191.04,107.55,83.49,19833.47,WellsFargo2,24,2
2,19833.47,191.04,107.1,83.94,19749.53,WellsFargo2,24,2
3,19749.53,432.41,106.65,325.76,19423.77,WellsFargo2,24,2
4,19423.77,1261.04,104.89,1156.15,18267.62,WellsFargo2,24,2
5,18267.62,1261.04,98.65,1162.39,17105.23,WellsFargo2,24,2
6,17105.23,1261.04,92.37,1168.67,15936.56,WellsFargo2,24,2
7,15936.56,1261.04,86.06,1174.98,14761.58,WellsFargo2,24,2
8,14761.58,1261.04,79.71,1181.33,13580.25,WellsFargo2,24,2
9,13580.25,1261.04,73.33,1187.71,12392.54,WellsFargo2,24,2
10,12392.54,1261.04,66.92,1194.12,11198.42,WellsFargo2,24,2
11,11198.42,1261.04,60.47,1200.57,9997.85,WellsFargo2,24,2
12,9997.85,1261.04,53.99,1207.05,8790.8,WellsFargo2,24,2
13,8790.8,1261.04,47.47,1213.57,7577.23,WellsFargo2,24,2
14,7577.23,1261.04,40.92,1220.12,6357.11,WellsFargo2,24,2
15,6357.11,1261.04,34.33,1226.71,5130.4,WellsFargo2,24,2
16,5130.4,1261.04,27.7,1233.34,3897.06,WellsFargo2,24,2
17,3897.06,1261.04,21.04,1240.0,2657.06,WellsFargo2,24,2
18,2657.06,1261.04,14.35,1246.69,1410.37,WellsFargo2,24,2
19,1410.37,1261.04,7.62,1253.42,156.95,WellsFargo2,24,2
20,156.95,1261.04,0.85,1260.19,-1103.24,WellsFargo2,24,2
0,8250.57,84.62,53.63,30.99,8219.58,WellsFargo1,24,3
1,8219.58,84.62,53.43,31.19,8188.39,WellsFargo1,24,3
2,8188.39,84.62,53.22,31.4,8156.99,WellsFargo1,24,3
3,8156.99,84.62,53.02,31.6,8125.39,WellsFargo1,24,3
4,8125.39,84.62,52.82,31.8,8093.59,WellsFargo1,24,3
5,8093.59,84.62,52.61,32.01,8061.58,WellsFargo1,24,3
6,8061.58,84.62,52.4,32.22,8029.36,WellsFargo1,24,3
7,8029.36,84.62,52.19,32.43,7996.93,WellsFargo1,24,3
8,7996.93,84.62,51.98,32.64,7964.29,WellsFargo1,24,3
9,7964.29,84.62,51.77,32.85,7931.44,WellsFargo1,24,3
10,7931.44,84.62,51.55,33.07,7898.37,WellsFargo1,24,3
11,7898.37,84.62,51.34,33.28,7865.09,WellsFargo1,24,3
12,7865.09,84.62,51.12,33.5,7831.59,WellsFargo1,24,3
13,7831.59,84.62,50.91,33.71,7797.88,WellsFargo1,24,3
14,7797.88,84.62,50.69,33.93,7763.95,WellsFargo1,24,3
15,7763.95,84.62,50.47,34.15,7729.8,WellsFargo1,24,3
16,7729.8,84.62,50.24,34.38,7695.42,WellsFargo1,24,3
17,7695.42,84.62,50.02,34.6,7660.82,WellsFargo1,24,3
18,7660.82,84.62,49.8,34.82,7626.0,WellsFargo1,24,3
19,7626.0,84.62,49.57,35.05,7590.95,WellsFargo1,24,3
20,7590.95,1187.86,49.34,1138.52,6452.43,WellsFargo1,24,3
21,6452.43,1345.66,41.94,1303.72,5148.71,WellsFargo1,24,3
22,5148.71,1345.66,33.47,1312.19,3836.52,WellsFargo1,24,3
23,3836.52,1345.66,24.94,1320.72,2515.8,WellsFargo1,24,3
24,2515.8,1345.66,16.35,1329.31,1186.49,WellsFargo1,24,3
25,1186.49,1345.66,7.71,1337.95,-151.46,WellsFargo1,24,3
0,5000.0,333.0,36.0,297.0,4703.0,Car,24,4
1,4703.0,333.0,33.86,299.14,4403.86,Car,24,4
2,4403.86,333.0,31.71,301.29,4102.57,Car,24,4
3,4102.57,333.0,29.54,303.46,3799.11,Car,24,4
4,3799.11,333.0,27.35,305.65,3493.46,Car,24,4
5,3493.46,333.0,25.15,307.85,3185.61,Car,24,4
6,3185.61,333.0,22.94,310.06,2875.55,Car,24,4
7,2875.55,333.0,20.7,312.3,2563.25,Car,24,4
8,2563.25,333.0,18.46,314.54,2248.71,Car,24,4
9,2248.71,333.0,16.19,316.81,1931.9,Car,24,4
10,1931.9,333.0,13.91,319.09,1612.81,Car,24,4
11,1612.81,333.0,11.61,321.39,1291.42,Car,24,4
12,1291.42,333.0,9.3,323.7,967.72,Car,24,4
13,967.72,333.0,6.97,326.03,641.69,Car,24,4
14,641.69,333.0,4.62,328.38,313.31,Car,24,4
15,313.31,333.0,2.26,330.74,-17.43,Car,24,4
